날짜,노선명,역명,승차총승객수,하차총승객수,총승하차인원,월
2020-01-01,공항철도 1호선,홍대입구,10405,9279,19684,1
2020-01-01,공항철도 1호선,서울역,14369,10789,25158,1
2020-01-01,9호선,고속터미널,9488,13501,22989,1
2020-01-01,8호선,잠실(송파구청),12712,13225,25937,1
2020-01-01,7호선,가산디지털단지,11215,10506,21721,1
2020-01-01,7호선,고속터미널,12492,8223,20715,1
2020-01-01,경의선,홍대입구,1582,1959,3541,1
2020-01-01,경의선,서울역,1309,969,2278,1
2020-01-01,1호선,서울역,36470,29895,66365,1
2020-01-01,분당선,선릉,2279,3268,5547,1
2020-01-01,경부선,가산디지털단지,4474,6236,10710,1
2020-01-01,경부선,서울역,6620,1051,7671,1
2020-01-01,4호선,사당,13276,11928,25204,1
2020-01-01,4호선,서울역,6182,14194,20376,1
2020-01-01,3호선,고속터미널,39526,34867,74393,1
2020-01-01,2호선,홍대입구,69202,61962,131164,1
2020-01-01,2호선,구로디지털단지,25130,25859,50989,1
2020-01-01,2호선,신림,36826,37845,74671,1
2020-01-01,2호선,사당,18983,20297,39280,1
2020-01-01,2호선,강남,39231,36768,75999,1
2020-01-01,2호선,선릉,11749,9965,21714,1
2020-01-01,2호선,잠실(송파구청),53799,48425,102224,1
2020-01-02,1호선,서울역,59502,53548,113050,1
2020-01-02,2호선,잠실(송파구청),88601,86659,175260,1
2020-01-02,2호선,선릉,63911,57187,121098,1
2020-01-02,2호선,강남,115263,116820,232083,1
2020-01-02,2호선,사당,41886,46697,88583,1
2020-01-02,2호선,신림,72865,71278,144143,1
2020-01-02,2호선,구로디지털단지,71079,70880,141959,1
2020-01-02,2호선,홍대입구,79840,85293,165133,1
2020-01-02,3호선,고속터미널,55884,51160,107044,1
2020-01-02,4호선,서울역,15397,23785,39182,1
2020-01-02,4호선,사당,28840,24227,53067,1
2020-01-02,경부선,서울역,7265,1645,8910,1
2020-01-02,경부선,가산디지털단지,20409,23292,43701,1
2020-01-02,분당선,선릉,13838,22412,36250,1
2020-01-02,경의선,서울역,4770,6230,11000,1
2020-01-02,경의선,홍대입구,2107,2536,4643,1
2020-01-02,경의선,서울역,1,0,1,1
2020-01-02,7호선,고속터미널,21345,17051,38396,1
2020-01-02,7호선,가산디지털단지,48928,49299,98227,1
2020-01-02,8호선,잠실(송파구청),17458,19917,37375,1
2020-01-02,9호선,고속터미널,14460,19400,33860,1
2020-01-02,공항철도 1호선,서울역,14563,11779,26342,1
2020-01-02,공항철도 1호선,홍대입구,12860,12436,25296,1
2020-01-03,1호선,서울역,66013,60775,126788,1
2020-01-03,2호선,잠실(송파구청),95193,92634,187827,1
2020-01-03,2호선,선릉,66502,59573,126075,1
2020-01-03,2호선,강남,126036,132511,258547,1
2020-01-03,2호선,사당,48252,53045,101297,1
2020-01-03,2호선,신림,76792,74880,151672,1
2020-01-03,2호선,구로디지털단지,73974,74596,148570,1
2020-01-03,2호선,홍대입구,89087,99670,188757,1
2020-01-03,3호선,고속터미널,62892,63136,126028,1
2020-01-03,4호선,서울역,16192,26730,42922,1
2020-01-03,4호선,사당,31954,27658,59612,1
2020-01-03,경부선,서울역,8504,1846,10350,1
2020-01-03,경부선,가산디지털단지,20529,23685,44214,1
2020-01-03,분당선,선릉,14556,23802,38358,1
2020-01-03,경의선,서울역,5170,6674,11844,1
2020-01-03,경의선,홍대입구,2376,3012,5388,1
2020-01-03,경의선,서울역,1,0,1,1
2020-01-03,7호선,고속터미널,23341,18503,41844,1
2020-01-03,7호선,가산디지털단지,49822,50314,100136,1
2020-01-03,8호선,잠실(송파구청),18719,21398,40117,1
2020-01-03,9호선,고속터미널,16228,22882,39110,1
2020-01-03,공항철도 1호선,서울역,16000,13245,29245,1
2020-01-03,공항철도 1호선,홍대입구,13732,14199,27931,1
2020-01-04,1호선,서울역,48376,46823,95199,1
2020-01-04,2호선,잠실(송파구청),81999,77313,159312,1
2020-01-04,2호선,선릉,30318,27003,57321,1
2020-01-04,2호선,강남,87333,93257,180590,1
2020-01-04,2호선,사당,39197,42750,81947,1
2020-01-04,2호선,신림,60576,58649,119225,1
2020-01-04,2호선,구로디지털단지,44203,43499,87702,1
2020-01-04,2호선,홍대입구,90634,102811,193445,1
2020-01-04,3호선,고속터미널,68676,67117,135793,1
2020-01-04,4호선,서울역,8812,20649,29461,1
2020-01-04,4호선,사당,26114,23011,49125,1
2020-01-04,경부선,서울역,8218,1538,9756,1
2020-01-04,경부선,가산디지털단지,6932,9446,16378,1
2020-01-04,분당선,선릉,6047,9958,16005,1
2020-01-04,경의선,서울역,1768,1893,3661,1
2020-01-04,경의선,홍대입구,2517,3111,5628,1
2020-01-04,7호선,고속터미널,20839,16063,36902,1
2020-01-04,7호선,가산디지털단지,17112,15715,32827,1
2020-01-04,8호선,잠실(송파구청),16162,18111,34273,1
2020-01-04,9호선,고속터미널,16148,24145,40293,1
2020-01-04,공항철도 1호선,서울역,14880,12779,27659,1
2020-01-04,공항철도 1호선,홍대입구,14817,14439,29256,1
2020-01-05,1호선,서울역,38247,34335,72582,1
2020-01-05,2호선,잠실(송파구청),59763,55702,115465,1
2020-01-05,2호선,선릉,15439,13520,28959,1
2020-01-05,2호선,강남,52620,51683,104303,1
2020-01-05,2호선,사당,26437,28988,55425,1
2020-01-05,2호선,신림,45798,45068,90866,1
2020-01-05,2호선,구로디지털단지,31980,31694,63674,1
2020-01-05,2호선,홍대입구,70489,70084,140573,1
2020-01-05,3호선,고속터미널,55120,52535,107655,1
2020-01-05,4호선,서울역,6567,15715,22282,1
2020-01-05,4호선,사당,18298,17166,35464,1
2020-01-05,경부선,서울역,7353,1255,8608,1
2020-01-05,경부선,가산디지털단지,5490,7663,13153,1
2020-01-05,분당선,선릉,2974,4676,7650,1
2020-01-05,경의선,서울역,1383,1269,2652,1
2020-01-05,경의선,홍대입구,1972,2370,4342,1
2020-01-05,7호선,고속터미널,16836,11758,28594,1
2020-01-05,7호선,가산디지털단지,12713,11763,24476,1
2020-01-05,8호선,잠실(송파구청),12197,13278,25475,1
2020-01-05,9호선,고속터미널,13050,18653,31703,1
2020-01-05,공항철도 1호선,서울역,14277,11073,25350,1
2020-01-05,공항철도 1호선,홍대입구,11792,10504,22296,1
2020-01-06,1호선,서울역,58509,54106,112615,1
2020-01-06,2호선,잠실(송파구청),85090,83547,168637,1
2020-01-06,2호선,선릉,69055,61369,130424,1
2020-01-06,2호선,강남,117522,118454,235976,1
2020-01-06,2호선,사당,43383,48242,91625,1
2020-01-06,2호선,신림,72858,71297,144155,1
2020-01-06,2호선,구로디지털단지,72750,72692,145442,1
2020-01-06,2호선,홍대입구,71697,75177,146874,1
2020-01-06,3호선,고속터미널,54701,51591,106292,1
2020-01-06,4호선,서울역,15150,23530,38680,1
2020-01-06,4호선,사당,29803,25102,54905,1
2020-01-06,경부선,서울역,6832,1686,8518,1
2020-01-06,경부선,가산디지털단지,20836,24326,45162,1
2020-01-06,분당선,선릉,15270,24661,39931,1
2020-01-06,경의선,서울역,4858,6400,11258,1
2020-01-06,경의선,홍대입구,1877,2309,4186,1
2020-01-06,경의선,서울역,1,0,1,1
2020-01-06,7호선,고속터미널,21153,17215,38368,1
2020-01-06,7호선,가산디지털단지,51719,51373,103092,1
2020-01-06,8호선,잠실(송파구청),17104,19032,36136,1
2020-01-06,9호선,고속터미널,14564,19485,34049,1
2020-01-06,공항철도 1호선,서울역,13217,11048,24265,1
2020-01-06,공항철도 1호선,홍대입구,11564,11218,22782,1
2020-01-07,1호선,서울역,56932,52709,109641,1
2020-01-07,2호선,잠실(송파구청),83156,82477,165633,1
2020-01-07,2호선,선릉,68443,60518,128961,1
2020-01-07,2호선,강남,115832,116538,232370,1
2020-01-07,2호선,사당,44077,47887,91964,1
2020-01-07,2호선,신림,71503,70124,141627,1
2020-01-07,2호선,구로디지털단지,71028,71465,142493,1
2020-01-07,2호선,홍대입구,68312,71304,139616,1
2020-01-07,3호선,고속터미널,52659,50550,103209,1
2020-01-07,4호선,서울역,15301,23591,38892,1
2020-01-07,4호선,사당,29655,25244,54899,1
2020-01-07,경부선,서울역,6449,1517,7966,1
2020-01-07,경부선,가산디지털단지,20052,23445,43497,1
2020-01-07,분당선,선릉,15502,24489,39991,1
2020-01-07,경의선,서울역,4601,5779,10380,1
2020-01-07,경의선,홍대입구,1788,2075,3863,1
2020-01-07,경의선,홍대입구,1,0,1,1
2020-01-07,7호선,고속터미널,20111,17107,37218,1
2020-01-07,7호선,가산디지털단지,51290,51012,102302,1
2020-01-07,8호선,잠실(송파구청),17114,19148,36262,1
2020-01-07,9호선,고속터미널,13470,18431,31901,1
2020-01-07,공항철도 1호선,서울역,12581,10603,23184,1
2020-01-07,공항철도 1호선,홍대입구,10744,10923,21667,1
2020-01-08,1호선,서울역,58754,53792,112546,1
2020-01-08,2호선,잠실(송파구청),89594,88027,177621,1
2020-01-08,2호선,선릉,69980,61984,131964,1
2020-01-08,2호선,강남,120178,120962,241140,1
2020-01-08,2호선,사당,46619,50787,97406,1
2020-01-08,2호선,신림,75033,72856,147889,1
2020-01-08,2호선,구로디지털단지,73576,73616,147192,1
2020-01-08,2호선,홍대입구,74819,79883,154702,1
2020-01-08,3호선,고속터미널,53961,51851,105812,1
2020-01-08,4호선,서울역,15588,23852,39440,1
2020-01-08,4호선,사당,31238,26477,57715,1
2020-01-08,경부선,서울역,6301,1509,7810,1
2020-01-08,경부선,가산디지털단지,20923,24065,44988,1
2020-01-08,분당선,선릉,15117,24527,39644,1
2020-01-08,경의선,서울역,4833,6342,11175,1
2020-01-08,경의선,홍대입구,2021,2454,4475,1
2020-01-08,7호선,고속터미널,20389,17237,37626,1
2020-01-08,7호선,가산디지털단지,50955,51111,102066,1
2020-01-08,8호선,잠실(송파구청),17803,20160,37963,1
2020-01-08,9호선,고속터미널,14675,19350,34025,1
2020-01-08,공항철도 1호선,서울역,12673,10792,23465,1
2020-01-08,공항철도 1호선,홍대입구,12092,11943,24035,1
2020-01-09,1호선,서울역,60442,56118,116560,1
2020-01-09,2호선,잠실(송파구청),93980,91824,185804,1
2020-01-09,2호선,선릉,70061,62554,132615,1
2020-01-09,2호선,강남,122108,122689,244797,1
2020-01-09,2호선,사당,48175,52514,100689,1
2020-01-09,2호선,신림,75995,73872,149867,1
2020-01-09,2호선,구로디지털단지,74410,74750,149160,1
2020-01-09,2호선,홍대입구,77947,82743,160690,1
2020-01-09,3호선,고속터미널,55859,54515,110374,1
2020-01-09,4호선,서울역,15727,24805,40532,1
2020-01-09,4호선,사당,31637,27159,58796,1
2020-01-09,경부선,서울역,6847,1587,8434,1
2020-01-09,경부선,가산디지털단지,21101,24259,45360,1
2020-01-09,분당선,선릉,15255,24816,40071,1
2020-01-09,경의선,서울역,4892,6351,11243,1
2020-01-09,경의선,홍대입구,2130,2600,4730,1
2020-01-09,경의선,서울역,1,0,1,1
2020-01-09,경의선,홍대입구,1,0,1,1
2020-01-09,7호선,고속터미널,20734,17341,38075,1
2020-01-09,7호선,가산디지털단지,50862,51370,102232,1
2020-01-09,8호선,잠실(송파구청),18350,20954,39304,1
2020-01-09,9호선,고속터미널,14992,20408,35400,1
2020-01-09,공항철도 1호선,서울역,12892,10708,23600,1
2020-01-09,공항철도 1호선,홍대입구,11889,12165,24054,1
2020-01-10,2호선,잠실(송파구청),96532,92917,189449,1
2020-01-10,2호선,선릉,70116,62468,132584,1
2020-01-10,2호선,강남,127610,134985,262595,1
2020-01-10,2호선,사당,52177,57311,109488,1
2020-01-10,2호선,신림,79361,77355,156716,1
2020-01-10,2호선,구로디지털단지,76485,76975,153460,1
2020-01-10,2호선,홍대입구,83173,95550,178723,1
2020-01-10,3호선,고속터미널,65813,66587,132400,1
2020-01-10,4호선,서울역,16448,27774,44222,1
2020-01-10,4호선,사당,34479,30333,64812,1
2020-01-10,경부선,서울역,9219,2039,11258,1
2020-01-10,경부선,가산디지털단지,21493,24648,46141,1
2020-01-10,분당선,선릉,15202,24680,39882,1
2020-01-10,1호선,서울역,69054,62678,131732,1
2020-01-10,경의선,서울역,5170,6715,11885,1
2020-01-10,경의선,홍대입구,2119,2813,4932,1
2020-01-10,7호선,고속터미널,24428,19582,44010,1
2020-01-10,7호선,가산디지털단지,51492,51422,102914,1
2020-01-10,8호선,잠실(송파구청),18664,21623,40287,1
2020-01-10,9호선,고속터미널,17055,23984,41039,1
2020-01-10,공항철도 1호선,서울역,15248,13439,28687,1
2020-01-10,공항철도 1호선,홍대입구,13201,14203,27404,1
2020-01-11,1호선,서울역,54012,52192,106204,1
2020-01-11,2호선,잠실(송파구청),87689,83099,170788,1
2020-01-11,2호선,선릉,33407,29629,63036,1
2020-01-11,2호선,강남,94848,101571,196419,1
2020-01-11,2호선,사당,44579,48835,93414,1
2020-01-11,2호선,신림,64764,62501,127265,1
2020-01-11,2호선,구로디지털단지,46475,46346,92821,1
2020-01-11,2호선,홍대입구,95907,110791,206698,1
2020-01-11,3호선,고속터미널,74941,74985,149926,1
2020-01-11,4호선,서울역,9654,23514,33168,1
2020-01-11,4호선,사당,29887,26716,56603,1
2020-01-11,경부선,서울역,9112,1717,10829,1
2020-01-11,경부선,가산디지털단지,7421,10119,17540,1
2020-01-11,분당선,선릉,6367,10703,17070,1
2020-01-11,경의선,서울역,1922,2198,4120,1
2020-01-11,경의선,홍대입구,2475,3310,5785,1
2020-01-11,경의선,서울역,1,0,1,1
2020-01-11,7호선,고속터미널,22977,16693,39670,1
2020-01-11,7호선,가산디지털단지,18338,16629,34967,1
2020-01-11,8호선,잠실(송파구청),16812,19103,35915,1
2020-01-11,9호선,고속터미널,17650,25958,43608,1
2020-01-11,공항철도 1호선,서울역,14295,13627,27922,1
2020-01-11,공항철도 1호선,홍대입구,15501,15634,31135,1
2020-01-12,1호선,서울역,38946,35440,74386,1
2020-01-12,2호선,잠실(송파구청),64087,59597,123684,1
2020-01-12,2호선,선릉,16488,14334,30822,1
2020-01-12,2호선,강남,55787,54371,110158,1
2020-01-12,2호선,사당,29634,31776,61410,1
2020-01-12,2호선,신림,48368,47737,96105,1
2020-01-12,2호선,구로디지털단지,33445,32676,66121,1
2020-01-12,2호선,홍대입구,77950,76314,154264,1
2020-01-12,3호선,고속터미널,58310,57631,115941,1
2020-01-12,4호선,서울역,7011,17558,24569,1
2020-01-12,4호선,사당,19969,18404,38373,1
2020-01-12,경부선,서울역,7550,1471,9021,1
2020-01-12,경부선,가산디지털단지,5645,7792,13437,1
2020-01-12,분당선,선릉,3111,4958,8069,1
2020-01-12,경의선,서울역,1421,1326,2747,1
2020-01-12,경의선,홍대입구,1960,2415,4375,1
2020-01-12,7호선,고속터미널,16736,12653,29389,1
2020-01-12,7호선,가산디지털단지,13516,12513,26029,1
2020-01-12,8호선,잠실(송파구청),12930,14050,26980,1
2020-01-12,9호선,고속터미널,13302,20335,33637,1
2020-01-12,공항철도 1호선,서울역,14322,11965,26287,1
2020-01-12,공항철도 1호선,홍대입구,12951,11401,24352,1
2020-01-13,1호선,서울역,59613,55643,115256,1
2020-01-13,2호선,잠실(송파구청),88522,86537,175059,1
2020-01-13,2호선,선릉,69660,62360,132020,1
2020-01-13,2호선,강남,118073,118909,236982,1
2020-01-13,2호선,사당,45566,50507,96073,1
2020-01-13,2호선,신림,74036,71808,145844,1
2020-01-13,2호선,구로디지털단지,73015,73669,146684,1
2020-01-13,2호선,홍대입구,74146,77150,151296,1
2020-01-13,3호선,고속터미널,55448,53223,108671,1
2020-01-13,4호선,서울역,15619,24480,40099,1
2020-01-13,4호선,사당,30534,25931,56465,1
2020-01-13,경부선,서울역,6940,1696,8636,1
2020-01-13,경부선,가산디지털단지,20921,24134,45055,1
2020-01-13,분당선,선릉,15071,24753,39824,1
2020-01-13,경의선,서울역,4976,6535,11511,1
2020-01-13,경의선,홍대입구,1938,2367,4305,1
2020-01-13,7호선,고속터미널,20970,17298,38268,1
2020-01-13,7호선,가산디지털단지,51347,51384,102731,1
2020-01-13,8호선,잠실(송파구청),17320,19744,37064,1
2020-01-13,9호선,고속터미널,14715,20376,35091,1
2020-01-13,공항철도 1호선,서울역,14014,11748,25762,1
2020-01-13,공항철도 1호선,홍대입구,12168,11512,23680,1
2020-01-14,공항철도 1호선,홍대입구,12149,12241,24390,1
2020-01-14,공항철도 1호선,서울역,13425,11169,24594,1
2020-01-14,9호선,고속터미널,14555,19944,34499,1
2020-01-14,8호선,잠실(송파구청),17181,19624,36805,1
2020-01-14,7호선,가산디지털단지,51544,51903,103447,1
2020-01-14,7호선,고속터미널,21377,18031,39408,1
2020-01-14,경의선,홍대입구,2148,2512,4660,1
2020-01-14,경의선,서울역,4949,6427,11376,1
2020-01-14,분당선,선릉,15671,24797,40468,1
2020-01-14,경부선,가산디지털단지,20917,24164,45081,1
2020-01-14,경부선,서울역,6363,1583,7946,1
2020-01-14,4호선,사당,31213,26314,57527,1
2020-01-14,4호선,서울역,15793,24716,40509,1
2020-01-14,3호선,고속터미널,55611,53555,109166,1
2020-01-14,2호선,홍대입구,77040,80960,158000,1
2020-01-14,2호선,구로디지털단지,74529,74519,149048,1
2020-01-14,2호선,신림,75589,73807,149396,1
2020-01-14,2호선,사당,47135,51475,98610,1
2020-01-14,2호선,강남,120976,121733,242709,1
2020-01-14,2호선,선릉,69774,62359,132133,1
2020-01-14,2호선,잠실(송파구청),91634,89073,180707,1
2020-01-14,1호선,서울역,59632,55374,115006,1
2020-01-15,2호선,잠실(송파구청),92707,89902,182609,1
2020-01-15,2호선,선릉,70282,62412,132694,1
2020-01-15,2호선,강남,122025,122875,244900,1
2020-01-15,2호선,사당,47739,51975,99714,1
2020-01-15,2호선,신림,76301,74509,150810,1
2020-01-15,2호선,구로디지털단지,74642,74998,149640,1
2020-01-15,2호선,홍대입구,77801,82503,160304,1
2020-01-15,3호선,고속터미널,55935,54187,110122,1
2020-01-15,4호선,서울역,15920,24816,40736,1
2020-01-15,4호선,사당,31699,27006,58705,1
2020-01-15,경부선,서울역,6827,1719,8546,1
2020-01-15,경부선,가산디지털단지,20873,24391,45264,1
2020-01-15,분당선,선릉,15524,24828,40352,1
2020-01-15,경의선,서울역,4932,6327,11259,1
2020-01-15,경의선,홍대입구,2143,2571,4714,1
2020-01-15,1호선,서울역,59961,55706,115667,1
2020-01-15,7호선,고속터미널,21203,18199,39402,1
2020-01-15,7호선,가산디지털단지,51709,51616,103325,1
2020-01-15,8호선,잠실(송파구청),17385,20035,37420,1
2020-01-15,9호선,고속터미널,15100,19986,35086,1
2020-01-15,공항철도 1호선,서울역,13053,11153,24206,1
2020-01-15,공항철도 1호선,홍대입구,12349,12527,24876,1
2020-01-16,공항철도 1호선,홍대입구,12601,12765,25366,1
2020-01-16,공항철도 1호선,서울역,13258,11383,24641,1
2020-01-16,9호선,고속터미널,15562,20796,36358,1
2020-01-16,8호선,잠실(송파구청),17946,20263,38209,1
2020-01-16,7호선,가산디지털단지,51436,51895,103331,1
2020-01-16,7호선,고속터미널,20996,18076,39072,1
2020-01-16,경의선,서울역,1,0,1,1
2020-01-16,경의선,홍대입구,2151,2634,4785,1
2020-01-16,경의선,서울역,4829,6423,11252,1
2020-01-16,분당선,선릉,15594,25108,40702,1
2020-01-16,경부선,가산디지털단지,20789,24301,45090,1
2020-01-16,경부선,서울역,7286,1694,8980,1
2020-01-16,4호선,사당,31947,27396,59343,1
2020-01-16,4호선,서울역,16014,25657,41671,1
2020-01-16,3호선,고속터미널,57267,54944,112211,1
2020-01-16,2호선,홍대입구,80741,85552,166293,1
2020-01-16,2호선,구로디지털단지,74816,75121,149937,1
2020-01-16,2호선,신림,76716,74203,150919,1
2020-01-16,2호선,사당,48765,53008,101773,1
2020-01-16,2호선,강남,123030,124343,247373,1
2020-01-16,2호선,선릉,71359,63504,134863,1
2020-01-16,2호선,잠실(송파구청),92637,90400,183037,1
2020-01-16,1호선,서울역,61843,56697,118540,1
2020-01-17,1호선,서울역,69208,62321,131529,1
2020-01-17,2호선,잠실(송파구청),97679,94193,191872,1
2020-01-17,2호선,선릉,70725,63156,133881,1
2020-01-17,2호선,강남,129997,136864,266861,1
2020-01-17,2호선,사당,53076,58185,111261,1
2020-01-17,2호선,신림,79263,77090,156353,1
2020-01-17,2호선,구로디지털단지,76456,76883,153339,1
2020-01-17,2호선,홍대입구,86314,98551,184865,1
2020-01-17,3호선,고속터미널,66462,65405,131867,1
2020-01-17,4호선,서울역,16687,28811,45498,1
2020-01-17,4호선,사당,34600,30022,64622,1
2020-01-17,경부선,서울역,9335,2114,11449,1
2020-01-17,경부선,가산디지털단지,21572,24614,46186,1
2020-01-17,분당선,선릉,15459,25082,40541,1
2020-01-17,경의선,서울역,5214,6814,12028,1
2020-01-17,경의선,홍대입구,2270,2945,5215,1
2020-01-17,7호선,고속터미널,25008,20099,45107,1
2020-01-17,7호선,가산디지털단지,51411,51553,102964,1
2020-01-17,8호선,잠실(송파구청),18302,21365,39667,1
2020-01-17,9호선,고속터미널,17784,24393,42177,1
2020-01-17,공항철도 1호선,서울역,15865,13799,29664,1
2020-01-17,공항철도 1호선,홍대입구,13939,14920,28859,1
2020-01-18,1호선,서울역,51651,48048,99699,1
2020-01-18,2호선,잠실(송파구청),87802,83241,171043,1
2020-01-18,2호선,선릉,33366,29746,63112,1
2020-01-18,2호선,강남,93172,99551,192723,1
2020-01-18,2호선,사당,43116,47655,90771,1
2020-01-18,2호선,신림,63727,61293,125020,1
2020-01-18,2호선,구로디지털단지,47561,46819,94380,1
2020-01-18,2호선,홍대입구,97173,110721,207894,1
2020-01-18,3호선,고속터미널,73140,71346,144486,1
2020-01-18,4호선,서울역,9200,22453,31653,1
2020-01-18,4호선,사당,28774,25829,54603,1
2020-01-18,경부선,서울역,8495,1740,10235,1
2020-01-18,경부선,가산디지털단지,7814,10571,18385,1
2020-01-18,분당선,선릉,6646,10954,17600,1
2020-01-18,경의선,서울역,1807,2078,3885,1
2020-01-18,경의선,홍대입구,2602,3386,5988,1
2020-01-18,7호선,고속터미널,22159,16631,38790,1
2020-01-18,7호선,가산디지털단지,18565,17248,35813,1
2020-01-18,8호선,잠실(송파구청),16313,18629,34942,1
2020-01-18,9호선,고속터미널,17670,26285,43955,1
2020-01-18,공항철도 1호선,서울역,14154,13229,27383,1
2020-01-18,공항철도 1호선,홍대입구,15919,15573,31492,1
2020-01-19,1호선,서울역,38294,36289,74583,1
2020-01-19,2호선,잠실(송파구청),61657,57527,119184,1
2020-01-19,2호선,선릉,15927,13711,29638,1
2020-01-19,2호선,강남,54820,53801,108621,1
2020-01-19,2호선,사당,27858,30662,58520,1
2020-01-19,2호선,신림,47960,46521,94481,1
2020-01-19,2호선,구로디지털단지,33053,32822,65875,1
2020-01-19,2호선,홍대입구,75739,74313,150052,1
2020-01-19,3호선,고속터미널,53784,54963,108747,1
2020-01-19,4호선,서울역,6829,17376,24205,1
2020-01-19,4호선,사당,19293,18036,37329,1
2020-01-19,경부선,서울역,7359,1468,8827,1
2020-01-19,경부선,가산디지털단지,5511,7727,13238,1
2020-01-19,분당선,선릉,3022,4725,7747,1
2020-01-19,경의선,서울역,1365,1327,2692,1
2020-01-19,경의선,홍대입구,2081,2347,4428,1
2020-01-19,경의선,서울역,1,0,1,1
2020-01-19,7호선,고속터미널,15713,12157,27870,1
2020-01-19,7호선,가산디지털단지,13365,12281,25646,1
2020-01-19,8호선,잠실(송파구청),12693,13810,26503,1
2020-01-19,9호선,고속터미널,12652,19605,32257,1
2020-01-19,공항철도 1호선,서울역,13943,11842,25785,1
2020-01-19,공항철도 1호선,홍대입구,12513,10859,23372,1
2020-01-20,공항철도 1호선,홍대입구,12131,11678,23809,1
2020-01-20,공항철도 1호선,서울역,12857,11964,24821,1
2020-01-20,9호선,고속터미널,14919,20252,35171,1
2020-01-20,8호선,잠실(송파구청),17486,19992,37478,1
2020-01-20,7호선,가산디지털단지,51809,52143,103952,1
2020-01-20,7호선,고속터미널,21416,18059,39475,1
2020-01-20,경의선,홍대입구,2043,2335,4378,1
2020-01-20,경의선,서울역,4963,6569,11532,1
2020-01-20,분당선,선릉,15438,24938,40376,1
2020-01-20,경부선,가산디지털단지,21034,24461,45495,1
2020-01-20,경부선,서울역,6868,1737,8605,1
2020-01-20,4호선,사당,30663,25934,56597,1
2020-01-20,4호선,서울역,16059,25027,41086,1
2020-01-20,3호선,고속터미널,55697,54306,110003,1
2020-01-20,2호선,홍대입구,76767,79573,156340,1
2020-01-20,2호선,구로디지털단지,73952,74196,148148,1
2020-01-20,2호선,신림,75441,73030,148471,1
2020-01-20,2호선,사당,44874,49981,94855,1
2020-01-20,2호선,강남,119614,120537,240151,1
2020-01-20,2호선,선릉,69857,62642,132499,1
2020-01-20,2호선,잠실(송파구청),89741,87890,177631,1
2020-01-20,1호선,서울역,59190,57147,116337,1
2020-01-21,1호선,서울역,58638,57038,115676,1
2020-01-21,2호선,잠실(송파구청),90862,88162,179024,1
2020-01-21,2호선,선릉,70070,62176,132246,1
2020-01-21,2호선,강남,121647,122832,244479,1
2020-01-21,2호선,사당,46180,50870,97050,1
2020-01-21,2호선,신림,75247,73039,148286,1
2020-01-21,2호선,구로디지털단지,74974,75143,150117,1
2020-01-21,2호선,홍대입구,76578,80179,156757,1
2020-01-21,3호선,고속터미널,55817,57254,113071,1
2020-01-21,4호선,서울역,15923,25945,41868,1
2020-01-21,4호선,사당,31195,26371,57566,1
2020-01-21,경부선,서울역,6628,1730,8358,1
2020-01-21,경부선,가산디지털단지,21147,24365,45512,1
2020-01-21,분당선,선릉,15459,24668,40127,1
2020-01-21,경의선,서울역,4796,6269,11065,1
2020-01-21,경의선,홍대입구,2101,2527,4628,1
2020-01-21,경의선,서울역,1,0,1,1
2020-01-21,7호선,고속터미널,21142,18899,40041,1
2020-01-21,7호선,가산디지털단지,51498,51907,103405,1
2020-01-21,8호선,잠실(송파구청),17094,20034,37128,1
2020-01-21,9호선,고속터미널,14853,20879,35732,1
2020-01-21,공항철도 1호선,서울역,12790,11515,24305,1
2020-01-21,공항철도 1호선,홍대입구,12303,11844,24147,1
2020-01-22,9호선,고속터미널,14770,22993,37763,1
2020-01-22,공항철도 1호선,서울역,13354,12845,26199,1
2020-01-22,공항철도 1호선,홍대입구,12724,12046,24770,1
2020-01-22,1호선,서울역,56692,59402,116094,1
2020-01-22,2호선,잠실(송파구청),91953,87859,179812,1
2020-01-22,2호선,선릉,69302,61535,130837,1
2020-01-22,2호선,강남,120553,121856,242409,1
2020-01-22,2호선,사당,45931,50413,96344,1
2020-01-22,2호선,신림,76967,72978,149945,1
2020-01-22,2호선,구로디지털단지,74560,74805,149365,1
2020-01-22,2호선,홍대입구,77205,82290,159495,1
2020-01-22,3호선,고속터미널,54285,64702,118987,1
2020-01-22,4호선,서울역,15589,26257,41846,1
2020-01-22,4호선,사당,31197,25650,56847,1
2020-01-22,경부선,서울역,5940,1852,7792,1
2020-01-22,경부선,가산디지털단지,21353,24584,45937,1
2020-01-22,분당선,선릉,15053,24242,39295,1
2020-01-22,경의선,서울역,4825,6555,11380,1
2020-01-22,경의선,홍대입구,2194,2487,4681,1
2020-01-22,7호선,고속터미널,20238,19113,39351,1
2020-01-22,7호선,가산디지털단지,51642,51361,103003,1
2020-01-22,8호선,잠실(송파구청),17267,19956,37223,1
2020-01-23,1호선,서울역,55247,62901,118148,1
2020-01-23,2호선,잠실(송파구청),86020,84247,170267,1
2020-01-23,2호선,선릉,59150,51263,110413,1
2020-01-23,2호선,강남,111812,115448,227260,1
2020-01-23,2호선,사당,41163,45075,86238,1
2020-01-23,2호선,신림,75840,67624,143464,1
2020-01-23,2호선,구로디지털단지,70445,68230,138675,1
2020-01-23,2호선,홍대입구,75805,82758,158563,1
2020-01-23,3호선,고속터미널,56454,96688,153142,1
2020-01-23,4호선,서울역,14215,26133,40348,1
2020-01-23,4호선,사당,29446,23587,53033,1
2020-01-23,경부선,서울역,5854,1898,7752,1
2020-01-23,경부선,가산디지털단지,18658,21332,39990,1
2020-01-23,분당선,선릉,12850,20624,33474,1
2020-01-23,경의선,서울역,4278,6315,10593,1
2020-01-23,경의선,홍대입구,2105,2442,4547,1
2020-01-23,7호선,고속터미널,19199,23751,42950,1
2020-01-23,7호선,가산디지털단지,46975,45374,92349,1
2020-01-23,8호선,잠실(송파구청),17529,19910,37439,1
2020-01-23,9호선,고속터미널,14519,32263,46782,1
2020-01-23,공항철도 1호선,서울역,13197,14481,27678,1
2020-01-23,공항철도 1호선,홍대입구,12001,12208,24209,1
2020-01-24,8호선,잠실(송파구청),8805,9508,18313,1
2020-01-24,7호선,가산디지털단지,11030,9273,20303,1
2020-01-24,7호선,고속터미널,9970,13642,23612,1
2020-01-24,경의선,홍대입구,1319,1456,2775,1
2020-01-24,경의선,서울역,1320,1422,2742,1
2020-01-24,분당선,선릉,1899,2599,4498,1
2020-01-24,경부선,가산디지털단지,5053,6025,11078,1
2020-01-24,경부선,서울역,4284,1264,5548,1
2020-01-24,4호선,사당,12699,10141,22840,1
2020-01-24,4호선,서울역,5099,15526,20625,1
2020-01-24,3호선,고속터미널,31403,65199,96602,1
2020-01-24,2호선,홍대입구,48136,49441,97577,1
2020-01-24,2호선,구로디지털단지,23796,20981,44777,1
2020-01-24,2호선,신림,37666,28379,66045,1
2020-01-24,2호선,사당,16036,16502,32538,1
2020-01-24,2호선,강남,33186,33251,66437,1
2020-01-24,2호선,선릉,9470,7267,16737,1
2020-01-24,2호선,잠실(송파구청),41856,39512,81368,1
2020-01-24,1호선,서울역,32248,39786,72034,1
2020-01-24,공항철도 1호선,홍대입구,8200,7655,15855,1
2020-01-24,공항철도 1호선,서울역,10180,12784,22964,1
2020-01-24,9호선,고속터미널,7572,22403,29975,1
2020-01-25,1호선,서울역,35849,34423,70272,1
2020-01-25,2호선,잠실(송파구청),37015,34804,71819,1
2020-01-25,2호선,선릉,5613,5048,10661,1
2020-01-25,2호선,강남,18365,20003,38368,1
2020-01-25,2호선,사당,12336,13372,25708,1
2020-01-25,2호선,신림,27095,28289,55384,1
2020-01-25,2호선,구로디지털단지,18464,18963,37427,1
2020-01-25,2호선,홍대입구,37373,43471,80844,1
2020-01-25,3호선,고속터미널,32956,28370,61326,1
2020-01-25,4호선,서울역,5026,13578,18604,1
2020-01-25,4호선,사당,10484,8774,19258,1
2020-01-25,경부선,서울역,6400,1137,7537,1
2020-01-25,경부선,가산디지털단지,4339,5972,10311,1
2020-01-25,분당선,선릉,1098,1746,2844,1
2020-01-25,경의선,서울역,1323,1355,2678,1
2020-01-25,경의선,홍대입구,867,1324,2191,1
2020-01-25,7호선,고속터미널,16006,7488,23494,1
2020-01-25,7호선,가산디지털단지,8123,7241,15364,1
2020-01-25,8호선,잠실(송파구청),7146,8021,15167,1
2020-01-25,9호선,고속터미널,8114,9430,17544,1
2020-01-25,공항철도 1호선,서울역,12369,10578,22947,1
2020-01-25,공항철도 1호선,홍대입구,6364,6656,13020,1
2020-01-26,2호선,잠실(송파구청),51575,48090,99665,1
2020-01-26,2호선,선릉,8179,7882,16061,1
2020-01-26,2호선,강남,31769,35387,67156,1
2020-01-26,2호선,사당,19091,21379,40470,1
2020-01-26,2호선,신림,34291,39207,73498,1
2020-01-26,2호선,구로디지털단지,25232,26726,51958,1
2020-01-26,2호선,홍대입구,56309,64972,121281,1
2020-01-26,3호선,고속터미널,59992,36321,96313,1
2020-01-26,4호선,서울역,5701,12704,18405,1
2020-01-26,4호선,사당,14120,12840,26960,1
2020-01-26,경부선,서울역,7200,946,8146,1
2020-01-26,경부선,가산디지털단지,4842,7338,12180,1
2020-01-26,분당선,선릉,1623,2777,4400,1
2020-01-26,경의선,서울역,1474,1118,2592,1
2020-01-26,경의선,홍대입구,1423,2048,3471,1
2020-01-26,7호선,고속터미널,23110,8089,31199,1
2020-01-26,7호선,가산디지털단지,11596,11082,22678,1
2020-01-26,8호선,잠실(송파구청),10912,12117,23029,1
2020-01-26,9호선,고속터미널,14160,12056,26216,1
2020-01-26,공항철도 1호선,서울역,14480,9077,23557,1
2020-01-26,공항철도 1호선,홍대입구,9060,9601,18661,1
2020-01-26,1호선,서울역,40076,28841,68917,1
2020-01-27,2호선,잠실(송파구청),52788,50048,102836,1
2020-01-27,2호선,선릉,12699,11775,24474,1
2020-01-27,2호선,강남,42470,42586,85056,1
2020-01-27,2호선,사당,21403,24603,46006,1
2020-01-27,2호선,신림,37467,41210,78677,1
2020-01-27,2호선,구로디지털단지,26557,28015,54572,1
2020-01-27,2호선,홍대입구,59328,62335,121663,1
2020-01-27,3호선,고속터미널,64244,39980,104224,1
2020-01-27,4호선,서울역,5213,12680,17893,1
2020-01-27,4호선,사당,14622,13866,28488,1
2020-01-27,경부선,서울역,8580,1153,9733,1
2020-01-27,경부선,가산디지털단지,4834,6733,11567,1
2020-01-27,분당선,선릉,2539,4321,6860,1
2020-01-27,경의선,서울역,1492,1079,2571,1
2020-01-27,경의선,홍대입구,1434,1883,3317,1
2020-01-27,7호선,고속터미널,23321,8898,32219,1
2020-01-27,7호선,가산디지털단지,11518,11416,22934,1
2020-01-27,8호선,잠실(송파구청),11618,12676,24294,1
2020-01-27,9호선,고속터미널,14641,13514,28155,1
2020-01-27,공항철도 1호선,서울역,14715,10477,25192,1
2020-01-27,공항철도 1호선,홍대입구,9298,9152,18450,1
2020-01-27,1호선,서울역,41239,31184,72423,1
2020-01-28,2호선,잠실(송파구청),75376,74128,149504,1
2020-01-28,2호선,선릉,60221,53610,113831,1
2020-01-28,2호선,강남,99953,101282,201235,1
2020-01-28,2호선,사당,39193,43472,82665,1
2020-01-28,2호선,신림,68218,67766,135984,1
2020-01-28,2호선,구로디지털단지,66984,67108,134092,1
2020-01-28,2호선,홍대입구,67507,72390,139897,1
2020-01-28,3호선,고속터미널,52376,42944,95320,1
2020-01-28,4호선,서울역,13636,20132,33768,1
2020-01-28,4호선,사당,26449,22885,49334,1
2020-01-28,경부선,서울역,8072,1456,9528,1
2020-01-28,경부선,가산디지털단지,19081,21549,40630,1
2020-01-28,분당선,선릉,13262,21307,34569,1
2020-01-28,경의선,서울역,4588,5490,10078,1
2020-01-28,경의선,홍대입구,1906,2133,4039,1
2020-01-28,7호선,고속터미널,22964,15291,38255,1
2020-01-28,7호선,가산디지털단지,46780,47148,93928,1
2020-01-28,8호선,잠실(송파구청),14906,16865,31771,1
2020-01-28,9호선,고속터미널,13870,16387,30257,1
2020-01-28,공항철도 1호선,서울역,13616,9572,23188,1
2020-01-28,공항철도 1호선,홍대입구,10574,10444,21018,1
2020-01-28,1호선,서울역,55784,46389,102173,1
2020-01-29,2호선,잠실(송파구청),78801,76812,155613,1
2020-01-29,2호선,선릉,65259,58109,123368,1
2020-01-29,2호선,강남,106844,107871,214715,1
2020-01-29,2호선,사당,42831,46851,89682,1
2020-01-29,2호선,신림,72308,70664,142972,1
2020-01-29,2호선,구로디지털단지,70508,70993,141501,1
2020-01-29,2호선,홍대입구,68126,72676,140802,1
2020-01-29,3호선,고속터미널,46965,43772,90737,1
2020-01-29,4호선,서울역,14845,22003,36848,1
2020-01-29,4호선,사당,28533,24373,52906,1
2020-01-29,경부선,서울역,6651,1504,8155,1
2020-01-29,경부선,가산디지털단지,20613,23398,44011,1
2020-01-29,분당선,선릉,14616,23611,38227,1
2020-01-29,경의선,서울역,4612,5861,10473,1
2020-01-29,경의선,홍대입구,1878,2262,4140,1
2020-01-29,7호선,고속터미널,19769,15689,35458,1
2020-01-29,7호선,가산디지털단지,49712,50337,100049,1
2020-01-29,8호선,잠실(송파구청),15292,17740,33032,1
2020-01-29,9호선,고속터미널,12739,16824,29563,1
2020-01-29,공항철도 1호선,서울역,11921,9575,21496,1
2020-01-29,공항철도 1호선,홍대입구,10983,11406,22389,1
2020-01-29,1호선,서울역,56226,50057,106283,1
2020-01-30,공항철도 1호선,홍대입구,11092,11288,22380,1
2020-01-30,공항철도 1호선,서울역,11771,9783,21554,1
2020-01-30,9호선,고속터미널,12895,17370,30265,1
2020-01-30,8호선,잠실(송파구청),15733,17984,33717,1
2020-01-30,7호선,가산디지털단지,49804,50790,100594,1
2020-01-30,7호선,고속터미널,19626,16019,35645,1
2020-01-30,경의선,홍대입구,1959,2215,4174,1
2020-01-30,경의선,서울역,4662,5803,10465,1
2020-01-30,분당선,선릉,14703,23597,38300,1
2020-01-30,경부선,가산디지털단지,20645,23555,44200,1
2020-01-30,경부선,서울역,6215,1400,7615,1
2020-01-30,4호선,사당,29073,25015,54088,1
2020-01-30,4호선,서울역,15046,22438,37484,1
2020-01-30,3호선,고속터미널,46824,44865,91689,1
2020-01-30,2호선,홍대입구,70210,74396,144606,1
2020-01-30,2호선,구로디지털단지,71306,71596,142902,1
2020-01-30,2호선,신림,72365,70256,142621,1
2020-01-30,2호선,사당,43899,47594,91493,1
2020-01-30,2호선,강남,106050,108133,214183,1
2020-01-30,2호선,선릉,67058,59576,126634,1
2020-01-30,2호선,잠실(송파구청),80368,78540,158908,1
2020-01-30,1호선,서울역,55339,50836,106175,1
2020-01-31,1호선,서울역,58277,54060,112337,1
2020-01-31,2호선,잠실(송파구청),80783,78372,159155,1
2020-01-31,2호선,선릉,65582,58482,124064,1
2020-01-31,2호선,강남,108233,112821,221054,1
2020-01-31,2호선,사당,46151,50496,96647,1
2020-01-31,2호선,신림,74018,72346,146364,1
2020-01-31,2호선,구로디지털단지,71642,71634,143276,1
2020-01-31,2호선,홍대입구,70875,79651,150526,1
2020-01-31,3호선,고속터미널,50449,50455,100904,1
2020-01-31,4호선,서울역,15247,23993,39240,1
2020-01-31,4호선,사당,30309,26176,56485,1
2020-01-31,경부선,서울역,7635,1785,9420,1
2020-01-31,경부선,가산디지털단지,20553,23479,44032,1
2020-01-31,분당선,선릉,14315,23336,37651,1
2020-01-31,경의선,서울역,4791,6070,10861,1
2020-01-31,경의선,홍대입구,1933,2446,4379,1
2020-01-31,7호선,고속터미널,20292,16424,36716,1
2020-01-31,7호선,가산디지털단지,49763,50155,99918,1
2020-01-31,8호선,잠실(송파구청),15679,18570,34249,1
2020-01-31,9호선,고속터미널,13750,19041,32791,1
2020-01-31,공항철도 1호선,서울역,13100,10935,24035,1
2020-01-31,공항철도 1호선,홍대입구,11310,11954,23264,1
2020-02-01,2호선,잠실(송파구청),58011,55089,113100,2
2020-02-01,2호선,선릉,26026,23009,49035,2
2020-02-01,2호선,강남,65598,69156,134754,2
2020-02-01,2호선,사당,34268,37016,71284,2
2020-02-01,2호선,신림,53866,51985,105851,2
2020-02-01,2호선,구로디지털단지,37857,37681,75538,2
2020-02-01,2호선,홍대입구,69648,78330,147978,2
2020-02-01,3호선,고속터미널,48285,47465,95750,2
2020-02-01,4호선,서울역,6792,15379,22171,2
2020-02-01,4호선,사당,21990,20185,42175,2
2020-02-01,경부선,서울역,5226,1123,6349,2
2020-02-01,경부선,가산디지털단지,5927,7739,13666,2
2020-02-01,분당선,선릉,5028,8499,13527,2
2020-02-01,경의선,서울역,1244,1494,2738,2
2020-02-01,경의선,홍대입구,1816,2183,3999,2
2020-02-01,7호선,고속터미널,15403,11972,27375,2
2020-02-01,7호선,가산디지털단지,14267,13219,27486,2
2020-02-01,8호선,잠실(송파구청),11358,13031,24389,2
2020-02-01,9호선,고속터미널,11048,16729,27777,2
2020-02-01,공항철도 1호선,서울역,10865,9930,20795,2
2020-02-01,공항철도 1호선,홍대입구,11464,11581,23045,2
2020-02-01,1호선,서울역,34375,33070,67445,2
2020-02-02,1호선,서울역,27746,25860,53606,2
2020-02-02,2호선,잠실(송파구청),41970,38764,80734,2
2020-02-02,2호선,선릉,13444,11679,25123,2
2020-02-02,2호선,강남,37382,36531,73913,2
2020-02-02,2호선,사당,23229,24536,47765,2
2020-02-02,2호선,신림,40218,38819,79037,2
2020-02-02,2호선,구로디지털단지,25749,25665,51414,2
2020-02-02,2호선,홍대입구,54803,53722,108525,2
2020-02-02,3호선,고속터미널,36088,35775,71863,2
2020-02-02,4호선,서울역,5374,12014,17388,2
2020-02-02,4호선,사당,15153,14389,29542,2
2020-02-02,경부선,서울역,4997,925,5922,2
2020-02-02,경부선,가산디지털단지,4069,5407,9476,2
2020-02-02,분당선,선릉,2535,4219,6754,2
2020-02-02,경의선,서울역,949,944,1893,2
2020-02-02,경의선,홍대입구,1486,1717,3203,2
2020-02-02,경의선,서울역,2,0,2,2
2020-02-02,7호선,고속터미널,11255,8590,19845,2
2020-02-02,7호선,가산디지털단지,9082,8593,17675,2
2020-02-02,8호선,잠실(송파구청),8837,9431,18268,2
2020-02-02,9호선,고속터미널,8479,12937,21416,2
2020-02-02,공항철도 1호선,서울역,10516,8602,19118,2
2020-02-02,공항철도 1호선,홍대입구,9552,8682,18234,2
2020-02-03,1호선,서울역,48307,46039,94346,2
2020-02-03,2호선,잠실(송파구청),72031,70736,142767,2
2020-02-03,2호선,선릉,63324,56654,119978,2
2020-02-03,2호선,강남,100352,101584,201936,2
2020-02-03,2호선,사당,38713,42878,81591,2
2020-02-03,2호선,신림,68681,66920,135601,2
2020-02-03,2호선,구로디지털단지,67861,68039,135900,2
2020-02-03,2호선,홍대입구,61615,63969,125584,2
2020-02-03,3호선,고속터미널,40831,38708,79539,2
2020-02-03,4호선,서울역,13848,19749,33597,2
2020-02-03,4호선,사당,26435,21951,48386,2
2020-02-03,경부선,서울역,5014,1497,6511,2
2020-02-03,경부선,가산디지털단지,19884,22679,42563,2
2020-02-03,분당선,선릉,14173,22705,36878,2
2020-02-03,경의선,서울역,4334,5510,9844,2
2020-02-03,경의선,홍대입구,1549,1851,3400,2
2020-02-03,7호선,고속터미널,16874,14215,31089,2
2020-02-03,7호선,가산디지털단지,48603,49437,98040,2
2020-02-03,8호선,잠실(송파구청),14444,16349,30793,2
2020-02-03,9호선,고속터미널,11286,15305,26591,2
2020-02-03,공항철도 1호선,서울역,10045,8761,18806,2
2020-02-03,공항철도 1호선,홍대입구,9778,9814,19592,2
2020-02-04,1호선,서울역,48476,45855,94331,2
2020-02-04,2호선,잠실(송파구청),73810,71859,145669,2
2020-02-04,2호선,선릉,64433,57180,121613,2
2020-02-04,2호선,강남,103200,103228,206428,2
2020-02-04,2호선,사당,40378,43668,84046,2
2020-02-04,2호선,신림,69572,68381,137953,2
2020-02-04,2호선,구로디지털단지,68371,68631,137002,2
2020-02-04,2호선,홍대입구,62935,65944,128879,2
2020-02-04,3호선,고속터미널,40058,38177,78235,2
2020-02-04,4호선,서울역,14109,19807,33916,2
2020-02-04,4호선,사당,27069,22782,49851,2
2020-02-04,경부선,서울역,4564,1305,5869,2
2020-02-04,경부선,가산디지털단지,19463,22435,41898,2
2020-02-04,분당선,선릉,14304,22741,37045,2
2020-02-04,경의선,서울역,4297,5500,9797,2
2020-02-04,경의선,홍대입구,1638,1853,3491,2
2020-02-04,경의선,서울역,1,0,1,2
2020-02-04,7호선,고속터미널,16008,14081,30089,2
2020-02-04,7호선,가산디지털단지,49428,49163,98591,2
2020-02-04,8호선,잠실(송파구청),14539,16381,30920,2
2020-02-04,9호선,고속터미널,11340,15021,26361,2
2020-02-04,공항철도 1호선,서울역,9756,8243,17999,2
2020-02-04,공항철도 1호선,홍대입구,10123,10392,20515,2
2020-02-05,1호선,서울역,46922,44674,91596,2
2020-02-05,2호선,잠실(송파구청),72954,71788,144742,2
2020-02-05,2호선,선릉,63230,56110,119340,2
2020-02-05,2호선,강남,102545,103379,205924,2
2020-02-05,2호선,사당,39729,42689,82418,2
2020-02-05,2호선,신림,68551,66599,135150,2
2020-02-05,2호선,구로디지털단지,66827,67502,134329,2
2020-02-05,2호선,홍대입구,63059,66026,129085,2
2020-02-05,3호선,고속터미널,40045,38165,78210,2
2020-02-05,4호선,서울역,13663,19231,32894,2
2020-02-05,4호선,사당,26536,22294,48830,2
2020-02-05,경부선,서울역,4664,1341,6005,2
2020-02-05,경부선,가산디지털단지,18943,21875,40818,2
2020-02-05,분당선,선릉,13964,22417,36381,2
2020-02-05,경의선,서울역,4273,5402,9675,2
2020-02-05,경의선,홍대입구,1527,1965,3492,2
2020-02-05,7호선,고속터미널,15503,13590,29093,2
2020-02-05,7호선,가산디지털단지,48461,48723,97184,2
2020-02-05,8호선,잠실(송파구청),14401,16644,31045,2
2020-02-05,9호선,고속터미널,11025,14997,26022,2
2020-02-05,공항철도 1호선,서울역,9896,8151,18047,2
2020-02-05,공항철도 1호선,홍대입구,10242,10295,20537,2
2020-02-06,1호선,서울역,47433,44662,92095,2
2020-02-06,2호선,잠실(송파구청),71464,69150,140614,2
2020-02-06,2호선,선릉,62378,55752,118130,2
2020-02-06,2호선,강남,101782,102485,204267,2
2020-02-06,2호선,사당,39375,42821,82196,2
2020-02-06,2호선,신림,68172,66276,134448,2
2020-02-06,2호선,구로디지털단지,66697,67009,133706,2
2020-02-06,2호선,홍대입구,63111,66274,129385,2
2020-02-06,3호선,고속터미널,39941,38833,78774,2
2020-02-06,4호선,서울역,13943,19588,33531,2
2020-02-06,4호선,사당,26460,22372,48832,2
2020-02-06,경부선,서울역,4586,1278,5864,2
2020-02-06,경부선,가산디지털단지,19129,21584,40713,2
2020-02-06,분당선,선릉,13735,22333,36068,2
2020-02-06,경의선,서울역,4153,5378,9531,2
2020-02-06,경의선,홍대입구,1702,1917,3619,2
2020-02-06,7호선,고속터미널,15629,13753,29382,2
2020-02-06,7호선,가산디지털단지,47784,48433,96217,2
2020-02-06,8호선,잠실(송파구청),13607,15797,29404,2
2020-02-06,9호선,고속터미널,11072,14740,25812,2
2020-02-06,공항철도 1호선,서울역,9541,8075,17616,2
2020-02-06,공항철도 1호선,홍대입구,9935,10384,20319,2
2020-02-07,1호선,서울역,53092,49805,102897,2
2020-02-07,2호선,잠실(송파구청),74405,70983,145388,2
2020-02-07,2호선,선릉,63327,56242,119569,2
2020-02-07,2호선,강남,106007,110312,216319,2
2020-02-07,2호선,사당,42372,46504,88876,2
2020-02-07,2호선,신림,71326,69380,140706,2
2020-02-07,2호선,구로디지털단지,69178,69194,138372,2
2020-02-07,2호선,홍대입구,66760,75006,141766,2
2020-02-07,3호선,고속터미널,45957,47438,93395,2
2020-02-07,4호선,서울역,14249,21793,36042,2
2020-02-07,4호선,사당,28410,24108,52518,2
2020-02-07,경부선,서울역,6577,1726,8303,2
2020-02-07,경부선,가산디지털단지,19833,22320,42153,2
2020-02-07,분당선,선릉,13750,22186,35936,2
2020-02-07,경의선,서울역,4479,5610,10089,2
2020-02-07,경의선,홍대입구,1849,2196,4045,2
2020-02-07,7호선,고속터미널,17938,14973,32911,2
2020-02-07,7호선,가산디지털단지,48482,48501,96983,2
2020-02-07,8호선,잠실(송파구청),14207,16420,30627,2
2020-02-07,9호선,고속터미널,12516,17748,30264,2
2020-02-07,공항철도 1호선,서울역,11045,10059,21104,2
2020-02-07,공항철도 1호선,홍대입구,10797,11357,22154,2
2020-02-08,2호선,잠실(송파구청),54268,50172,104440,2
2020-02-08,2호선,선릉,27064,23749,50813,2
2020-02-08,2호선,강남,66548,69937,136485,2
2020-02-08,2호선,사당,31721,35093,66814,2
2020-02-08,2호선,신림,52486,50431,102917,2
2020-02-08,2호선,구로디지털단지,36414,36367,72781,2
2020-02-08,2호선,홍대입구,67318,75947,143265,2
2020-02-08,3호선,고속터미널,45894,45634,91528,2
2020-02-08,4호선,서울역,6405,13734,20139,2
2020-02-08,4호선,사당,21046,19038,40084,2
2020-02-08,경부선,서울역,4560,1062,5622,2
2020-02-08,경부선,가산디지털단지,5543,7353,12896,2
2020-02-08,분당선,선릉,5030,8725,13755,2
2020-02-08,경의선,서울역,1121,1210,2331,2
2020-02-08,경의선,홍대입구,1688,2095,3783,2
2020-02-08,7호선,고속터미널,14144,11050,25194,2
2020-02-08,7호선,가산디지털단지,13047,11951,24998,2
2020-02-08,8호선,잠실(송파구청),10138,11829,21967,2
2020-02-08,1호선,서울역,31425,32139,63564,2
2020-02-08,9호선,고속터미널,10724,16220,26944,2
2020-02-08,공항철도 1호선,서울역,9330,8679,18009,2
2020-02-08,공항철도 1호선,홍대입구,10955,11290,22245,2
2020-02-09,1호선,서울역,25067,23190,48257,2
2020-02-09,2호선,잠실(송파구청),40385,37265,77650,2
2020-02-09,2호선,선릉,13227,11927,25154,2
2020-02-09,2호선,강남,40663,39982,80645,2
2020-02-09,2호선,사당,22360,24105,46465,2
2020-02-09,2호선,신림,39631,38692,78323,2
2020-02-09,2호선,구로디지털단지,25221,24912,50133,2
2020-02-09,2호선,홍대입구,55518,55411,110929,2
2020-02-09,3호선,고속터미널,38085,36400,74485,2
2020-02-09,4호선,서울역,5340,10872,16212,2
2020-02-09,4호선,사당,15141,14196,29337,2
2020-02-09,경부선,서울역,4797,1008,5805,2
2020-02-09,경부선,가산디지털단지,3978,5314,9292,2
2020-02-09,분당선,선릉,2537,4200,6737,2
2020-02-09,경의선,서울역,923,874,1797,2
2020-02-09,경의선,홍대입구,1560,1730,3290,2
2020-02-09,7호선,고속터미널,11279,8570,19849,2
2020-02-09,7호선,가산디지털단지,8880,8238,17118,2
2020-02-09,8호선,잠실(송파구청),8044,8665,16709,2
2020-02-09,9호선,고속터미널,9205,13247,22452,2
2020-02-09,공항철도 1호선,서울역,9769,7775,17544,2
2020-02-09,공항철도 1호선,홍대입구,9447,8572,18019,2
2020-02-10,1호선,서울역,48317,46088,94405,2
2020-02-10,2호선,잠실(송파구청),69697,67781,137478,2
2020-02-10,2호선,선릉,63799,57024,120823,2
2020-02-10,2호선,강남,103591,104910,208501,2
2020-02-10,2호선,사당,39054,43198,82252,2
2020-02-10,2호선,신림,68684,66718,135402,2
2020-02-10,2호선,구로디지털단지,67547,68200,135747,2
2020-02-10,2호선,홍대입구,64580,68102,132682,2
2020-02-10,3호선,고속터미널,37782,35128,72910,2
2020-02-10,4호선,서울역,13934,19932,33866,2
2020-02-10,4호선,사당,26273,22433,48706,2
2020-02-10,경부선,서울역,4960,1343,6303,2
2020-02-10,경부선,가산디지털단지,20489,22745,43234,2
2020-02-10,분당선,선릉,14070,22642,36712,2
2020-02-10,경의선,서울역,4458,5670,10128,2
2020-02-10,경의선,홍대입구,1698,1994,3692,2
2020-02-10,7호선,고속터미널,16862,13872,30734,2
2020-02-10,7호선,가산디지털단지,48601,49702,98303,2
2020-02-10,8호선,잠실(송파구청),13604,15594,29198,2
2020-02-10,9호선,고속터미널,11176,15403,26579,2
2020-02-10,공항철도 1호선,서울역,10576,9047,19623,2
2020-02-10,공항철도 1호선,홍대입구,10671,10339,21010,2
2020-02-11,1호선,서울역,48277,46129,94406,2
2020-02-11,2호선,잠실(송파구청),76655,74480,151135,2
2020-02-11,2호선,선릉,65259,58128,123387,2
2020-02-11,2호선,강남,106091,107900,213991,2
2020-02-11,2호선,사당,41263,45301,86564,2
2020-02-11,2호선,신림,70545,68368,138913,2
2020-02-11,2호선,구로디지털단지,69538,69974,139512,2
2020-02-11,2호선,홍대입구,66567,70247,136814,2
2020-02-11,3호선,고속터미널,43394,41968,85362,2
2020-02-11,4호선,서울역,14252,19931,34183,2
2020-02-11,4호선,사당,27883,23418,51301,2
2020-02-11,경부선,서울역,4579,1278,5857,2
2020-02-11,경부선,가산디지털단지,20819,23009,43828,2
2020-02-11,분당선,선릉,14469,23218,37687,2
2020-02-11,경의선,서울역,4401,5652,10053,2
2020-02-11,경의선,홍대입구,1886,2145,4031,2
2020-02-11,7호선,고속터미널,16937,14729,31666,2
2020-02-11,7호선,가산디지털단지,49091,50071,99162,2
2020-02-11,8호선,잠실(송파구청),14257,16741,30998,2
2020-02-11,9호선,고속터미널,12053,16034,28087,2
2020-02-11,공항철도 1호선,서울역,10442,8327,18769,2
2020-02-11,공항철도 1호선,홍대입구,10851,10590,21441,2
2020-02-12,1호선,서울역,47850,45385,93235,2
2020-02-12,2호선,잠실(송파구청),72665,71020,143685,2
2020-02-12,2호선,선릉,64220,56880,121100,2
2020-02-12,2호선,강남,104164,104777,208941,2
2020-02-12,2호선,사당,40280,43988,84268,2
2020-02-12,2호선,신림,68653,67056,135709,2
2020-02-12,2호선,구로디지털단지,67205,67924,135129,2
2020-02-12,2호선,홍대입구,62346,66542,128888,2
2020-02-12,3호선,고속터미널,42389,40638,83027,2
2020-02-12,4호선,서울역,13891,19860,33751,2
2020-02-12,4호선,사당,27486,23046,50532,2
2020-02-12,경부선,서울역,4902,1341,6243,2
2020-02-12,경부선,가산디지털단지,19822,22358,42180,2
2020-02-12,분당선,선릉,14283,22690,36973,2
2020-02-12,경의선,서울역,4199,5356,9555,2
2020-02-12,경의선,홍대입구,1671,2042,3713,2
2020-02-12,7호선,고속터미널,16355,14228,30583,2
2020-02-12,7호선,가산디지털단지,48415,48869,97284,2
2020-02-12,8호선,잠실(송파구청),14356,16552,30908,2
2020-02-12,9호선,고속터미널,11570,15947,27517,2
2020-02-12,공항철도 1호선,서울역,10019,8420,18439,2
2020-02-12,공항철도 1호선,홍대입구,10170,10185,20355,2
2020-02-13,1호선,서울역,50232,47437,97669,2
2020-02-13,2호선,잠실(송파구청),79076,76961,156037,2
2020-02-13,2호선,선릉,65276,58558,123834,2
2020-02-13,2호선,강남,108592,109881,218473,2
2020-02-13,2호선,사당,42287,46494,88781,2
2020-02-13,2호선,신림,71430,69442,140872,2
2020-02-13,2호선,구로디지털단지,70270,70047,140317,2
2020-02-13,2호선,홍대입구,70215,75160,145375,2
2020-02-13,3호선,고속터미널,46505,44726,91231,2
2020-02-13,4호선,서울역,14237,20761,34998,2
2020-02-13,4호선,사당,28630,24360,52990,2
2020-02-13,경부선,서울역,5083,1374,6457,2
2020-02-13,경부선,가산디지털단지,20559,23135,43694,2
2020-02-13,분당선,선릉,14332,23266,37598,2
2020-02-13,경의선,서울역,4339,5674,10013,2
2020-02-13,경의선,홍대입구,1869,2210,4079,2
2020-02-13,7호선,고속터미널,17495,15248,32743,2
2020-02-13,7호선,가산디지털단지,48895,50072,98967,2
2020-02-13,8호선,잠실(송파구청),15378,17624,33002,2
2020-02-13,9호선,고속터미널,12558,17066,29624,2
2020-02-13,공항철도 1호선,서울역,10260,8627,18887,2
2020-02-13,공항철도 1호선,홍대입구,11039,11311,22350,2
2020-02-14,9호선,고속터미널,14500,20446,34946,2
2020-02-14,공항철도 1호선,서울역,12643,11033,23676,2
2020-02-14,공항철도 1호선,홍대입구,12606,12895,25501,2
2020-02-14,1호선,서울역,56171,52470,108641,2
2020-02-14,2호선,잠실(송파구청),85045,82142,167187,2
2020-02-14,2호선,선릉,65557,58337,123894,2
2020-02-14,2호선,강남,113614,119315,232929,2
2020-02-14,2호선,사당,45905,50455,96360,2
2020-02-14,2호선,신림,74964,73124,148088,2
2020-02-14,2호선,구로디지털단지,72247,72004,144251,2
2020-02-14,2호선,홍대입구,76030,87780,163810,2
2020-02-14,3호선,고속터미널,54910,56984,111894,2
2020-02-14,4호선,서울역,14808,23382,38190,2
2020-02-14,4호선,사당,31026,26338,57364,2
2020-02-14,경부선,서울역,7168,1899,9067,2
2020-02-14,경부선,가산디지털단지,20733,22499,43232,2
2020-02-14,분당선,선릉,14270,23208,37478,2
2020-02-14,경의선,서울역,4589,6127,10716,2
2020-02-14,경의선,홍대입구,2130,2751,4881,2
2020-02-14,7호선,고속터미널,20185,16762,36947,2
2020-02-14,7호선,가산디지털단지,49656,50152,99808,2
2020-02-14,8호선,잠실(송파구청),16303,19144,35447,2
2020-02-15,1호선,서울역,36339,36476,72815,2
2020-02-15,2호선,잠실(송파구청),67531,63648,131179,2
2020-02-15,2호선,선릉,28554,25401,53955,2
2020-02-15,2호선,강남,75772,80458,156230,2
2020-02-15,2호선,사당,35184,38671,73855,2
2020-02-15,2호선,신림,56507,54467,110974,2
2020-02-15,2호선,구로디지털단지,40829,40075,80904,2
2020-02-15,2호선,홍대입구,77574,87171,164745,2
2020-02-15,3호선,고속터미널,55262,54961,110223,2
2020-02-15,4호선,서울역,7099,15806,22905,2
2020-02-15,4호선,사당,23519,20863,44382,2
2020-02-15,경부선,서울역,5597,1286,6883,2
2020-02-15,경부선,가산디지털단지,6234,8210,14444,2
2020-02-15,분당선,선릉,5522,9433,14955,2
2020-02-15,경의선,서울역,1358,1501,2859,2
2020-02-15,경의선,홍대입구,2015,2532,4547,2
2020-02-15,경의선,서울역,1,0,1,2
2020-02-15,7호선,고속터미널,17070,13278,30348,2
2020-02-15,7호선,가산디지털단지,14992,13787,28779,2
2020-02-15,8호선,잠실(송파구청),12920,14816,27736,2
2020-02-15,9호선,고속터미널,12780,19246,32026,2
2020-02-15,공항철도 1호선,서울역,9947,9775,19722,2
2020-02-15,공항철도 1호선,홍대입구,12529,12476,25005,2
2020-02-16,1호선,서울역,29311,25874,55185,2
2020-02-16,2호선,잠실(송파구청),47279,44438,91717,2
2020-02-16,2호선,선릉,14144,12323,26467,2
2020-02-16,2호선,강남,43892,43610,87502,2
2020-02-16,2호선,사당,23113,24927,48040,2
2020-02-16,2호선,신림,41356,40389,81745,2
2020-02-16,2호선,구로디지털단지,26626,26704,53330,2
2020-02-16,2호선,홍대입구,58925,57965,116890,2
2020-02-16,3호선,고속터미널,44074,41850,85924,2
2020-02-16,4호선,서울역,5266,12322,17588,2
2020-02-16,4호선,사당,15895,15077,30972,2
2020-02-16,경부선,서울역,5770,1186,6956,2
2020-02-16,경부선,가산디지털단지,4015,5599,9614,2
2020-02-16,분당선,선릉,2800,4630,7430,2
2020-02-16,경의선,서울역,994,886,1880,2
2020-02-16,경의선,홍대입구,1551,1805,3356,2
2020-02-16,7호선,고속터미널,13109,9652,22761,2
2020-02-16,7호선,가산디지털단지,9914,9222,19136,2
2020-02-16,8호선,잠실(송파구청),10105,11118,21223,2
2020-02-16,9호선,고속터미널,9529,14428,23957,2
2020-02-16,공항철도 1호선,서울역,10562,8379,18941,2
2020-02-16,공항철도 1호선,홍대입구,9269,8716,17985,2
2020-02-17,1호선,서울역,50340,47562,97902,2
2020-02-17,2호선,잠실(송파구청),74923,73398,148321,2
2020-02-17,2호선,선릉,65325,58521,123846,2
2020-02-17,2호선,강남,106675,109029,215704,2
2020-02-17,2호선,사당,39215,43691,82906,2
2020-02-17,2호선,신림,69271,67343,136614,2
2020-02-17,2호선,구로디지털단지,68684,69483,138167,2
2020-02-17,2호선,홍대입구,65195,68124,133319,2
2020-02-17,3호선,고속터미널,44911,42764,87675,2
2020-02-17,4호선,서울역,14180,20755,34935,2
2020-02-17,4호선,사당,27101,23060,50161,2
2020-02-17,경부선,서울역,5741,1664,7405,2
2020-02-17,경부선,가산디지털단지,19915,23049,42964,2
2020-02-17,분당선,선릉,14593,23447,38040,2
2020-02-17,경의선,서울역,4583,6010,10593,2
2020-02-17,경의선,홍대입구,1585,2021,3606,2
2020-02-17,7호선,고속터미널,17564,14953,32517,2
2020-02-17,7호선,가산디지털단지,50184,50874,101058,2
2020-02-17,8호선,잠실(송파구청),15197,17516,32713,2
2020-02-17,9호선,고속터미널,12281,16908,29189,2
2020-02-17,공항철도 1호선,서울역,10502,9254,19756,2
2020-02-17,공항철도 1호선,홍대입구,9941,10389,20330,2
2020-02-18,1호선,서울역,49301,46801,96102,2
2020-02-18,2호선,잠실(송파구청),77833,75852,153685,2
2020-02-18,2호선,선릉,66348,59042,125390,2
2020-02-18,2호선,강남,109332,110513,219845,2
2020-02-18,2호선,사당,41317,45301,86618,2
2020-02-18,2호선,신림,69278,67863,137141,2
2020-02-18,2호선,구로디지털단지,69454,69654,139108,2
2020-02-18,2호선,홍대입구,69587,73199,142786,2
2020-02-18,3호선,고속터미널,44601,42587,87188,2
2020-02-18,4호선,서울역,14157,20204,34361,2
2020-02-18,4호선,사당,28076,23498,51574,2
2020-02-18,경부선,서울역,5051,1366,6417,2
2020-02-18,경부선,가산디지털단지,19953,22450,42403,2
2020-02-18,분당선,선릉,14556,23498,38054,2
2020-02-18,경의선,서울역,4384,5579,9963,2
2020-02-18,경의선,홍대입구,1853,2168,4021,2
2020-02-18,7호선,고속터미널,17032,14883,31915,2
2020-02-18,7호선,가산디지털단지,49324,50215,99539,2
2020-02-18,8호선,잠실(송파구청),15173,17495,32668,2
2020-02-18,9호선,고속터미널,12176,16686,28862,2
2020-02-18,공항철도 1호선,서울역,9615,8282,17897,2
2020-02-18,공항철도 1호선,홍대입구,10689,10808,21497,2
2020-02-19,1호선,서울역,49978,47110,97088,2
2020-02-19,2호선,잠실(송파구청),79734,77938,157672,2
2020-02-19,2호선,선릉,65909,58988,124897,2
2020-02-19,2호선,강남,109058,110042,219100,2
2020-02-19,2호선,사당,42458,46496,88954,2
2020-02-19,2호선,신림,70368,68774,139142,2
2020-02-19,2호선,구로디지털단지,69020,69630,138650,2
2020-02-19,2호선,홍대입구,69381,73095,142476,2
2020-02-19,3호선,고속터미널,44234,42470,86704,2
2020-02-19,4호선,서울역,14272,20617,34889,2
2020-02-19,4호선,사당,28644,24315,52959,2
2020-02-19,경부선,서울역,5300,1421,6721,2
2020-02-19,경부선,가산디지털단지,20321,23033,43354,2
2020-02-19,분당선,선릉,14628,23502,38130,2
2020-02-19,경의선,서울역,4475,5730,10205,2
2020-02-19,경의선,홍대입구,1967,2230,4197,2
2020-02-19,7호선,고속터미널,17398,14900,32298,2
2020-02-19,7호선,가산디지털단지,49656,50281,99937,2
2020-02-19,8호선,잠실(송파구청),14969,17446,32415,2
2020-02-19,9호선,고속터미널,12502,16708,29210,2
2020-02-19,공항철도 1호선,서울역,9830,8414,18244,2
2020-02-19,공항철도 1호선,홍대입구,10711,11148,21859,2
2020-02-20,1호선,서울역,49555,46719,96274,2
2020-02-20,2호선,잠실(송파구청),78178,76225,154403,2
2020-02-20,2호선,선릉,65123,57809,122932,2
2020-02-20,2호선,강남,107019,108655,215674,2
2020-02-20,2호선,사당,41721,45747,87468,2
2020-02-20,2호선,신림,70194,68071,138265,2
2020-02-20,2호선,구로디지털단지,68213,68507,136720,2
2020-02-20,2호선,홍대입구,68935,73013,141948,2
2020-02-20,3호선,고속터미널,43829,42658,86487,2
2020-02-20,4호선,서울역,14226,20533,34759,2
2020-02-20,4호선,사당,28013,23884,51897,2
2020-02-20,경부선,서울역,5231,1429,6660,2
2020-02-20,경부선,가산디지털단지,20256,22625,42881,2
2020-02-20,분당선,선릉,14164,23091,37255,2
2020-02-20,경의선,서울역,4460,5752,10212,2
2020-02-20,경의선,홍대입구,1888,2244,4132,2
2020-02-20,7호선,고속터미널,17068,14671,31739,2
2020-02-20,7호선,가산디지털단지,48604,49937,98541,2
2020-02-20,8호선,잠실(송파구청),14486,16927,31413,2
2020-02-20,9호선,고속터미널,12107,16474,28581,2
2020-02-20,공항철도 1호선,서울역,9968,8556,18524,2
2020-02-20,공항철도 1호선,홍대입구,10676,10943,21619,2
2020-02-21,1호선,서울역,51060,47574,98634,2
2020-02-21,2호선,잠실(송파구청),75652,72726,148378,2
2020-02-21,2호선,선릉,62229,56051,118280,2
2020-02-21,2호선,강남,105267,109084,214351,2
2020-02-21,2호선,사당,41463,45212,86675,2
2020-02-21,2호선,신림,69815,67510,137325,2
2020-02-21,2호선,구로디지털단지,66852,67348,134200,2
2020-02-21,2호선,홍대입구,66364,74180,140544,2
2020-02-21,3호선,고속터미널,44955,46750,91705,2
2020-02-21,4호선,서울역,14187,20583,34770,2
2020-02-21,4호선,사당,28018,23902,51920,2
2020-02-21,경부선,서울역,5921,1612,7533,2
2020-02-21,경부선,가산디지털단지,19457,21679,41136,2
2020-02-21,분당선,선릉,13913,21629,35542,2
2020-02-21,경의선,서울역,4884,6518,11402,2
2020-02-21,경의선,홍대입구,1640,1914,3554,2
2020-02-21,7호선,고속터미널,17778,14640,32418,2
2020-02-21,7호선,가산디지털단지,48107,48333,96440,2
2020-02-21,8호선,잠실(송파구청),14503,16729,31232,2
2020-02-21,9호선,고속터미널,12307,17484,29791,2
2020-02-21,공항철도 1호선,서울역,10716,9111,19827,2
2020-02-21,공항철도 1호선,홍대입구,10524,11293,21817,2
2020-02-22,1호선,서울역,25308,23887,49195,2
2020-02-22,2호선,잠실(송파구청),50965,47919,98884,2
2020-02-22,2호선,선릉,23452,20884,44336,2
2020-02-22,2호선,강남,60264,63003,123267,2
2020-02-22,2호선,사당,26974,29714,56688,2
2020-02-22,2호선,신림,48116,46191,94307,2
2020-02-22,2호선,구로디지털단지,32246,32225,64471,2
2020-02-22,2호선,홍대입구,58300,64481,122781,2
2020-02-22,3호선,고속터미널,38955,38984,77939,2
2020-02-22,4호선,서울역,5728,10993,16721,2
2020-02-22,4호선,사당,18252,16139,34391,2
2020-02-22,경부선,서울역,3556,832,4388,2
2020-02-22,경부선,가산디지털단지,5008,6628,11636,2
2020-02-22,분당선,선릉,4618,7657,12275,2
2020-02-22,경의선,서울역,917,1035,1952,2
2020-02-22,경의선,홍대입구,1477,1718,3195,2
2020-02-22,7호선,고속터미널,12644,9948,22592,2
2020-02-22,7호선,가산디지털단지,12162,11166,23328,2
2020-02-22,8호선,잠실(송파구청),9688,11157,20845,2
2020-02-22,9호선,고속터미널,9253,13903,23156,2
2020-02-22,공항철도 1호선,서울역,7830,6911,14741,2
2020-02-22,공항철도 1호선,홍대입구,9007,9374,18381,2
2020-02-23,1호선,서울역,18234,16791,35025,2
2020-02-23,2호선,잠실(송파구청),35062,32919,67981,2
2020-02-23,2호선,선릉,10997,9700,20697,2
2020-02-23,2호선,강남,32842,32141,64983,2
2020-02-23,2호선,사당,17266,18992,36258,2
2020-02-23,2호선,신림,32751,32039,64790,2
2020-02-23,2호선,구로디지털단지,20364,20118,40482,2
2020-02-23,2호선,홍대입구,44873,43527,88400,2
2020-02-23,3호선,고속터미널,26816,25718,52534,2
2020-02-23,4호선,서울역,4137,8134,12271,2
2020-02-23,4호선,사당,11484,10871,22355,2
2020-02-23,경부선,서울역,3339,742,4081,2
2020-02-23,경부선,가산디지털단지,3251,4400,7651,2
2020-02-23,분당선,선릉,2137,3488,5625,2
2020-02-23,경의선,서울역,678,603,1281,2
2020-02-23,경의선,홍대입구,1230,1379,2609,2
2020-02-23,7호선,고속터미널,9411,6622,16033,2
2020-02-23,7호선,가산디지털단지,7485,7021,14506,2
2020-02-23,8호선,잠실(송파구청),6755,7451,14206,2
2020-02-23,9호선,고속터미널,6343,9371,15714,2
2020-02-23,공항철도 1호선,서울역,7338,5657,12995,2
2020-02-23,공항철도 1호선,홍대입구,7366,6471,13837,2
2020-02-24,1호선,서울역,38888,37484,76372,2
2020-02-24,2호선,잠실(송파구청),59036,58552,117588,2
2020-02-24,2호선,선릉,55355,49338,104693,2
2020-02-24,2호선,강남,84095,85164,169259,2
2020-02-24,2호선,사당,31542,35101,66643,2
2020-02-24,2호선,신림,60585,58816,119401,2
2020-02-24,2호선,구로디지털단지,59853,60362,120215,2
2020-02-24,2호선,홍대입구,48077,49951,98028,2
2020-02-24,3호선,고속터미널,29411,27791,57202,2
2020-02-24,4호선,서울역,12329,15893,28222,2
2020-02-24,4호선,사당,21889,18247,40136,2
2020-02-24,경부선,서울역,3361,1068,4429,2
2020-02-24,경부선,가산디지털단지,18237,20529,38766,2
2020-02-24,분당선,선릉,12769,19818,32587,2
2020-02-24,경의선,서울역,3931,4634,8565,2
2020-02-24,경의선,홍대입구,1358,1493,2851,2
2020-02-24,7호선,고속터미널,13151,10938,24089,2
2020-02-24,7호선,가산디지털단지,45014,45928,90942,2
2020-02-24,8호선,잠실(송파구청),11424,13064,24488,2
2020-02-24,9호선,고속터미널,8690,11426,20116,2
2020-02-24,공항철도 1호선,서울역,8263,6269,14532,2
2020-02-24,공항철도 1호선,홍대입구,7999,7753,15752,2
2020-02-25,1호선,서울역,35126,33231,68357,2
2020-02-25,2호선,잠실(송파구청),54448,53819,108267,2
2020-02-25,2호선,선릉,52142,46577,98719,2
2020-02-25,2호선,강남,77368,78595,155963,2
2020-02-25,2호선,사당,29231,31604,60835,2
2020-02-25,2호선,신림,57541,55473,113014,2
2020-02-25,2호선,구로디지털단지,56568,56988,113556,2
2020-02-25,2호선,홍대입구,43129,45292,88421,2
2020-02-25,3호선,고속터미널,26066,24938,51004,2
2020-02-25,4호선,서울역,11410,14294,25704,2
2020-02-25,4호선,사당,20070,16391,36461,2
2020-02-25,경부선,서울역,2505,890,3395,2
2020-02-25,경부선,가산디지털단지,17228,19465,36693,2
2020-02-25,분당선,선릉,11779,18592,30371,2
2020-02-25,경의선,서울역,3490,4340,7830,2
2020-02-25,경의선,홍대입구,1173,1324,2497,2
2020-02-25,7호선,고속터미널,11296,9918,21214,2
2020-02-25,7호선,가산디지털단지,43835,44682,88517,2
2020-02-25,8호선,잠실(송파구청),10570,12307,22877,2
2020-02-25,9호선,고속터미널,7410,9956,17366,2
2020-02-25,공항철도 1호선,서울역,6657,5159,11816,2
2020-02-25,공항철도 1호선,홍대입구,7263,7022,14285,2
2020-02-26,1호선,서울역,33906,32297,66203,2
2020-02-26,2호선,잠실(송파구청),54839,53863,108702,2
2020-02-26,2호선,선릉,51082,45595,96677,2
2020-02-26,2호선,강남,75301,75787,151088,2
2020-02-26,2호선,사당,29634,32020,61654,2
2020-02-26,2호선,신림,57191,55041,112232,2
2020-02-26,2호선,구로디지털단지,56250,56710,112960,2
2020-02-26,2호선,홍대입구,44807,46963,91770,2
2020-02-26,3호선,고속터미널,25639,24616,50255,2
2020-02-26,4호선,서울역,10926,13349,24275,2
2020-02-26,4호선,사당,20144,16824,36968,2
2020-02-26,경부선,서울역,2304,802,3106,2
2020-02-26,경부선,가산디지털단지,16862,18709,35571,2
2020-02-26,분당선,선릉,11530,17888,29418,2
2020-02-26,경의선,서울역,3432,4219,7651,2
2020-02-26,경의선,홍대입구,1206,1312,2518,2
2020-02-26,7호선,고속터미널,10995,9793,20788,2
2020-02-26,7호선,가산디지털단지,42829,43679,86508,2
2020-02-26,8호선,잠실(송파구청),10499,11898,22397,2
2020-02-26,9호선,고속터미널,7646,9822,17468,2
2020-02-26,공항철도 1호선,서울역,6164,4917,11081,2
2020-02-26,공항철도 1호선,홍대입구,7149,7111,14260,2
2020-02-27,공항철도 1호선,홍대입구,6584,6654,13238,2
2020-02-27,공항철도 1호선,서울역,5649,4637,10286,2
2020-02-27,9호선,고속터미널,7231,9504,16735,2
2020-02-27,8호선,잠실(송파구청),10185,11632,21817,2
2020-02-27,1호선,서울역,32598,30785,63383,2
2020-02-27,2호선,잠실(송파구청),52876,51822,104698,2
2020-02-27,2호선,선릉,49120,44036,93156,2
2020-02-27,2호선,강남,71572,72386,143958,2
2020-02-27,2호선,사당,28785,31221,60006,2
2020-02-27,2호선,신림,55779,53847,109626,2
2020-02-27,2호선,구로디지털단지,53284,53516,106800,2
2020-02-27,2호선,홍대입구,42487,44672,87159,2
2020-02-27,3호선,고속터미널,24867,24334,49201,2
2020-02-27,4호선,서울역,10424,12804,23228,2
2020-02-27,4호선,사당,19332,16452,35784,2
2020-02-27,경부선,서울역,2207,784,2991,2
2020-02-27,경부선,가산디지털단지,16074,17747,33821,2
2020-02-27,분당선,선릉,11248,17216,28464,2
2020-02-27,경의선,서울역,3259,4110,7369,2
2020-02-27,경의선,홍대입구,1188,1316,2504,2
2020-02-27,7호선,고속터미널,10607,9484,20091,2
2020-02-27,7호선,가산디지털단지,40087,41412,81499,2
2020-02-28,1호선,서울역,32454,30638,63092,2
2020-02-28,2호선,잠실(송파구청),51115,50232,101347,2
2020-02-28,2호선,선릉,46260,41395,87655,2
2020-02-28,2호선,강남,69594,71163,140757,2
2020-02-28,2호선,사당,28580,30673,59253,2
2020-02-28,2호선,신림,54600,52735,107335,2
2020-02-28,2호선,구로디지털단지,51738,52112,103850,2
2020-02-28,2호선,홍대입구,38916,42521,81437,2
2020-02-28,3호선,고속터미널,23477,24773,48250,2
2020-02-28,4호선,서울역,9890,12516,22406,2
2020-02-28,4호선,사당,19327,16422,35749,2
2020-02-28,경부선,서울역,2791,937,3728,2
2020-02-28,경부선,가산디지털단지,14889,16971,31860,2
2020-02-28,분당선,선릉,10563,16317,26880,2
2020-02-28,경의선,서울역,3178,3948,7126,2
2020-02-28,경의선,홍대입구,1017,1178,2195,2
2020-02-28,7호선,고속터미널,11024,9562,20586,2
2020-02-28,7호선,가산디지털단지,38778,38785,77563,2
2020-02-28,8호선,잠실(송파구청),10423,11839,22262,2
2020-02-28,9호선,고속터미널,6739,9448,16187,2
2020-02-28,공항철도 1호선,서울역,5983,4877,10860,2
2020-02-28,공항철도 1호선,홍대입구,6118,6370,12488,2
2020-02-29,공항철도 1호선,홍대입구,5468,5253,10721,2
2020-02-29,공항철도 1호선,서울역,3642,3166,6808,2
2020-02-29,9호선,고속터미널,4978,6941,11919,2
2020-02-29,8호선,잠실(송파구청),6310,7130,13440,2
2020-02-29,7호선,가산디지털단지,9061,8573,17634,2
2020-02-29,2호선,잠실(송파구청),33248,31490,64738,2
2020-02-29,2호선,선릉,14742,13005,27747,2
2020-02-29,2호선,강남,35285,37114,72399,2
2020-02-29,2호선,사당,17723,18892,36615,2
2020-02-29,2호선,신림,35245,33730,68975,2
2020-02-29,2호선,구로디지털단지,24361,24547,48908,2
2020-02-29,2호선,홍대입구,31885,35720,67605,2
2020-02-29,3호선,고속터미널,19964,20287,40251,2
2020-02-29,7호선,고속터미널,6911,5953,12864,2
2020-02-29,4호선,서울역,3459,5457,8916,2
2020-02-29,4호선,사당,11424,9997,21421,2
2020-02-29,경부선,서울역,1235,336,1571,2
2020-02-29,경부선,가산디지털단지,3823,4757,8580,2
2020-02-29,1호선,서울역,14546,13815,28361,2
2020-02-29,분당선,선릉,2769,4615,7384,2
2020-02-29,경의선,서울역,581,648,1229,2
2020-02-29,경의선,홍대입구,932,1054,1986,2
2020-03-01,1호선,서울역,10457,10389,20846,3
2020-03-01,2호선,잠실(송파구청),23040,21563,44603,3
2020-03-01,2호선,선릉,7177,6250,13427,3
2020-03-01,2호선,강남,18405,18248,36653,3
2020-03-01,2호선,사당,11385,12516,23901,3
2020-03-01,2호선,신림,24142,23183,47325,3
2020-03-01,2호선,구로디지털단지,15018,14672,29690,3
2020-03-01,2호선,홍대입구,23021,22176,45197,3
2020-03-01,3호선,고속터미널,16392,16095,32487,3
2020-03-01,4호선,서울역,2446,4081,6527,3
2020-03-01,4호선,사당,7201,7356,14557,3
2020-03-01,경부선,서울역,1390,362,1752,3
2020-03-01,경부선,가산디지털단지,2441,3236,5677,3
2020-03-01,분당선,선릉,1309,2141,3450,3
2020-03-01,경의선,서울역,402,433,835,3
2020-03-01,경의선,홍대입구,675,738,1413,3
2020-03-01,7호선,고속터미널,5647,4217,9864,3
2020-03-01,7호선,가산디지털단지,5524,5341,10865,3
2020-03-01,8호선,잠실(송파구청),4870,5243,10113,3
2020-03-01,9호선,고속터미널,3711,5039,8750,3
2020-03-01,공항철도 1호선,서울역,2938,2562,5500,3
2020-03-01,공항철도 1호선,홍대입구,3868,3510,7378,3
2020-03-02,1호선,서울역,30750,29308,60058,3
2020-03-02,2호선,잠실(송파구청),47376,46641,94017,3
2020-03-02,2호선,선릉,45926,40927,86853,3
2020-03-02,2호선,강남,62556,63127,125683,3
2020-03-02,2호선,사당,26881,29409,56290,3
2020-03-02,2호선,신림,53149,51179,104328,3
2020-03-02,2호선,구로디지털단지,51243,51443,102686,3
2020-03-02,2호선,홍대입구,35969,37361,73330,3
2020-03-02,3호선,고속터미널,23169,21627,44796,3
2020-03-02,4호선,서울역,9485,11226,20711,3
2020-03-02,4호선,사당,18166,15459,33625,3
2020-03-02,경부선,서울역,2162,780,2942,3
2020-03-02,경부선,가산디지털단지,15152,17229,32381,3
2020-03-02,분당선,선릉,10518,16417,26935,3
2020-03-02,경의선,서울역,3085,3911,6996,3
2020-03-02,경의선,홍대입구,1059,1220,2279,3
2020-03-02,7호선,고속터미널,10605,9095,19700,3
2020-03-02,7호선,가산디지털단지,38438,39278,77716,3
2020-03-02,8호선,잠실(송파구청),9750,11154,20904,3
2020-03-02,9호선,고속터미널,6461,8233,14694,3
2020-03-02,공항철도 1호선,서울역,4393,3901,8294,3
2020-03-02,공항철도 1호선,홍대입구,5458,5687,11145,3
2020-03-03,1호선,서울역,30631,28834,59465,3
2020-03-03,2호선,선릉,46188,41292,87480,3
2020-03-03,2호선,잠실(송파구청),49893,49309,99202,3
2020-03-03,2호선,강남,62742,63287,126029,3
2020-03-03,2호선,사당,27680,30034,57714,3
2020-03-03,2호선,신림,53085,51573,104658,3
2020-03-03,2호선,구로디지털단지,50953,51523,102476,3
2020-03-03,2호선,홍대입구,36750,38561,75311,3
2020-03-03,3호선,고속터미널,22000,21448,43448,3
2020-03-03,4호선,서울역,9329,11187,20516,3
2020-03-03,4호선,사당,18329,15702,34031,3
2020-03-03,경부선,서울역,1836,702,2538,3
2020-03-03,경부선,가산디지털단지,14979,17026,32005,3
2020-03-03,분당선,선릉,10422,16188,26610,3
2020-03-03,경의선,서울역,2947,3958,6905,3
2020-03-03,경의선,홍대입구,1088,1190,2278,3
2020-03-03,7호선,고속터미널,10150,9118,19268,3
2020-03-03,7호선,가산디지털단지,38401,38903,77304,3
2020-03-03,8호선,잠실(송파구청),10349,11761,22110,3
2020-03-03,9호선,고속터미널,6466,7941,14407,3
2020-03-03,공항철도 1호선,서울역,4182,3741,7923,3
2020-03-03,공항철도 1호선,홍대입구,5892,5875,11767,3
2020-03-04,1호선,서울역,30043,28180,58223,3
2020-03-04,2호선,잠실(송파구청),50775,49688,100463,3
2020-03-04,2호선,선릉,46108,40953,87061,3
2020-03-04,2호선,강남,63166,63174,126340,3
2020-03-04,2호선,사당,27855,29889,57744,3
2020-03-04,2호선,신림,53227,51620,104847,3
2020-03-04,2호선,구로디지털단지,51292,51625,102917,3
2020-03-04,2호선,홍대입구,37649,39431,77080,3
2020-03-04,3호선,고속터미널,22235,21825,44060,3
2020-03-04,4호선,서울역,9316,10864,20180,3
2020-03-04,4호선,사당,18573,15783,34356,3
2020-03-04,경부선,서울역,1879,727,2606,3
2020-03-04,경부선,가산디지털단지,14935,17084,32019,3
2020-03-04,분당선,선릉,10380,16231,26611,3
2020-03-04,경의선,서울역,2924,3897,6821,3
2020-03-04,경의선,홍대입구,1097,1237,2334,3
2020-03-04,7호선,고속터미널,10085,9090,19175,3
2020-03-04,7호선,가산디지털단지,38428,38811,77239,3
2020-03-04,8호선,잠실(송파구청),10422,11656,22078,3
2020-03-04,9호선,고속터미널,6401,7910,14311,3
2020-03-04,공항철도 1호선,서울역,4097,3602,7699,3
2020-03-04,공항철도 1호선,홍대입구,5683,6004,11687,3
2020-03-05,1호선,서울역,30249,28384,58633,3
2020-03-05,2호선,잠실(송파구청),51452,50461,101913,3
2020-03-05,2호선,선릉,46332,41607,87939,3
2020-03-05,2호선,강남,64350,64829,129179,3
2020-03-05,2호선,사당,28424,30563,58987,3
2020-03-05,2호선,신림,53567,51861,105428,3
2020-03-05,2호선,구로디지털단지,51163,51577,102740,3
2020-03-05,2호선,홍대입구,38433,41080,79513,3
2020-03-05,3호선,고속터미널,22946,22625,45571,3
2020-03-05,4호선,서울역,9401,11211,20612,3
2020-03-05,4호선,사당,18752,15975,34727,3
2020-03-05,경부선,서울역,2017,741,2758,3
2020-03-05,경부선,가산디지털단지,15133,17003,32136,3
2020-03-05,분당선,선릉,10635,16259,26894,3
2020-03-05,경의선,서울역,2897,3889,6786,3
2020-03-05,경의선,홍대입구,1189,1308,2497,3
2020-03-05,7호선,고속터미널,10424,9308,19732,3
2020-03-05,7호선,가산디지털단지,38008,38871,76879,3
2020-03-05,8호선,잠실(송파구청),10615,11876,22491,3
2020-03-05,9호선,고속터미널,6449,8223,14672,3
2020-03-05,공항철도 1호선,서울역,4061,3666,7727,3
2020-03-05,공항철도 1호선,홍대입구,5902,6040,11942,3
2020-03-06,1호선,서울역,32461,30457,62918,3
2020-03-06,2호선,잠실(송파구청),53574,52067,105641,3
2020-03-06,2호선,선릉,46692,41707,88399,3
2020-03-06,2호선,강남,68005,70586,138591,3
2020-03-06,2호선,사당,30374,33063,63437,3
2020-03-06,2호선,신림,55816,54271,110087,3
2020-03-06,2호선,구로디지털단지,52706,53143,105849,3
2020-03-06,2호선,홍대입구,41529,45792,87321,3
2020-03-06,3호선,고속터미널,27124,28593,55717,3
2020-03-06,4호선,서울역,9374,11681,21055,3
2020-03-06,4호선,사당,20367,17257,37624,3
2020-03-06,경부선,서울역,2796,977,3773,3
2020-03-06,경부선,가산디지털단지,15085,17175,32260,3
2020-03-06,분당선,선릉,10492,16398,26890,3
2020-03-06,경의선,서울역,3070,4089,7159,3
2020-03-06,경의선,홍대입구,1244,1399,2643,3
2020-03-06,7호선,고속터미널,11423,9965,21388,3
2020-03-06,7호선,가산디지털단지,37670,37799,75469,3
2020-03-06,8호선,잠실(송파구청),10991,12336,23327,3
2020-03-06,9호선,고속터미널,7333,9958,17291,3
2020-03-06,공항철도 1호선,서울역,5067,4497,9564,3
2020-03-06,공항철도 1호선,홍대입구,6287,6694,12981,3
2020-03-07,1호선,서울역,14773,14238,29011,3
2020-03-07,2호선,잠실(송파구청),36206,34183,70389,3
2020-03-07,2호선,선릉,16577,14655,31232,3
2020-03-07,2호선,강남,39648,41549,81197,3
2020-03-07,2호선,사당,19715,21160,40875,3
2020-03-07,2호선,신림,37733,35957,73690,3
2020-03-07,2호선,구로디지털단지,25537,25533,51070,3
2020-03-07,2호선,홍대입구,36602,40786,77388,3
2020-03-07,3호선,고속터미널,23070,23475,46545,3
2020-03-07,4호선,서울역,3399,5358,8757,3
2020-03-07,4호선,사당,12557,10996,23553,3
2020-03-07,경부선,서울역,1546,370,1916,3
2020-03-07,경부선,가산디지털단지,4047,5114,9161,3
2020-03-07,분당선,선릉,3144,5094,8238,3
2020-03-07,경의선,서울역,615,663,1278,3
2020-03-07,경의선,홍대입구,1118,1279,2397,3
2020-03-07,7호선,고속터미널,7261,6042,13303,3
2020-03-07,7호선,가산디지털단지,9584,8958,18542,3
2020-03-07,8호선,잠실(송파구청),7425,8224,15649,3
2020-03-07,9호선,고속터미널,5822,7959,13781,3
2020-03-07,공항철도 1호선,서울역,3156,2836,5992,3
2020-03-07,공항철도 1호선,홍대입구,5773,6024,11797,3
2020-03-08,1호선,서울역,11143,11045,22188,3
2020-03-08,2호선,잠실(송파구청),27466,25257,52723,3
2020-03-08,2호선,선릉,8034,7237,15271,3
2020-03-08,2호선,강남,22855,22861,45716,3
2020-03-08,2호선,사당,13440,15010,28450,3
2020-03-08,2호선,신림,26703,26028,52731,3
2020-03-08,2호선,구로디지털단지,16434,15956,32390,3
2020-03-08,2호선,홍대입구,28285,28251,56536,3
2020-03-08,3호선,고속터미널,20697,19736,40433,3
2020-03-08,4호선,서울역,2396,4326,6722,3
2020-03-08,4호선,사당,8730,8626,17356,3
2020-03-08,경부선,서울역,1775,436,2211,3
2020-03-08,경부선,가산디지털단지,2862,3723,6585,3
2020-03-08,분당선,선릉,1614,2490,4104,3
2020-03-08,경의선,서울역,501,467,968,3
2020-03-08,경의선,홍대입구,889,985,1874,3
2020-03-08,7호선,고속터미널,6755,4784,11539,3
2020-03-08,7호선,가산디지털단지,6473,6151,12624,3
2020-03-08,8호선,잠실(송파구청),5769,6146,11915,3
2020-03-08,9호선,고속터미널,4892,6582,11474,3
2020-03-08,공항철도 1호선,서울역,2850,2762,5612,3
2020-03-08,공항철도 1호선,홍대입구,4765,4495,9260,3
2020-03-09,2호선,잠실(송파구청),53410,52621,106031,3
2020-03-09,2호선,선릉,49468,44192,93660,3
2020-03-09,2호선,강남,72919,73302,146221,3
2020-03-09,2호선,사당,29377,32046,61423,3
2020-03-09,2호선,신림,55638,54039,109677,3
2020-03-09,2호선,구로디지털단지,53921,54563,108484,3
2020-03-09,2호선,홍대입구,39336,41200,80536,3
2020-03-09,3호선,고속터미널,26485,24789,51274,3
2020-03-09,4호선,서울역,9666,11596,21262,3
2020-03-09,4호선,사당,19585,16651,36236,3
2020-03-09,경부선,서울역,2586,903,3489,3
2020-03-09,경부선,가산디지털단지,15684,17766,33450,3
2020-03-09,분당선,선릉,11336,17723,29059,3
2020-03-09,1호선,서울역,31832,30133,61965,3
2020-03-09,경의선,서울역,3127,4062,7189,3
2020-03-09,경의선,홍대입구,1258,1330,2588,3
2020-03-09,7호선,고속터미널,11492,9749,21241,3
2020-03-09,7호선,가산디지털단지,39371,40122,79493,3
2020-03-09,8호선,잠실(송파구청),10810,12396,23206,3
2020-03-09,9호선,고속터미널,7645,9538,17183,3
2020-03-09,공항철도 1호선,서울역,4372,4029,8401,3
2020-03-09,공항철도 1호선,홍대입구,6098,6270,12368,3
2020-03-10,1호선,서울역,30495,28745,59240,3
2020-03-10,2호선,잠실(송파구청),50762,50155,100917,3
2020-03-10,2호선,선릉,48246,43132,91378,3
2020-03-10,2호선,강남,70679,71554,142233,3
2020-03-10,2호선,사당,28450,30962,59412,3
2020-03-10,2호선,신림,53027,51313,104340,3
2020-03-10,2호선,구로디지털단지,51278,51650,102928,3
2020-03-10,2호선,홍대입구,36872,38865,75737,3
2020-03-10,3호선,고속터미널,23095,22683,45778,3
2020-03-10,4호선,서울역,9534,11316,20850,3
2020-03-10,4호선,사당,19151,16090,35241,3
2020-03-10,경부선,서울역,2152,793,2945,3
2020-03-10,경부선,가산디지털단지,14703,16996,31699,3
2020-03-10,분당선,선릉,11138,17210,28348,3
2020-03-10,경의선,서울역,3018,3886,6904,3
2020-03-10,경의선,홍대입구,1088,1214,2302,3
2020-03-10,7호선,고속터미널,10850,9500,20350,3
2020-03-10,7호선,가산디지털단지,38893,39451,78344,3
2020-03-10,8호선,잠실(송파구청),10492,11877,22369,3
2020-03-10,9호선,고속터미널,6902,8677,15579,3
2020-03-10,공항철도 1호선,서울역,3872,3738,7610,3
2020-03-10,공항철도 1호선,홍대입구,5429,5654,11083,3
2020-03-11,1호선,서울역,30849,29167,60016,3
2020-03-11,2호선,잠실(송파구청),55483,53890,109373,3
2020-03-11,2호선,선릉,49174,43960,93134,3
2020-03-11,2호선,강남,72971,73223,146194,3
2020-03-11,2호선,사당,29781,32519,62300,3
2020-03-11,2호선,신림,54902,53032,107934,3
2020-03-11,2호선,구로디지털단지,51299,51445,102744,3
2020-03-11,2호선,홍대입구,40711,43271,83982,3
2020-03-11,3호선,고속터미널,24888,23965,48853,3
2020-03-11,4호선,서울역,9599,11761,21360,3
2020-03-11,4호선,사당,20079,16758,36837,3
2020-03-11,경부선,서울역,2111,770,2881,3
2020-03-11,경부선,가산디지털단지,14482,16522,31004,3
2020-03-11,분당선,선릉,11150,17361,28511,3
2020-03-11,경의선,서울역,3064,3950,7014,3
2020-03-11,경의선,홍대입구,1267,1319,2586,3
2020-03-11,7호선,고속터미널,10706,9529,20235,3
2020-03-11,7호선,가산디지털단지,38025,38549,76574,3
2020-03-11,8호선,잠실(송파구청),11165,12764,23929,3
2020-03-11,9호선,고속터미널,7326,9157,16483,3
2020-03-11,공항철도 1호선,서울역,4125,3735,7860,3
2020-03-11,공항철도 1호선,홍대입구,6205,6443,12648,3
2020-03-12,1호선,서울역,30762,28918,59680,3
2020-03-12,2호선,잠실(송파구청),54495,52918,107413,3
2020-03-12,2호선,선릉,47992,42892,90884,3
2020-03-12,2호선,강남,71929,72725,144654,3
2020-03-12,2호선,사당,29281,31519,60800,3
2020-03-12,2호선,신림,53458,51673,105131,3
2020-03-12,2호선,구로디지털단지,49971,50299,100270,3
2020-03-12,2호선,홍대입구,40126,42461,82587,3
2020-03-12,3호선,고속터미널,25076,24314,49390,3
2020-03-12,4호선,서울역,9568,11526,21094,3
2020-03-12,4호선,사당,19549,16723,36272,3
2020-03-12,경부선,서울역,2223,795,3018,3
2020-03-12,경부선,가산디지털단지,14480,16385,30865,3
2020-03-12,분당선,선릉,10791,17068,27859,3
2020-03-12,경의선,서울역,2971,3961,6932,3
2020-03-12,경의선,홍대입구,1218,1411,2629,3
2020-03-12,7호선,고속터미널,10724,9590,20314,3
2020-03-12,7호선,가산디지털단지,37443,38161,75604,3
2020-03-12,8호선,잠실(송파구청),10663,12405,23068,3
2020-03-12,9호선,고속터미널,7174,9179,16353,3
2020-03-12,공항철도 1호선,서울역,4091,3880,7971,3
2020-03-12,공항철도 1호선,홍대입구,6091,6275,12366,3
2020-03-13,1호선,서울역,31673,30183,61856,3
2020-03-13,2호선,잠실(송파구청),56106,54138,110244,3
2020-03-13,2호선,선릉,47767,42923,90690,3
2020-03-13,2호선,강남,75857,78367,154224,3
2020-03-13,2호선,사당,31079,33874,64953,3
2020-03-13,2호선,신림,55723,53669,109392,3
2020-03-13,2호선,구로디지털단지,50454,50277,100731,3
2020-03-13,2호선,홍대입구,43264,48593,91857,3
2020-03-13,3호선,고속터미널,29475,30530,60005,3
2020-03-13,4호선,서울역,8705,11225,19930,3
2020-03-13,4호선,사당,21035,17651,38686,3
2020-03-13,경부선,서울역,3174,967,4141,3
2020-03-13,경부선,가산디지털단지,14397,16223,30620,3
2020-03-13,분당선,선릉,10844,17039,27883,3
2020-03-13,경의선,서울역,2924,3921,6845,3
2020-03-13,경의선,홍대입구,1341,1506,2847,3
2020-03-13,7호선,고속터미널,11504,10160,21664,3
2020-03-13,7호선,가산디지털단지,37336,37364,74700,3
2020-03-13,8호선,잠실(송파구청),11348,13159,24507,3
2020-03-13,9호선,고속터미널,8007,10912,18919,3
2020-03-13,공항철도 1호선,서울역,5133,4672,9805,3
2020-03-13,공항철도 1호선,홍대입구,6582,7145,13727,3
2020-03-14,1호선,서울역,15358,14932,30290,3
2020-03-14,2호선,잠실(송파구청),40140,37668,77808,3
2020-03-14,2호선,선릉,17015,15057,32072,3
2020-03-14,2호선,강남,44058,46745,90803,3
2020-03-14,2호선,사당,21172,22860,44032,3
2020-03-14,2호선,신림,37870,36192,74062,3
2020-03-14,2호선,구로디지털단지,24975,24661,49636,3
2020-03-14,2호선,홍대입구,39593,44740,84333,3
2020-03-14,3호선,고속터미널,26297,26576,52873,3
2020-03-14,4호선,서울역,3473,5967,9440,3
2020-03-14,4호선,사당,13952,12034,25986,3
2020-03-14,경부선,서울역,1838,467,2305,3
2020-03-14,경부선,가산디지털단지,3816,4865,8681,3
2020-03-14,분당선,선릉,3466,5423,8889,3
2020-03-14,경의선,서울역,647,691,1338,3
2020-03-14,경의선,홍대입구,1169,1383,2552,3
2020-03-14,7호선,고속터미널,7865,6540,14405,3
2020-03-14,7호선,가산디지털단지,9322,8758,18080,3
2020-03-14,8호선,잠실(송파구청),8456,9151,17607,3
2020-03-14,9호선,고속터미널,6151,8712,14863,3
2020-03-14,공항철도 1호선,서울역,3119,3165,6284,3
2020-03-14,공항철도 1호선,홍대입구,6096,6275,12371,3
2020-03-15,1호선,서울역,12189,12077,24266,3
2020-03-15,2호선,잠실(송파구청),27667,25807,53474,3
2020-03-15,2호선,선릉,8230,7213,15443,3
2020-03-15,2호선,강남,24905,24485,49390,3
2020-03-15,2호선,사당,13718,15098,28816,3
2020-03-15,2호선,신림,26136,25303,51439,3
2020-03-15,2호선,구로디지털단지,15640,15360,31000,3
2020-03-15,2호선,홍대입구,29003,28466,57469,3
2020-03-15,3호선,고속터미널,21618,20548,42166,3
2020-03-15,4호선,서울역,2587,4500,7087,3
2020-03-15,4호선,사당,9323,8927,18250,3
2020-03-15,경부선,서울역,2158,511,2669,3
2020-03-15,경부선,가산디지털단지,2458,3390,5848,3
2020-03-15,분당선,선릉,1598,2534,4132,3
2020-03-15,경의선,서울역,497,509,1006,3
2020-03-15,경의선,홍대입구,803,886,1689,3
2020-03-15,7호선,고속터미널,6807,4726,11533,3
2020-03-15,7호선,가산디지털단지,6046,5804,11850,3
2020-03-15,8호선,잠실(송파구청),6226,6463,12689,3
2020-03-15,9호선,고속터미널,4707,6456,11163,3
2020-03-15,공항철도 1호선,서울역,2954,3063,6017,3
2020-03-15,공항철도 1호선,홍대입구,4417,4313,8730,3
2020-03-16,1호선,서울역,31332,29557,60889,3
2020-03-16,2호선,잠실(송파구청),52355,51191,103546,3
2020-03-16,2호선,선릉,49570,44456,94026,3
2020-03-16,2호선,강남,73055,71549,144604,3
2020-03-16,2호선,사당,28823,31526,60349,3
2020-03-16,2호선,신림,54006,52268,106274,3
2020-03-16,2호선,구로디지털단지,50979,51318,102297,3
2020-03-16,2호선,홍대입구,37814,39393,77207,3
2020-03-16,3호선,고속터미널,25428,23489,48917,3
2020-03-16,4호선,서울역,9453,11439,20892,3
2020-03-16,4호선,사당,19468,16591,36059,3
2020-03-16,경부선,서울역,2621,893,3514,3
2020-03-16,경부선,가산디지털단지,14930,17086,32016,3
2020-03-16,분당선,선릉,11331,17748,29079,3
2020-03-16,경의선,서울역,3093,4093,7186,3
2020-03-16,경의선,홍대입구,1160,1286,2446,3
2020-03-16,7호선,고속터미널,11548,9849,21397,3
2020-03-16,7호선,가산디지털단지,39316,39417,78733,3
2020-03-16,8호선,잠실(송파구청),10759,12372,23131,3
2020-03-16,9호선,고속터미널,7526,9366,16892,3
2020-03-16,공항철도 1호선,서울역,4465,4156,8621,3
2020-03-16,공항철도 1호선,홍대입구,5674,5844,11518,3
2020-03-17,2호선,잠실(송파구청),53302,52258,105560,3
2020-03-17,2호선,선릉,49324,44314,93638,3
2020-03-17,2호선,강남,73130,73546,146676,3
2020-03-17,2호선,사당,29519,32262,61781,3
2020-03-17,2호선,신림,54055,52548,106603,3
2020-03-17,2호선,구로디지털단지,51107,51450,102557,3
2020-03-17,2호선,홍대입구,37983,40299,78282,3
2020-03-17,3호선,고속터미널,25114,24189,49303,3
2020-03-17,4호선,서울역,9434,11344,20778,3
2020-03-17,4호선,사당,19709,16670,36379,3
2020-03-17,경부선,서울역,2287,790,3077,3
2020-03-17,경부선,가산디지털단지,14939,16975,31914,3
2020-03-17,분당선,선릉,11241,17648,28889,3
2020-03-17,경의선,서울역,3101,4005,7106,3
2020-03-17,경의선,홍대입구,1194,1273,2467,3
2020-03-17,7호선,고속터미널,11022,9798,20820,3
2020-03-17,7호선,가산디지털단지,38864,39429,78293,3
2020-03-17,8호선,잠실(송파구청),10740,12153,22893,3
2020-03-17,1호선,서울역,30397,28800,59197,3
2020-03-17,9호선,고속터미널,7310,9140,16450,3
2020-03-17,공항철도 1호선,서울역,4097,3870,7967,3
2020-03-17,공항철도 1호선,홍대입구,5906,6094,12000,3
2020-03-18,1호선,서울역,31201,29331,60532,3
2020-03-18,2호선,잠실(송파구청),56426,55012,111438,3
2020-03-18,2호선,선릉,49963,44924,94887,3
2020-03-18,2호선,강남,74676,75073,149749,3
2020-03-18,2호선,사당,30705,33191,63896,3
2020-03-18,2호선,신림,55477,53588,109065,3
2020-03-18,2호선,구로디지털단지,52203,52288,104491,3
2020-03-18,2호선,홍대입구,40912,43449,84361,3
2020-03-18,3호선,고속터미널,26556,25360,51916,3
2020-03-18,4호선,서울역,9471,11542,21013,3
2020-03-18,4호선,사당,20621,17292,37913,3
2020-03-18,경부선,서울역,2386,809,3195,3
2020-03-18,경부선,가산디지털단지,15194,17191,32385,3
2020-03-18,분당선,선릉,11338,17658,28996,3
2020-03-18,경의선,서울역,3159,4119,7278,3
2020-03-18,경의선,홍대입구,1268,1406,2674,3
2020-03-18,7호선,고속터미널,11196,9931,21127,3
2020-03-18,7호선,가산디지털단지,38902,39567,78469,3
2020-03-18,8호선,잠실(송파구청),11085,12501,23586,3
2020-03-18,9호선,고속터미널,7802,9779,17581,3
2020-03-18,공항철도 1호선,서울역,4359,4102,8461,3
2020-03-18,공항철도 1호선,홍대입구,6272,6487,12759,3
2020-03-19,1호선,서울역,30841,29065,59906,3
2020-03-19,2호선,잠실(송파구청),52352,51171,103523,3
2020-03-19,2호선,선릉,48317,43609,91926,3
2020-03-19,2호선,강남,72021,72660,144681,3
2020-03-19,2호선,사당,29170,31373,60543,3
2020-03-19,2호선,신림,53723,51770,105493,3
2020-03-19,2호선,구로디지털단지,50764,51132,101896,3
2020-03-19,2호선,홍대입구,38838,40825,79663,3
2020-03-19,3호선,고속터미널,24803,24393,49196,3
2020-03-19,4호선,서울역,9164,11180,20344,3
2020-03-19,4호선,사당,19583,16604,36187,3
2020-03-19,경부선,서울역,2417,834,3251,3
2020-03-19,경부선,가산디지털단지,14650,16694,31344,3
2020-03-19,분당선,선릉,10888,17041,27929,3
2020-03-19,경의선,서울역,3018,4042,7060,3
2020-03-19,경의선,홍대입구,1188,1324,2512,3
2020-03-19,경의선,홍대입구,1,0,1,3
2020-03-19,7호선,고속터미널,10861,9486,20347,3
2020-03-19,7호선,가산디지털단지,38483,38988,77471,3
2020-03-19,8호선,잠실(송파구청),10462,12036,22498,3
2020-03-19,9호선,고속터미널,7239,8960,16199,3
2020-03-19,공항철도 1호선,서울역,4275,4087,8362,3
2020-03-19,공항철도 1호선,홍대입구,5868,6154,12022,3
2020-03-20,1호선,서울역,34045,32448,66493,3
2020-03-20,2호선,잠실(송파구청),58747,56962,115709,3
2020-03-20,2호선,선릉,49492,44595,94087,3
2020-03-20,2호선,강남,78642,82085,160727,3
2020-03-20,2호선,사당,32642,35758,68400,3
2020-03-20,2호선,신림,57771,55854,113625,3
2020-03-20,2호선,구로디지털단지,53437,53522,106959,3
2020-03-20,2호선,홍대입구,46052,52607,98659,3
2020-03-20,3호선,고속터미널,31160,32782,63942,3
2020-03-20,4호선,서울역,9419,12268,21687,3
2020-03-20,4호선,사당,22348,18558,40906,3
2020-03-20,경부선,서울역,3523,1068,4591,3
2020-03-20,경부선,가산디지털단지,15169,17291,32460,3
2020-03-20,분당선,선릉,11049,17469,28518,3
2020-03-20,경의선,서울역,3098,4099,7197,3
2020-03-20,경의선,홍대입구,1489,1691,3180,3
2020-03-20,7호선,고속터미널,12314,10708,23022,3
2020-03-20,7호선,가산디지털단지,38462,38761,77223,3
2020-03-20,8호선,잠실(송파구청),11570,13557,25127,3
2020-03-20,9호선,고속터미널,8808,11971,20779,3
2020-03-20,공항철도 1호선,서울역,5363,5311,10674,3
2020-03-20,공항철도 1호선,홍대입구,7198,7697,14895,3
2020-03-21,1호선,서울역,16715,16436,33151,3
2020-03-21,2호선,잠실(송파구청),40868,38166,79034,3
2020-03-21,2호선,선릉,17571,15638,33209,3
2020-03-21,2호선,강남,47272,49593,96865,3
2020-03-21,2호선,사당,22334,24272,46606,3
2020-03-21,2호선,신림,39608,37669,77277,3
2020-03-21,2호선,구로디지털단지,26346,25897,52243,3
2020-03-21,2호선,홍대입구,41362,46632,87994,3
2020-03-21,3호선,고속터미널,28747,28841,57588,3
2020-03-21,4호선,서울역,3677,6335,10012,3
2020-03-21,4호선,사당,14550,13037,27587,3
2020-03-21,경부선,서울역,2099,521,2620,3
2020-03-21,경부선,가산디지털단지,4377,5612,9989,3
2020-03-21,분당선,선릉,3419,5449,8868,3
2020-03-21,경의선,서울역,735,782,1517,3
2020-03-21,경의선,홍대입구,1272,1459,2731,3
2020-03-21,7호선,고속터미널,8281,7097,15378,3
2020-03-21,7호선,가산디지털단지,10154,9427,19581,3
2020-03-21,8호선,잠실(송파구청),7918,8840,16758,3
2020-03-21,9호선,고속터미널,6892,9754,16646,3
2020-03-21,공항철도 1호선,서울역,3507,3607,7114,3
2020-03-21,공항철도 1호선,홍대입구,6710,6827,13537,3
2020-03-22,1호선,서울역,12816,12436,25252,3
2020-03-22,2호선,잠실(송파구청),30258,27873,58131,3
2020-03-22,2호선,선릉,8594,7540,16134,3
2020-03-22,2호선,강남,26203,25826,52029,3
2020-03-22,2호선,사당,14745,16996,31741,3
2020-03-22,2호선,신림,27598,27175,54773,3
2020-03-22,2호선,구로디지털단지,16619,16241,32860,3
2020-03-22,2호선,홍대입구,31762,30728,62490,3
2020-03-22,3호선,고속터미널,24746,22861,47607,3
2020-03-22,4호선,서울역,2542,4638,7180,3
2020-03-22,4호선,사당,9715,9572,19287,3
2020-03-22,경부선,서울역,2382,503,2885,3
2020-03-22,경부선,가산디지털단지,2961,3985,6946,3
2020-03-22,분당선,선릉,1736,2585,4321,3
2020-03-22,경의선,서울역,533,494,1027,3
2020-03-22,경의선,홍대입구,963,1109,2072,3
2020-03-22,7호선,고속터미널,7331,5202,12533,3
2020-03-22,7호선,가산디지털단지,6674,6529,13203,3
2020-03-22,8호선,잠실(송파구청),6291,6481,12772,3
2020-03-22,9호선,고속터미널,5926,7834,13760,3
2020-03-22,공항철도 1호선,서울역,3409,3340,6749,3
2020-03-22,공항철도 1호선,홍대입구,5085,5000,10085,3
2020-03-23,1호선,서울역,31943,30458,62401,3
2020-03-23,2호선,잠실(송파구청),53420,52284,105704,3
2020-03-23,2호선,선릉,50765,45511,96276,3
2020-03-23,2호선,강남,74050,74190,148240,3
2020-03-23,2호선,사당,29402,32611,62013,3
2020-03-23,2호선,신림,55470,53776,109246,3
2020-03-23,2호선,구로디지털단지,53274,53610,106884,3
2020-03-23,2호선,홍대입구,39383,41069,80452,3
2020-03-23,3호선,고속터미널,27618,25642,53260,3
2020-03-23,4호선,서울역,9273,11344,20617,3
2020-03-23,4호선,사당,19900,16838,36738,3
2020-03-23,경부선,서울역,2789,915,3704,3
2020-03-23,경부선,가산디지털단지,15907,17962,33869,3
2020-03-23,분당선,선릉,11341,17914,29255,3
2020-03-23,경의선,서울역,3270,4241,7511,3
2020-03-23,경의선,홍대입구,1290,1398,2688,3
2020-03-23,7호선,고속터미널,11712,9870,21582,3
2020-03-23,7호선,가산디지털단지,40533,41304,81837,3
2020-03-23,8호선,잠실(송파구청),10776,12272,23048,3
2020-03-23,9호선,고속터미널,7987,9846,17833,3
2020-03-23,공항철도 1호선,서울역,4460,4196,8656,3
2020-03-23,공항철도 1호선,홍대입구,6055,6136,12191,3
2020-03-24,1호선,서울역,31333,29473,60806,3
2020-03-24,2호선,잠실(송파구청),55000,53875,108875,3
2020-03-24,2호선,선릉,50684,45411,96095,3
2020-03-24,2호선,강남,74822,74483,149305,3
2020-03-24,2호선,사당,30434,33217,63651,3
2020-03-24,2호선,신림,55767,54061,109828,3
2020-03-24,2호선,구로디지털단지,52944,53314,106258,3
2020-03-24,2호선,홍대입구,39830,41945,81775,3
2020-03-24,3호선,고속터미널,26348,25124,51472,3
2020-03-24,4호선,서울역,9517,11406,20923,3
2020-03-24,4호선,사당,20491,17154,37645,3
2020-03-24,경부선,서울역,2413,842,3255,3
2020-03-24,경부선,가산디지털단지,15832,18033,33865,3
2020-03-24,분당선,선릉,11343,17708,29051,3
2020-03-24,경의선,서울역,3098,4041,7139,3
2020-03-24,경의선,홍대입구,1293,1378,2671,3
2020-03-24,7호선,고속터미널,11186,9836,21022,3
2020-03-24,7호선,가산디지털단지,40415,40976,81391,3
2020-03-24,8호선,잠실(송파구청),10796,12338,23134,3
2020-03-24,9호선,고속터미널,7806,9633,17439,3
2020-03-24,공항철도 1호선,서울역,4219,4174,8393,3
2020-03-24,공항철도 1호선,홍대입구,6162,6180,12342,3
2020-03-25,2호선,잠실(송파구청),56930,55768,112698,3
2020-03-25,2호선,선릉,50726,45574,96300,3
2020-03-25,2호선,강남,76454,76834,153288,3
2020-03-25,2호선,사당,31087,33957,65044,3
2020-03-25,2호선,신림,56386,54477,110863,3
2020-03-25,2호선,구로디지털단지,53332,53734,107066,3
2020-03-25,2호선,홍대입구,41827,43861,85688,3
2020-03-25,3호선,고속터미널,27247,25889,53136,3
2020-03-25,4호선,서울역,9577,11718,21295,3
2020-03-25,4호선,사당,20817,17455,38272,3
2020-03-25,경부선,서울역,2418,834,3252,3
2020-03-25,경부선,가산디지털단지,15875,17864,33739,3
2020-03-25,분당선,선릉,11444,17833,29277,3
2020-03-25,1호선,서울역,31682,29740,61422,3
2020-03-25,경의선,서울역,3190,4257,7447,3
2020-03-25,경의선,홍대입구,1350,1473,2823,3
2020-03-25,7호선,고속터미널,11049,9852,20901,3
2020-03-25,7호선,가산디지털단지,40183,40793,80976,3
2020-03-25,8호선,잠실(송파구청),11090,12677,23767,3
2020-03-25,9호선,고속터미널,8194,10359,18553,3
2020-03-25,공항철도 1호선,서울역,4275,4167,8442,3
2020-03-25,공항철도 1호선,홍대입구,6501,6710,13211,3
2020-03-26,2호선,잠실(송파구청),53888,52855,106743,3
2020-03-26,2호선,선릉,50244,45084,95328,3
2020-03-26,2호선,강남,74869,74954,149823,3
2020-03-26,2호선,사당,30702,33112,63814,3
2020-03-26,2호선,신림,55532,53515,109047,3
2020-03-26,2호선,구로디지털단지,52977,52996,105973,3
2020-03-26,2호선,홍대입구,39935,42057,81992,3
2020-03-26,3호선,고속터미널,26722,26072,52794,3
2020-03-26,4호선,서울역,9388,11511,20899,3
2020-03-26,4호선,사당,20299,17220,37519,3
2020-03-26,경부선,서울역,2442,891,3333,3
2020-03-26,경부선,가산디지털단지,15535,17785,33320,3
2020-03-26,분당선,선릉,11251,17721,28972,3
2020-03-26,경의선,서울역,3112,4098,7210,3
2020-03-26,경의선,홍대입구,1245,1438,2683,3
2020-03-26,7호선,고속터미널,10971,9968,20939,3
2020-03-26,7호선,가산디지털단지,39727,40374,80101,3
2020-03-26,8호선,잠실(송파구청),10780,12397,23177,3
2020-03-26,1호선,서울역,31431,29886,61317,3
2020-03-26,9호선,고속터미널,7652,9607,17259,3
2020-03-26,공항철도 1호선,서울역,4292,4218,8510,3
2020-03-26,공항철도 1호선,홍대입구,6174,6329,12503,3
2020-03-27,1호선,서울역,33978,32817,66795,3
2020-03-27,2호선,잠실(송파구청),58589,56706,115295,3
2020-03-27,2호선,선릉,50107,45144,95251,3
2020-03-27,2호선,강남,80402,82183,162585,3
2020-03-27,2호선,사당,33486,35854,69340,3
2020-03-27,2호선,신림,58212,56251,114463,3
2020-03-27,2호선,구로디지털단지,54150,54262,108412,3
2020-03-27,2호선,홍대입구,45014,50680,95694,3
2020-03-27,3호선,고속터미널,31784,33525,65309,3
2020-03-27,4호선,서울역,9409,12525,21934,3
2020-03-27,4호선,사당,22097,18660,40757,3
2020-03-27,경부선,서울역,3353,1157,4510,3
2020-03-27,경부선,가산디지털단지,15599,17743,33342,3
2020-03-27,분당선,선릉,11057,17710,28767,3
2020-03-27,경의선,서울역,3104,4173,7277,3
2020-03-27,경의선,홍대입구,1381,1636,3017,3
2020-03-27,7호선,고속터미널,12391,10944,23335,3
2020-03-27,7호선,가산디지털단지,39771,39976,79747,3
2020-03-27,8호선,잠실(송파구청),11726,13470,25196,3
2020-03-27,9호선,고속터미널,8927,12080,21007,3
2020-03-27,공항철도 1호선,서울역,5394,5134,10528,3
2020-03-27,공항철도 1호선,홍대입구,6959,7377,14336,3
2020-03-28,1호선,서울역,16953,16705,33658,3
2020-03-28,2호선,잠실(송파구청),40565,38048,78613,3
2020-03-28,2호선,선릉,17493,15433,32926,3
2020-03-28,2호선,강남,46628,48851,95479,3
2020-03-28,2호선,사당,21897,24245,46142,3
2020-03-28,2호선,신림,40376,38327,78703,3
2020-03-28,2호선,구로디지털단지,26610,26234,52844,3
2020-03-28,2호선,홍대입구,41866,45615,87481,3
2020-03-28,3호선,고속터미널,29535,27954,57489,3
2020-03-28,4호선,서울역,3523,6131,9654,3
2020-03-28,4호선,사당,14539,12807,27346,3
2020-03-28,경부선,서울역,2124,543,2667,3
2020-03-28,경부선,가산디지털단지,4354,5640,9994,3
2020-03-28,분당선,선릉,3480,5418,8898,3
2020-03-28,경의선,서울역,729,767,1496,3
2020-03-28,경의선,홍대입구,1220,1447,2667,3
2020-03-28,7호선,고속터미널,8410,7131,15541,3
2020-03-28,7호선,가산디지털단지,10896,10064,20960,3
2020-03-28,8호선,잠실(송파구청),8223,9126,17349,3
2020-03-28,9호선,고속터미널,7112,10441,17553,3
2020-03-28,공항철도 1호선,서울역,3560,3580,7140,3
2020-03-28,공항철도 1호선,홍대입구,6306,6458,12764,3
2020-03-29,1호선,서울역,13397,12987,26384,3
2020-03-29,2호선,잠실(송파구청),29072,27049,56121,3
2020-03-29,2호선,선릉,8792,7879,16671,3
2020-03-29,2호선,강남,25275,24989,50264,3
2020-03-29,2호선,사당,14719,16333,31052,3
2020-03-29,2호선,신림,27902,27317,55219,3
2020-03-29,2호선,구로디지털단지,16989,16766,33755,3
2020-03-29,2호선,홍대입구,30234,29623,59857,3
2020-03-29,3호선,고속터미널,25047,22912,47959,3
2020-03-29,4호선,서울역,2473,4716,7189,3
2020-03-29,4호선,사당,9757,9514,19271,3
2020-03-29,경부선,서울역,2508,562,3070,3
2020-03-29,경부선,가산디지털단지,3001,3951,6952,3
2020-03-29,분당선,선릉,1815,2729,4544,3
2020-03-29,경의선,서울역,531,506,1037,3
2020-03-29,경의선,홍대입구,946,1005,1951,3
2020-03-29,7호선,고속터미널,7351,5155,12506,3
2020-03-29,7호선,가산디지털단지,7096,6713,13809,3
2020-03-29,8호선,잠실(송파구청),6167,6515,12682,3
2020-03-29,9호선,고속터미널,5923,8057,13980,3
2020-03-29,공항철도 1호선,서울역,3353,3226,6579,3
2020-03-29,공항철도 1호선,홍대입구,4767,4613,9380,3
2020-03-30,1호선,서울역,32494,30740,63234,3
2020-03-30,2호선,잠실(송파구청),53812,52952,106764,3
2020-03-30,2호선,선릉,51235,45871,97106,3
2020-03-30,2호선,강남,73778,74047,147825,3
2020-03-30,2호선,사당,29752,32743,62495,3
2020-03-30,2호선,신림,55922,54334,110256,3
2020-03-30,2호선,구로디지털단지,53719,54006,107725,3
2020-03-30,2호선,홍대입구,39316,40589,79905,3
2020-03-30,3호선,고속터미널,28107,26052,54159,3
2020-03-30,4호선,서울역,9628,11685,21313,3
2020-03-30,4호선,사당,20011,16919,36930,3
2020-03-30,경부선,서울역,3006,936,3942,3
2020-03-30,경부선,가산디지털단지,16226,18445,34671,3
2020-03-30,분당선,선릉,11457,18049,29506,3
2020-03-30,경의선,서울역,3264,4294,7558,3
2020-03-30,경의선,홍대입구,1242,1397,2639,3
2020-03-30,7호선,고속터미널,11957,10183,22140,3
2020-03-30,7호선,가산디지털단지,41058,41789,82847,3
2020-03-30,8호선,잠실(송파구청),10817,12241,23058,3
2020-03-30,9호선,고속터미널,8079,9750,17829,3
2020-03-30,공항철도 1호선,서울역,4489,4175,8664,3
2020-03-30,공항철도 1호선,홍대입구,6082,6244,12326,3
2020-03-31,1호선,서울역,31671,30434,62105,3
2020-03-31,2호선,잠실(송파구청),55005,54239,109244,3
2020-03-31,2호선,선릉,51190,46025,97215,3
2020-03-31,2호선,강남,73891,74418,148309,3
2020-03-31,2호선,사당,30507,33626,64133,3
2020-03-31,2호선,신림,56325,54384,110709,3
2020-03-31,2호선,구로디지털단지,53051,53505,106556,3
2020-03-31,2호선,홍대입구,39862,41581,81443,3
2020-03-31,3호선,고속터미널,27171,26078,53249,3
2020-03-31,4호선,서울역,9623,11662,21285,3
2020-03-31,4호선,사당,20614,17083,37697,3
2020-03-31,경부선,서울역,2425,876,3301,3
2020-03-31,경부선,가산디지털단지,16296,18308,34604,3
2020-03-31,분당선,선릉,11555,18056,29611,3
2020-03-31,경의선,서울역,3058,4192,7250,3
2020-03-31,경의선,홍대입구,1285,1419,2704,3
2020-03-31,7호선,고속터미널,11476,10085,21561,3
2020-03-31,7호선,가산디지털단지,40731,41877,82608,3
2020-03-31,8호선,잠실(송파구청),10898,12418,23316,3
2020-03-31,9호선,고속터미널,7908,10026,17934,3
2020-03-31,공항철도 1호선,서울역,4343,3939,8282,3
2020-03-31,공항철도 1호선,홍대입구,6200,6478,12678,3
2020-04-01,2호선,잠실(송파구청),54890,53727,108617,4
2020-04-01,2호선,선릉,50145,44709,94854,4
2020-04-01,2호선,강남,74145,74244,148389,4
2020-04-01,2호선,사당,30798,33860,64658,4
2020-04-01,2호선,신림,56523,54199,110722,4
2020-04-01,2호선,구로디지털단지,53378,53594,106972,4
2020-04-01,2호선,홍대입구,41449,43584,85033,4
2020-04-01,3호선,고속터미널,26876,25858,52734,4
2020-04-01,4호선,서울역,9700,11912,21612,4
2020-04-01,4호선,사당,20759,17567,38326,4
2020-04-01,경부선,서울역,2305,786,3091,4
2020-04-01,경부선,가산디지털단지,15966,18329,34295,4
2020-04-01,분당선,선릉,11293,17757,29050,4
2020-04-01,경의선,서울역,3233,4227,7460,4
2020-04-01,경의선,홍대입구,1288,1478,2766,4
2020-04-01,7호선,고속터미널,10929,9817,20746,4
2020-04-01,7호선,가산디지털단지,40822,41379,82201,4
2020-04-01,8호선,잠실(송파구청),10883,12402,23285,4
2020-04-01,9호선,고속터미널,7912,10096,18008,4
2020-04-01,공항철도 1호선,서울역,4294,3826,8120,4
2020-04-01,공항철도 1호선,홍대입구,6421,6616,13037,4
2020-04-01,1호선,서울역,31908,30546,62454,4
2020-04-02,1호선,서울역,32391,30764,63155,4
2020-04-02,2호선,잠실(송파구청),55040,53810,108850,4
2020-04-02,2호선,선릉,50925,45759,96684,4
2020-04-02,2호선,강남,73850,74522,148372,4
2020-04-02,2호선,사당,31033,33826,64859,4
2020-04-02,2호선,신림,56209,53423,109632,4
2020-04-02,2호선,구로디지털단지,53302,53214,106516,4
2020-04-02,2호선,홍대입구,40890,43453,84343,4
2020-04-02,3호선,고속터미널,27359,26829,54188,4
2020-04-02,4호선,서울역,9579,11936,21515,4
2020-04-02,4호선,사당,20541,17532,38073,4
2020-04-02,경부선,서울역,2560,869,3429,4
2020-04-02,경부선,가산디지털단지,15966,18321,34287,4
2020-04-02,분당선,선릉,11338,17916,29254,4
2020-04-02,경의선,서울역,3166,4291,7457,4
2020-04-02,경의선,홍대입구,1390,1409,2799,4
2020-04-02,7호선,고속터미널,11167,10090,21257,4
2020-04-02,7호선,가산디지털단지,40599,41367,81966,4
2020-04-02,8호선,잠실(송파구청),10899,12337,23236,4
2020-04-02,9호선,고속터미널,7936,10138,18074,4
2020-04-02,공항철도 1호선,서울역,4414,4012,8426,4
2020-04-02,공항철도 1호선,홍대입구,6463,6450,12913,4
2020-04-03,1호선,서울역,35193,33968,69161,4
2020-04-03,2호선,잠실(송파구청),58447,56819,115266,4
2020-04-03,2호선,선릉,50487,45173,95660,4
2020-04-03,2호선,강남,78454,81684,160138,4
2020-04-03,2호선,사당,33377,36711,70088,4
2020-04-03,2호선,신림,58773,56333,115106,4
2020-04-03,2호선,구로디지털단지,54620,53942,108562,4
2020-04-03,2호선,홍대입구,45280,51422,96702,4
2020-04-03,3호선,고속터미널,33117,34869,67986,4
2020-04-03,4호선,서울역,9661,12885,22546,4
2020-04-03,4호선,사당,22276,19027,41303,4
2020-04-03,경부선,서울역,3540,1136,4676,4
2020-04-03,경부선,가산디지털단지,16040,18310,34350,4
2020-04-03,분당선,선릉,11379,17860,29239,4
2020-04-03,경의선,서울역,3289,4403,7692,4
2020-04-03,경의선,홍대입구,1453,1641,3094,4
2020-04-03,경의선,서울역,1,0,1,4
2020-04-03,7호선,고속터미널,12836,11302,24138,4
2020-04-03,7호선,가산디지털단지,40372,40668,81040,4
2020-04-03,8호선,잠실(송파구청),11452,13375,24827,4
2020-04-03,9호선,고속터미널,9185,12424,21609,4
2020-04-03,공항철도 1호선,서울역,5323,4998,10321,4
2020-04-03,공항철도 1호선,홍대입구,7329,7686,15015,4
2020-04-04,1호선,서울역,17222,16881,34103,4
2020-04-04,2호선,잠실(송파구청),39507,37111,76618,4
2020-04-04,2호선,선릉,17959,16127,34086,4
2020-04-04,2호선,강남,47013,48768,95781,4
2020-04-04,2호선,사당,22636,24478,47114,4
2020-04-04,2호선,신림,40526,38362,78888,4
2020-04-04,2호선,구로디지털단지,26245,25938,52183,4
2020-04-04,2호선,홍대입구,42516,46663,89179,4
2020-04-04,3호선,고속터미널,30623,30913,61536,4
2020-04-04,4호선,서울역,3745,6476,10221,4
2020-04-04,4호선,사당,14785,13054,27839,4
2020-04-04,경부선,서울역,2095,540,2635,4
2020-04-04,경부선,가산디지털단지,4410,5935,10345,4
2020-04-04,분당선,선릉,3511,5739,9250,4
2020-04-04,경의선,서울역,725,795,1520,4
2020-04-04,경의선,홍대입구,1318,1438,2756,4
2020-04-04,7호선,고속터미널,8783,7279,16062,4
2020-04-04,7호선,가산디지털단지,11207,10154,21361,4
2020-04-04,8호선,잠실(송파구청),8224,8914,17138,4
2020-04-04,9호선,고속터미널,6957,10302,17259,4
2020-04-04,공항철도 1호선,서울역,3438,3596,7034,4
2020-04-04,공항철도 1호선,홍대입구,6580,6865,13445,4
2020-04-05,1호선,서울역,14192,13388,27580,4
2020-04-05,2호선,잠실(송파구청),27897,25964,53861,4
2020-04-05,2호선,선릉,9408,8184,17592,4
2020-04-05,2호선,강남,25400,25236,50636,4
2020-04-05,2호선,사당,14833,16422,31255,4
2020-04-05,2호선,신림,28380,27618,55998,4
2020-04-05,2호선,구로디지털단지,16938,16765,33703,4
2020-04-05,2호선,홍대입구,31092,30449,61541,4
2020-04-05,3호선,고속터미널,25173,23223,48396,4
2020-04-05,4호선,서울역,2577,4963,7540,4
2020-04-05,4호선,사당,10059,9577,19636,4
2020-04-05,경부선,서울역,2710,557,3267,4
2020-04-05,경부선,가산디지털단지,3154,4246,7400,4
2020-04-05,분당선,선릉,1880,2893,4773,4
2020-04-05,경의선,서울역,564,527,1091,4
2020-04-05,경의선,홍대입구,979,1110,2089,4
2020-04-05,7호선,고속터미널,8053,5383,13436,4
2020-04-05,7호선,가산디지털단지,7475,6988,14463,4
2020-04-05,8호선,잠실(송파구청),6075,6345,12420,4
2020-04-05,9호선,고속터미널,5855,7776,13631,4
2020-04-05,공항철도 1호선,서울역,3477,3146,6623,4
2020-04-05,공항철도 1호선,홍대입구,4886,4862,9748,4
2020-04-06,공항철도 1호선,홍대입구,6154,6310,12464,4
2020-04-06,공항철도 1호선,서울역,4671,4342,9013,4
2020-04-06,9호선,고속터미널,8363,10015,18378,4
2020-04-06,8호선,잠실(송파구청),10904,12493,23397,4
2020-04-06,1호선,서울역,34875,32917,67792,4
2020-04-06,2호선,잠실(송파구청),53992,52917,106909,4
2020-04-06,2호선,선릉,52508,47268,99776,4
2020-04-06,2호선,강남,76736,76489,153225,4
2020-04-06,2호선,사당,30671,33756,64427,4
2020-04-06,2호선,신림,56911,54927,111838,4
2020-04-06,2호선,구로디지털단지,55053,55166,110219,4
2020-04-06,2호선,홍대입구,40521,42358,82879,4
2020-04-06,3호선,고속터미널,28849,26740,55589,4
2020-04-06,4호선,서울역,10303,12783,23086,4
2020-04-06,4호선,사당,20513,17664,38177,4
2020-04-06,경부선,서울역,3175,954,4129,4
2020-04-06,경부선,가산디지털단지,16749,19213,35962,4
2020-04-06,분당선,선릉,11986,18714,30700,4
2020-04-06,경의선,서울역,3448,4473,7921,4
2020-04-06,경의선,홍대입구,1254,1367,2621,4
2020-04-06,7호선,고속터미널,12522,10595,23117,4
2020-04-06,7호선,가산디지털단지,42532,43107,85639,4
2020-04-07,1호선,서울역,33973,32286,66259,4
2020-04-07,2호선,잠실(송파구청),55178,54019,109197,4
2020-04-07,2호선,선릉,52733,47064,99797,4
2020-04-07,2호선,강남,77633,77320,154953,4
2020-04-07,2호선,사당,31505,34461,65966,4
2020-04-07,2호선,신림,57673,55328,113001,4
2020-04-07,2호선,구로디지털단지,55195,55289,110484,4
2020-04-07,2호선,홍대입구,40731,43196,83927,4
2020-04-07,3호선,고속터미널,27507,26527,54034,4
2020-04-07,4호선,서울역,10352,12641,22993,4
2020-04-07,4호선,사당,21144,17846,38990,4
2020-04-07,경부선,서울역,2660,866,3526,4
2020-04-07,경부선,가산디지털단지,16585,19023,35608,4
2020-04-07,분당선,선릉,11788,18589,30377,4
2020-04-07,경의선,서울역,3349,4478,7827,4
2020-04-07,경의선,홍대입구,1304,1365,2669,4
2020-04-07,7호선,고속터미널,11835,10381,22216,4
2020-04-07,7호선,가산디지털단지,42348,43243,85591,4
2020-04-07,8호선,잠실(송파구청),10996,12379,23375,4
2020-04-07,9호선,고속터미널,8031,10206,18237,4
2020-04-07,공항철도 1호선,서울역,4384,4031,8415,4
2020-04-07,공항철도 1호선,홍대입구,6336,6500,12836,4
2020-04-08,1호선,서울역,33925,31959,65884,4
2020-04-08,2호선,잠실(송파구청),55877,54651,110528,4
2020-04-08,2호선,선릉,52734,46998,99732,4
2020-04-08,2호선,강남,77544,77579,155123,4
2020-04-08,2호선,사당,32290,34946,67236,4
2020-04-08,2호선,신림,57603,55623,113226,4
2020-04-08,2호선,구로디지털단지,55254,55638,110892,4
2020-04-08,2호선,홍대입구,42385,44953,87338,4
2020-04-08,3호선,고속터미널,28127,26934,55061,4
2020-04-08,4호선,서울역,10300,12742,23042,4
2020-04-08,4호선,사당,21516,18067,39583,4
2020-04-08,경부선,서울역,2638,848,3486,4
2020-04-08,경부선,가산디지털단지,16507,19000,35507,4
2020-04-08,분당선,선릉,11790,18526,30316,4
2020-04-08,경의선,서울역,3340,4452,7792,4
2020-04-08,경의선,홍대입구,1358,1464,2822,4
2020-04-08,7호선,고속터미널,11449,10368,21817,4
2020-04-08,7호선,가산디지털단지,42737,43109,85846,4
2020-04-08,8호선,잠실(송파구청),11168,12749,23917,4
2020-04-08,9호선,고속터미널,8345,10369,18714,4
2020-04-08,공항철도 1호선,서울역,4441,4095,8536,4
2020-04-08,공항철도 1호선,홍대입구,6567,6763,13330,4
2020-04-09,1호선,서울역,34555,32908,67463,4
2020-04-09,2호선,잠실(송파구청),55936,54780,110716,4
2020-04-09,2호선,선릉,53029,47417,100446,4
2020-04-09,2호선,강남,77853,78121,155974,4
2020-04-09,2호선,사당,32325,35450,67775,4
2020-04-09,2호선,신림,58060,55526,113586,4
2020-04-09,2호선,구로디지털단지,55311,55264,110575,4
2020-04-09,2호선,홍대입구,42689,45186,87875,4
2020-04-09,3호선,고속터미널,27765,27477,55242,4
2020-04-09,4호선,서울역,10374,12780,23154,4
2020-04-09,4호선,사당,21289,18235,39524,4
2020-04-09,경부선,서울역,2864,903,3767,4
2020-04-09,경부선,가산디지털단지,16532,19120,35652,4
2020-04-09,분당선,선릉,11900,18733,30633,4
2020-04-09,경의선,서울역,3363,4440,7803,4
2020-04-09,경의선,홍대입구,1317,1466,2783,4
2020-04-09,7호선,고속터미널,11541,10384,21925,4
2020-04-09,7호선,가산디지털단지,42295,43157,85452,4
2020-04-09,8호선,잠실(송파구청),11117,12849,23966,4
2020-04-09,9호선,고속터미널,7957,10416,18373,4
2020-04-09,공항철도 1호선,서울역,4647,4417,9064,4
2020-04-09,공항철도 1호선,홍대입구,6558,6818,13376,4
2020-04-10,1호선,서울역,37476,36130,73606,4
2020-04-10,9호선,고속터미널,9330,12712,22042,4
2020-04-10,공항철도 1호선,서울역,5700,5468,11168,4
2020-04-10,공항철도 1호선,홍대입구,7303,7812,15115,4
2020-04-10,2호선,잠실(송파구청),59251,57446,116697,4
2020-04-10,2호선,선릉,52804,47366,100170,4
2020-04-10,2호선,강남,82377,85018,167395,4
2020-04-10,2호선,사당,34446,37799,72245,4
2020-04-10,2호선,신림,60181,57472,117653,4
2020-04-10,2호선,구로디지털단지,55934,55599,111533,4
2020-04-10,2호선,홍대입구,46598,53384,99982,4
2020-04-10,3호선,고속터미널,33381,35917,69298,4
2020-04-10,4호선,서울역,9731,13313,23044,4
2020-04-10,4호선,사당,22827,19478,42305,4
2020-04-10,경부선,서울역,3845,1208,5053,4
2020-04-10,경부선,가산디지털단지,16787,19088,35875,4
2020-04-10,분당선,선릉,11852,18739,30591,4
2020-04-10,경의선,서울역,3438,4549,7987,4
2020-04-10,경의선,홍대입구,1556,1725,3281,4
2020-04-10,7호선,고속터미널,13170,11657,24827,4
2020-04-10,7호선,가산디지털단지,42002,42477,84479,4
2020-04-10,8호선,잠실(송파구청),11773,13804,25577,4
2020-04-11,1호선,서울역,18999,18675,37674,4
2020-04-11,2호선,잠실(송파구청),40249,38073,78322,4
2020-04-11,2호선,선릉,18108,16026,34134,4
2020-04-11,2호선,강남,48917,50831,99748,4
2020-04-11,2호선,사당,23723,25860,49583,4
2020-04-11,2호선,신림,41984,39884,81868,4
2020-04-11,2호선,구로디지털단지,27261,27115,54376,4
2020-04-11,2호선,홍대입구,44105,49257,93362,4
2020-04-11,3호선,고속터미널,31676,32299,63975,4
2020-04-11,4호선,서울역,3823,7004,10827,4
2020-04-11,4호선,사당,15518,13670,29188,4
2020-04-11,경부선,서울역,2354,627,2981,4
2020-04-11,경부선,가산디지털단지,4854,6283,11137,4
2020-04-11,분당선,선릉,3603,5804,9407,4
2020-04-11,경의선,서울역,825,862,1687,4
2020-04-11,경의선,홍대입구,1322,1569,2891,4
2020-04-11,7호선,고속터미널,9291,7917,17208,4
2020-04-11,7호선,가산디지털단지,11853,10881,22734,4
2020-04-11,8호선,잠실(송파구청),8273,9116,17389,4
2020-04-11,9호선,고속터미널,7602,10923,18525,4
2020-04-11,공항철도 1호선,서울역,3772,3769,7541,4
2020-04-11,공항철도 1호선,홍대입구,6911,7202,14113,4
2020-04-12,1호선,서울역,14850,13910,28760,4
2020-04-12,2호선,잠실(송파구청),28640,26298,54938,4
2020-04-12,2호선,선릉,9125,7878,17003,4
2020-04-12,2호선,강남,26851,26697,53548,4
2020-04-12,2호선,사당,16034,17787,33821,4
2020-04-12,2호선,신림,29147,28769,57916,4
2020-04-12,2호선,구로디지털단지,17506,17295,34801,4
2020-04-12,2호선,홍대입구,32654,31853,64507,4
2020-04-12,3호선,고속터미널,26196,24399,50595,4
2020-04-12,4호선,서울역,2748,5266,8014,4
2020-04-12,4호선,사당,10588,10184,20772,4
2020-04-12,경부선,서울역,2854,611,3465,4
2020-04-12,경부선,가산디지털단지,3358,4564,7922,4
2020-04-12,분당선,선릉,1819,2852,4671,4
2020-04-12,경의선,서울역,584,612,1196,4
2020-04-12,경의선,홍대입구,983,1129,2112,4
2020-04-12,7호선,고속터미널,8365,5688,14053,4
2020-04-12,7호선,가산디지털단지,7984,7459,15443,4
2020-04-12,8호선,잠실(송파구청),6369,6573,12942,4
2020-04-12,9호선,고속터미널,6105,8248,14353,4
2020-04-12,공항철도 1호선,서울역,3701,3410,7111,4
2020-04-12,공항철도 1호선,홍대입구,5284,5008,10292,4
2020-04-13,1호선,서울역,35559,33780,69339,4
2020-04-13,2호선,잠실(송파구청),55730,54860,110590,4
2020-04-13,2호선,선릉,53401,47917,101318,4
2020-04-13,2호선,강남,78506,78629,157135,4
2020-04-13,2호선,사당,31596,34864,66460,4
2020-04-13,2호선,신림,57593,55617,113210,4
2020-04-13,2호선,구로디지털단지,56016,56361,112377,4
2020-04-13,2호선,홍대입구,40991,43291,84282,4
2020-04-13,3호선,고속터미널,29678,27800,57478,4
2020-04-13,4호선,서울역,10322,12993,23315,4
2020-04-13,4호선,사당,21326,17961,39287,4
2020-04-13,경부선,서울역,3338,968,4306,4
2020-04-13,경부선,가산디지털단지,17364,19913,37277,4
2020-04-13,분당선,선릉,12042,19035,31077,4
2020-04-13,경의선,서울역,3545,4620,8165,4
2020-04-13,경의선,홍대입구,1265,1464,2729,4
2020-04-13,7호선,고속터미널,12915,10811,23726,4
2020-04-13,7호선,가산디지털단지,43735,44368,88103,4
2020-04-13,8호선,잠실(송파구청),10952,12921,23873,4
2020-04-13,9호선,고속터미널,8749,10829,19578,4
2020-04-13,공항철도 1호선,서울역,4911,4463,9374,4
2020-04-13,공항철도 1호선,홍대입구,6488,6432,12920,4
2020-04-14,1호선,서울역,35326,31057,66383,4
2020-04-14,공항철도 1호선,홍대입구,7100,7609,14709,4
2020-04-14,공항철도 1호선,서울역,5084,4849,9933,4
2020-04-14,9호선,고속터미널,9044,11325,20369,4
2020-04-14,2호선,잠실(송파구청),59047,57471,116518,4
2020-04-14,2호선,선릉,53854,48411,102265,4
2020-04-14,2호선,강남,82146,84845,166991,4
2020-04-14,2호선,사당,34555,38883,73438,4
2020-04-14,2호선,신림,60952,58057,119009,4
2020-04-14,2호선,구로디지털단지,58098,57942,116040,4
2020-04-14,2호선,홍대입구,44720,49627,94347,4
2020-04-14,3호선,고속터미널,31301,31311,62612,4
2020-04-14,4호선,서울역,10877,15039,25916,4
2020-04-14,4호선,사당,22799,19702,42501,4
2020-04-14,경부선,서울역,3280,1077,4357,4
2020-04-14,경부선,가산디지털단지,16943,17007,33950,4
2020-04-14,분당선,선릉,11921,19173,31094,4
2020-04-14,경의선,서울역,3424,4558,7982,4
2020-04-14,경의선,홍대입구,1535,1607,3142,4
2020-04-14,7호선,고속터미널,12767,11443,24210,4
2020-04-14,7호선,가산디지털단지,44139,47075,91214,4
2020-04-14,8호선,잠실(송파구청),11648,13682,25330,4
2020-04-15,1호선,서울역,15883,15392,31275,4
2020-04-15,2호선,잠실(송파구청),33954,32048,66002,4
2020-04-15,2호선,선릉,15375,13677,29052,4
2020-04-15,2호선,강남,39820,39836,79656,4
2020-04-15,2호선,사당,19882,21117,40999,4
2020-04-15,2호선,신림,37211,35626,72837,4
2020-04-15,2호선,구로디지털단지,24356,24201,48557,4
2020-04-15,2호선,홍대입구,37410,38412,75822,4
2020-04-15,3호선,고속터미널,25804,24473,50277,4
2020-04-15,4호선,서울역,3305,5517,8822,4
2020-04-15,4호선,사당,12645,11359,24004,4
2020-04-15,경부선,서울역,1791,459,2250,4
2020-04-15,경부선,가산디지털단지,4624,5992,10616,4
2020-04-15,분당선,선릉,2980,4829,7809,4
2020-04-15,경의선,서울역,759,722,1481,4
2020-04-15,경의선,홍대입구,1134,1240,2374,4
2020-04-15,7호선,고속터미널,6930,5722,12652,4
2020-04-15,7호선,가산디지털단지,11715,11210,22925,4
2020-04-15,8호선,잠실(송파구청),7295,7820,15115,4
2020-04-15,9호선,고속터미널,6278,8288,14566,4
2020-04-15,공항철도 1호선,서울역,3274,2913,6187,4
2020-04-15,공항철도 1호선,홍대입구,5985,5673,11658,4
2020-04-16,2호선,잠실(송파구청),56999,55354,112353,4
2020-04-16,2호선,선릉,53721,48468,102189,4
2020-04-16,2호선,강남,79588,80277,159865,4
2020-04-16,2호선,사당,32709,36114,68823,4
2020-04-16,2호선,신림,58701,56312,115013,4
2020-04-16,2호선,구로디지털단지,56909,56807,113716,4
2020-04-16,2호선,홍대입구,43677,46627,90304,4
2020-04-16,3호선,고속터미널,30195,28881,59076,4
2020-04-16,4호선,서울역,10379,13250,23629,4
2020-04-16,4호선,사당,21784,18704,40488,4
2020-04-16,경부선,서울역,3170,1003,4173,4
2020-04-16,경부선,가산디지털단지,17178,19626,36804,4
2020-04-16,분당선,선릉,12070,18983,31053,4
2020-04-16,1호선,서울역,35605,34109,69714,4
2020-04-16,경의선,서울역,3377,4598,7975,4
2020-04-16,경의선,홍대입구,1440,1492,2932,4
2020-04-16,7호선,고속터미널,12233,10876,23109,4
2020-04-16,7호선,가산디지털단지,43270,44168,87438,4
2020-04-16,8호선,잠실(송파구청),11258,12904,24162,4
2020-04-16,9호선,고속터미널,8921,10993,19914,4
2020-04-16,공항철도 1호선,서울역,4986,4582,9568,4
2020-04-16,공항철도 1호선,홍대입구,6782,7068,13850,4
2020-04-17,1호선,서울역,37747,36293,74040,4
2020-04-17,2호선,잠실(송파구청),57615,56723,114338,4
2020-04-17,2호선,선릉,53022,47622,100644,4
2020-04-17,2호선,강남,81657,85231,166888,4
2020-04-17,2호선,사당,34200,37740,71940,4
2020-04-17,2호선,신림,59112,56574,115686,4
2020-04-17,2호선,구로디지털단지,56267,56053,112320,4
2020-04-17,2호선,홍대입구,43485,50115,93600,4
2020-04-17,3호선,고속터미널,34187,36347,70534,4
2020-04-17,4호선,서울역,10438,14019,24457,4
2020-04-17,4호선,사당,22810,19505,42315,4
2020-04-17,경부선,서울역,4159,1205,5364,4
2020-04-17,경부선,가산디지털단지,17036,19240,36276,4
2020-04-17,분당선,선릉,11986,18996,30982,4
2020-04-17,경의선,서울역,3416,4487,7903,4
2020-04-17,경의선,홍대입구,1413,1628,3041,4
2020-04-17,7호선,고속터미널,13841,11844,25685,4
2020-04-17,7호선,가산디지털단지,43246,43797,87043,4
2020-04-17,8호선,잠실(송파구청),11672,13924,25596,4
2020-04-17,9호선,고속터미널,9200,12487,21687,4
2020-04-17,공항철도 1호선,서울역,5928,5490,11418,4
2020-04-17,공항철도 1호선,홍대입구,6941,7432,14373,4
2020-04-18,1호선,서울역,20347,20007,40354,4
2020-04-18,2호선,잠실(송파구청),44857,41779,86636,4
2020-04-18,2호선,선릉,20453,18154,38607,4
2020-04-18,2호선,강남,53203,55836,109039,4
2020-04-18,2호선,사당,25688,28583,54271,4
2020-04-18,2호선,신림,43937,41616,85553,4
2020-04-18,2호선,구로디지털단지,28972,28491,57463,4
2020-04-18,2호선,홍대입구,47934,54196,102130,4
2020-04-18,3호선,고속터미널,36187,36178,72365,4
2020-04-18,4호선,서울역,4030,7797,11827,4
2020-04-18,4호선,사당,16954,14797,31751,4
2020-04-18,경부선,서울역,2689,655,3344,4
2020-04-18,경부선,가산디지털단지,5183,6789,11972,4
2020-04-18,분당선,선릉,3996,6470,10466,4
2020-04-18,경의선,서울역,904,951,1855,4
2020-04-18,경의선,홍대입구,1455,1742,3197,4
2020-04-18,7호선,고속터미널,10261,8692,18953,4
2020-04-18,7호선,가산디지털단지,12698,11813,24511,4
2020-04-18,8호선,잠실(송파구청),9139,10092,19231,4
2020-04-18,9호선,고속터미널,8922,12363,21285,4
2020-04-18,공항철도 1호선,서울역,4145,4108,8253,4
2020-04-18,공항철도 1호선,홍대입구,7665,7890,15555,4
2020-04-19,1호선,서울역,16073,15162,31235,4
2020-04-19,2호선,잠실(송파구청),28859,27104,55963,4
2020-04-19,2호선,선릉,9499,8377,17876,4
2020-04-19,2호선,강남,27795,27093,54888,4
2020-04-19,2호선,사당,15722,17466,33188,4
2020-04-19,2호선,신림,28876,28296,57172,4
2020-04-19,2호선,구로디지털단지,17560,17562,35122,4
2020-04-19,2호선,홍대입구,31170,30653,61823,4
2020-04-19,3호선,고속터미널,28269,26288,54557,4
2020-04-19,4호선,서울역,2719,5285,8004,4
2020-04-19,4호선,사당,10527,9986,20513,4
2020-04-19,경부선,서울역,3274,622,3896,4
2020-04-19,경부선,가산디지털단지,3151,4468,7619,4
2020-04-19,분당선,선릉,1970,3003,4973,4
2020-04-19,경의선,서울역,612,591,1203,4
2020-04-19,경의선,홍대입구,971,1060,2031,4
2020-04-19,7호선,고속터미널,8781,5904,14685,4
2020-04-19,7호선,가산디지털단지,8129,7654,15783,4
2020-04-19,8호선,잠실(송파구청),6884,6927,13811,4
2020-04-19,9호선,고속터미널,5907,8100,14007,4
2020-04-19,공항철도 1호선,서울역,3966,3625,7591,4
2020-04-19,공항철도 1호선,홍대입구,4890,4811,9701,4
2020-04-20,1호선,서울역,37589,35472,73061,4
2020-04-20,2호선,잠실(송파구청),56147,55433,111580,4
2020-04-20,2호선,선릉,55302,49836,105138,4
2020-04-20,2호선,강남,79632,80189,159821,4
2020-04-20,2호선,사당,32354,35964,68318,4
2020-04-20,2호선,신림,59056,57170,116226,4
2020-04-20,2호선,구로디지털단지,58042,58238,116280,4
2020-04-20,2호선,홍대입구,41403,43660,85063,4
2020-04-20,3호선,고속터미널,30671,28461,59132,4
2020-04-20,4호선,서울역,10907,13608,24515,4
2020-04-20,4호선,사당,21793,18550,40343,4
2020-04-20,경부선,서울역,3603,1060,4663,4
2020-04-20,경부선,가산디지털단지,17549,20185,37734,4
2020-04-20,분당선,선릉,12308,19896,32204,4
2020-04-20,경의선,서울역,3691,4735,8426,4
2020-04-20,경의선,홍대입구,1283,1436,2719,4
2020-04-20,7호선,고속터미널,13124,11047,24171,4
2020-04-20,7호선,가산디지털단지,44784,45225,90009,4
2020-04-20,8호선,잠실(송파구청),11483,13246,24729,4
2020-04-20,9호선,고속터미널,8845,10931,19776,4
2020-04-20,공항철도 1호선,서울역,5249,4734,9983,4
2020-04-20,공항철도 1호선,홍대입구,6368,6686,13054,4
2020-04-21,1호선,서울역,37052,35001,72053,4
2020-04-21,2호선,잠실(송파구청),59606,58659,118265,4
2020-04-21,2호선,선릉,56014,50360,106374,4
2020-04-21,2호선,강남,82960,82857,165817,4
2020-04-21,2호선,사당,33748,36963,70711,4
2020-04-21,2호선,신림,60389,58411,118800,4
2020-04-21,2호선,구로디지털단지,58564,59004,117568,4
2020-04-21,2호선,홍대입구,43950,46128,90078,4
2020-04-21,3호선,고속터미널,31214,29801,61015,4
2020-04-21,4호선,서울역,11127,13851,24978,4
2020-04-21,4호선,사당,22935,19177,42112,4
2020-04-21,경부선,서울역,3165,927,4092,4
2020-04-21,경부선,가산디지털단지,17213,20085,37298,4
2020-04-21,분당선,선릉,12452,19757,32209,4
2020-04-21,경의선,서울역,3495,4753,8248,4
2020-04-21,경의선,홍대입구,1289,1458,2747,4
2020-04-21,7호선,고속터미널,12681,11192,23873,4
2020-04-21,7호선,가산디지털단지,45301,45451,90752,4
2020-04-21,8호선,잠실(송파구청),12130,13659,25789,4
2020-04-21,9호선,고속터미널,8702,10957,19659,4
2020-04-21,공항철도 1호선,서울역,4856,4472,9328,4
2020-04-21,공항철도 1호선,홍대입구,6523,6914,13437,4
2020-04-22,1호선,서울역,36994,34911,71905,4
2020-04-22,2호선,잠실(송파구청),59309,58414,117723,4
2020-04-22,2호선,선릉,55979,49991,105970,4
2020-04-22,2호선,강남,82439,82489,164928,4
2020-04-22,2호선,사당,34106,37187,71293,4
2020-04-22,2호선,신림,60222,57839,118061,4
2020-04-22,2호선,구로디지털단지,58498,58680,117178,4
2020-04-22,2호선,홍대입구,44792,47248,92040,4
2020-04-22,3호선,고속터미널,31581,30396,61977,4
2020-04-22,4호선,서울역,10915,13761,24676,4
2020-04-22,4호선,사당,22790,19097,41887,4
2020-04-22,경부선,서울역,3170,978,4148,4
2020-04-22,경부선,가산디지털단지,17177,19715,36892,4
2020-04-22,분당선,선릉,12411,19628,32039,4
2020-04-22,경의선,서울역,3543,4654,8197,4
2020-04-22,경의선,홍대입구,1371,1539,2910,4
2020-04-22,7호선,고속터미널,12660,11227,23887,4
2020-04-22,7호선,가산디지털단지,44748,44827,89575,4
2020-04-22,8호선,잠실(송파구청),12059,13860,25919,4
2020-04-22,9호선,고속터미널,9135,11523,20658,4
2020-04-22,공항철도 1호선,서울역,4998,4565,9563,4
2020-04-22,공항철도 1호선,홍대입구,6666,6931,13597,4
2020-04-23,1호선,서울역,37835,35886,73721,4
2020-04-23,2호선,잠실(송파구청),60339,59456,119795,4
2020-04-23,2호선,선릉,56425,50600,107025,4
2020-04-23,2호선,강남,83453,84365,167818,4
2020-04-23,2호선,사당,34798,37889,72687,4
2020-04-23,2호선,신림,61043,58474,119517,4
2020-04-23,2호선,구로디지털단지,59293,59402,118695,4
2020-04-23,2호선,홍대입구,46128,49171,95299,4
2020-04-23,3호선,고속터미널,32060,31297,63357,4
2020-04-23,4호선,서울역,11094,14217,25311,4
2020-04-23,4호선,사당,23041,19369,42410,4
2020-04-23,경부선,서울역,3369,1042,4411,4
2020-04-23,경부선,가산디지털단지,17428,20120,37548,4
2020-04-23,분당선,선릉,12665,20120,32785,4
2020-04-23,경의선,서울역,3563,4769,8332,4
2020-04-23,경의선,홍대입구,1376,1612,2988,4
2020-04-23,7호선,고속터미널,13116,11671,24787,4
2020-04-23,7호선,가산디지털단지,44833,45216,90049,4
2020-04-23,8호선,잠실(송파구청),11914,13842,25756,4
2020-04-23,9호선,고속터미널,9177,11635,20812,4
2020-04-23,공항철도 1호선,서울역,5215,4812,10027,4
2020-04-23,공항철도 1호선,홍대입구,6941,7390,14331,4
2020-04-24,2호선,잠실(송파구청),64922,63254,128176,4
2020-04-24,2호선,선릉,56805,50845,107650,4
2020-04-24,2호선,강남,89681,93972,183653,4
2020-04-24,2호선,사당,37730,41765,79495,4
2020-04-24,2호선,신림,63983,60908,124891,4
2020-04-24,2호선,구로디지털단지,60890,60812,121702,4
2020-04-24,2호선,홍대입구,51292,58845,110137,4
2020-04-24,3호선,고속터미널,38569,40703,79272,4
2020-04-24,4호선,서울역,11437,15491,26928,4
2020-04-24,4호선,사당,24883,21559,46442,4
2020-04-24,경부선,서울역,4592,1359,5951,4
2020-04-24,경부선,가산디지털단지,17941,20605,38546,4
2020-04-24,분당선,선릉,12651,20373,33024,4
2020-04-24,1호선,서울역,42256,39856,82112,4
2020-04-24,경의선,서울역,3713,5012,8725,4
2020-04-24,경의선,홍대입구,1583,1796,3379,4
2020-04-24,7호선,고속터미널,15126,12984,28110,4
2020-04-24,7호선,가산디지털단지,45124,45168,90292,4
2020-04-24,8호선,잠실(송파구청),13181,15210,28391,4
2020-04-24,9호선,고속터미널,10643,14335,24978,4
2020-04-24,공항철도 1호선,서울역,6561,6067,12628,4
2020-04-24,공항철도 1호선,홍대입구,8136,8756,16892,4
2020-04-25,1호선,서울역,23149,22675,45824,4
2020-04-25,2호선,잠실(송파구청),48694,45503,94197,4
2020-04-25,2호선,선릉,22375,19863,42238,4
2020-04-25,2호선,강남,57149,60256,117405,4
2020-04-25,2호선,사당,27438,30392,57830,4
2020-04-25,2호선,신림,46886,44417,91303,4
2020-04-25,2호선,구로디지털단지,31700,31370,63070,4
2020-04-25,2호선,홍대입구,51661,58556,110217,4
2020-04-25,3호선,고속터미널,39321,39355,78676,4
2020-04-25,4호선,서울역,4351,8513,12864,4
2020-04-25,4호선,사당,17850,15837,33687,4
2020-04-25,경부선,서울역,3247,800,4047,4
2020-04-25,경부선,가산디지털단지,5315,7091,12406,4
2020-04-25,분당선,선릉,4353,7271,11624,4
2020-04-25,경의선,서울역,964,1043,2007,4
2020-04-25,경의선,홍대입구,1566,1888,3454,4
2020-04-25,7호선,고속터미널,11433,9306,20739,4
2020-04-25,7호선,가산디지털단지,13149,12195,25344,4
2020-04-25,8호선,잠실(송파구청),9746,10813,20559,4
2020-04-25,9호선,고속터미널,9193,13474,22667,4
2020-04-25,공항철도 1호선,서울역,4738,4637,9375,4
2020-04-25,공항철도 1호선,홍대입구,8338,8545,16883,4
2020-04-26,1호선,서울역,17690,16629,34319,4
2020-04-26,2호선,잠실(송파구청),35233,32964,68197,4
2020-04-26,2호선,선릉,10990,9664,20654,4
2020-04-26,2호선,강남,32442,31585,64027,4
2020-04-26,2호선,사당,18777,20781,39558,4
2020-04-26,2호선,신림,32878,32070,64948,4
2020-04-26,2호선,구로디지털단지,20770,20520,41290,4
2020-04-26,2호선,홍대입구,39297,38351,77648,4
2020-04-26,3호선,고속터미널,31898,30292,62190,4
2020-04-26,4호선,서울역,3238,6567,9805,4
2020-04-26,4호선,사당,12524,11615,24139,4
2020-04-26,경부선,서울역,3365,695,4060,4
2020-04-26,경부선,가산디지털단지,3867,5032,8899,4
2020-04-26,분당선,선릉,2248,3565,5813,4
2020-04-26,경의선,서울역,744,760,1504,4
2020-04-26,경의선,홍대입구,1256,1449,2705,4
2020-04-26,7호선,고속터미널,9558,6740,16298,4
2020-04-26,7호선,가산디지털단지,9498,8775,18273,4
2020-04-26,8호선,잠실(송파구청),7615,8028,15643,4
2020-04-26,9호선,고속터미널,7584,10257,17841,4
2020-04-26,공항철도 1호선,서울역,4520,4274,8794,4
2020-04-26,공항철도 1호선,홍대입구,6428,6155,12583,4
2020-04-27,1호선,서울역,39504,37592,77096,4
2020-04-27,2호선,잠실(송파구청),59475,58916,118391,4
2020-04-27,2호선,선릉,57394,51696,109090,4
2020-04-27,2호선,강남,84080,81425,165505,4
2020-04-27,2호선,사당,34154,38035,72189,4
2020-04-27,2호선,신림,61486,58936,120422,4
2020-04-27,2호선,구로디지털단지,60569,60646,121215,4
2020-04-27,2호선,홍대입구,44201,46497,90698,4
2020-04-27,3호선,고속터미널,34336,32434,66770,4
2020-04-27,4호선,서울역,11342,14544,25886,4
2020-04-27,4호선,사당,23050,19464,42514,4
2020-04-27,경부선,서울역,3906,1092,4998,4
2020-04-27,경부선,가산디지털단지,18270,20804,39074,4
2020-04-27,분당선,선릉,12847,20455,33302,4
2020-04-27,경의선,서울역,3817,5000,8817,4
2020-04-27,경의선,홍대입구,1368,1510,2878,4
2020-04-27,7호선,고속터미널,14162,12030,26192,4
2020-04-27,7호선,가산디지털단지,45728,46596,92324,4
2020-04-27,8호선,잠실(송파구청),12067,13753,25820,4
2020-04-27,9호선,고속터미널,9669,12274,21943,4
2020-04-27,공항철도 1호선,서울역,5582,5050,10632,4
2020-04-27,공항철도 1호선,홍대입구,6824,7068,13892,4
2020-04-28,1호선,서울역,40217,38527,78744,4
2020-04-28,2호선,잠실(송파구청),62587,61108,123695,4
2020-04-28,2호선,선릉,57866,52025,109891,4
2020-04-28,2호선,강남,86470,83769,170239,4
2020-04-28,2호선,사당,35623,39415,75038,4
2020-04-28,2호선,신림,62189,59691,121880,4
2020-04-28,2호선,구로디지털단지,60711,60939,121650,4
2020-04-28,2호선,홍대입구,46375,49104,95479,4
2020-04-28,3호선,고속터미널,34707,34227,68934,4
2020-04-28,4호선,서울역,11245,15085,26330,4
2020-04-28,4호선,사당,23731,20001,43732,4
2020-04-28,경부선,서울역,3621,1042,4663,4
2020-04-28,경부선,가산디지털단지,18266,20879,39145,4
2020-04-28,분당선,선릉,13173,20611,33784,4
2020-04-28,경의선,서울역,3785,5012,8797,4
2020-04-28,경의선,홍대입구,1490,1638,3128,4
2020-04-28,7호선,고속터미널,14041,12425,26466,4
2020-04-28,7호선,가산디지털단지,46112,47165,93277,4
2020-04-28,8호선,잠실(송파구청),12420,14334,26754,4
2020-04-28,9호선,고속터미널,9854,12548,22402,4
2020-04-28,공항철도 1호선,서울역,5645,5145,10790,4
2020-04-28,공항철도 1호선,홍대입구,7275,7573,14848,4
2020-04-29,1호선,서울역,44067,44758,88825,4
2020-04-29,2호선,잠실(송파구청),65880,63944,129824,4
2020-04-29,2호선,선릉,58989,52501,111490,4
2020-04-29,2호선,강남,90440,91148,181588,4
2020-04-29,2호선,사당,37959,42028,79987,4
2020-04-29,2호선,신림,65242,61491,126733,4
2020-04-29,2호선,구로디지털단지,62592,61780,124372,4
2020-04-29,2호선,홍대입구,50189,56863,107052,4
2020-04-29,3호선,고속터미널,39340,47621,86961,4
2020-04-29,4호선,서울역,11582,17506,29088,4
2020-04-29,4호선,사당,25569,21792,47361,4
2020-04-29,경부선,서울역,4720,1482,6202,4
2020-04-29,경부선,가산디지털단지,18739,21469,40208,4
2020-04-29,분당선,선릉,12886,20936,33822,4
2020-04-29,경의선,서울역,3949,5355,9304,4
2020-04-29,경의선,홍대입구,1650,1812,3462,4
2020-04-29,7호선,고속터미널,15244,14361,29605,4
2020-04-29,7호선,가산디지털단지,46474,46602,93076,4
2020-04-29,8호선,잠실(송파구청),12924,15336,28260,4
2020-04-29,9호선,고속터미널,11333,16886,28219,4
2020-04-29,공항철도 1호선,서울역,6900,7346,14246,4
2020-04-29,공항철도 1호선,홍대입구,8261,8657,16918,4
2020-04-30,2호선,잠실(송파구청),43683,41208,84891,4
2020-04-30,2호선,선릉,16147,14116,30263,4
2020-04-30,2호선,강남,41984,42466,84450,4
2020-04-30,2호선,사당,22546,24663,47209,4
2020-04-30,2호선,신림,41729,37524,79253,4
2020-04-30,2호선,구로디지털단지,27892,26695,54587,4
2020-04-30,2호선,홍대입구,45089,49461,94550,4
2020-04-30,3호선,고속터미널,36539,43899,80438,4
2020-04-30,8호선,잠실(송파구청),8982,10029,19011,4
2020-04-30,9호선,고속터미널,9107,15236,24343,4
2020-04-30,공항철도 1호선,서울역,5032,6331,11363,4
2020-04-30,공항철도 1호선,홍대입구,7672,7922,15594,4
2020-04-30,4호선,서울역,4080,10058,14138,4
2020-04-30,4호선,사당,16050,13671,29721,4
2020-04-30,경부선,서울역,3322,1003,4325,4
2020-04-30,경부선,가산디지털단지,5187,6583,11770,4
2020-04-30,분당선,선릉,3177,5030,8207,4
2020-04-30,경의선,서울역,1043,1174,2217,4
2020-04-30,경의선,홍대입구,1527,1702,3229,4
2020-04-30,1호선,서울역,23002,27445,50447,4
2020-04-30,7호선,고속터미널,9914,9635,19549,4
2020-04-30,7호선,가산디지털단지,12460,11385,23845,4
2021-01-01,2호선,홍대입구,14982,14689,29671,1
2021-01-01,2호선,구로디지털단지,12160,12055,24215,1
2021-01-01,2호선,신림,19768,18609,38377,1
2021-01-01,2호선,사당,9266,9816,19082,1
2021-01-01,2호선,강남,13089,12668,25757,1
2021-01-01,2호선,선릉,6271,5370,11641,1
2021-01-01,2호선,잠실(송파구청),17029,16152,33181,1
2021-01-01,1호선,서울역,9260,9858,19118,1
2021-01-01,4호선,서울역,1925,3471,5396,1
2021-01-01,4호선,사당,5982,5539,11521,1
2021-01-01,3호선,고속터미널,11650,12958,24608,1
2021-01-01,7호선,고속터미널,4270,3497,7767,1
2021-01-01,7호선,가산디지털단지,5885,5299,11184,1
2021-01-01,8호선,잠실(송파구청),4481,4522,9003,1
2021-01-01,9호선,고속터미널,3048,4369,7417,1
2021-01-01,경부선,서울역,1363,520,1883,1
2021-01-01,경부선,가산디지털단지,2239,3083,5322,1
2021-01-01,경의선,서울역,370,408,778,1
2021-01-01,경의선,홍대입구,546,577,1123,1
2021-01-01,공항철도 1호선,서울역,2366,2474,4840,1
2021-01-01,공항철도 1호선,홍대입구,2865,2534,5399,1
2021-01-01,분당선,선릉,1471,1811,3282,1
2021-01-02,분당선,선릉,2467,3453,5920,1
2021-01-02,공항철도 1호선,홍대입구,3907,3896,7803,1
2021-01-02,공항철도 1호선,서울역,3039,2472,5511,1
2021-01-02,경의선,홍대입구,708,793,1501,1
2021-01-02,경의선,서울역,477,514,991,1
2021-01-02,경부선,가산디지털단지,2882,4278,7160,1
2021-01-02,경부선,서울역,2092,513,2605,1
2021-01-02,9호선,고속터미널,5633,6792,12425,1
2021-01-02,8호선,잠실(송파구청),7427,7584,15011,1
2021-01-02,7호선,가산디지털단지,8348,7926,16274,1
2021-01-02,7호선,고속터미널,6786,4984,11770,1
2021-01-02,4호선,사당,8752,8333,17085,1
2021-01-02,4호선,서울역,2425,4003,6428,1
2021-01-02,3호선,고속터미널,23856,21535,45391,1
2021-01-02,2호선,홍대입구,22086,23077,45163,1
2021-01-02,2호선,구로디지털단지,18136,18446,36582,1
2021-01-02,2호선,신림,27580,27810,55390,1
2021-01-02,2호선,사당,14117,15073,29190,1
2021-01-02,2호선,강남,26955,26265,53220,1
2021-01-02,2호선,선릉,10750,9807,20557,1
2021-01-02,2호선,잠실(송파구청),28358,26540,54898,1
2021-01-02,1호선,서울역,13135,11056,24191,1
2021-01-03,7호선,고속터미널,9182,4369,13551,1
2021-01-03,7호선,가산디지털단지,6325,6146,12471,1
2021-01-03,8호선,잠실(송파구청),5760,5870,11630,1
2021-01-03,경의선,홍대입구,579,635,1214,1
2021-01-03,경의선,서울역,493,453,946,1
2021-01-03,분당선,선릉,1530,2294,3824,1
2021-01-03,경부선,서울역,3889,580,4469,1
2021-01-03,경부선,가산디지털단지,2505,3653,6158,1
2021-01-03,공항철도 1호선,서울역,3898,2847,6745,1
2021-01-03,공항철도 1호선,홍대입구,3208,3285,6493,1
2021-01-03,9호선,고속터미널,5713,5953,11666,1
2021-01-03,4호선,사당,7229,7514,14743,1
2021-01-03,4호선,서울역,2091,3664,5755,1
2021-01-03,3호선,고속터미널,25617,19273,44890,1
2021-01-03,2호선,홍대입구,17297,17265,34562,1
2021-01-03,2호선,구로디지털단지,13608,13914,27522,1
2021-01-03,2호선,신림,21370,22647,44017,1
2021-01-03,2호선,사당,10723,11707,22430,1
2021-01-03,2호선,강남,15585,14888,30473,1
2021-01-03,2호선,선릉,6908,6282,13190,1
2021-01-03,2호선,잠실(송파구청),22484,21105,43589,1
2021-01-03,1호선,서울역,14459,11444,25903,1
2021-01-04,1호선,서울역,32167,28808,60975,1
2021-01-04,8호선,잠실(송파구청),10741,11802,22543,1
2021-01-04,7호선,고속터미널,12589,10187,22776,1
2021-01-04,경부선,가산디지털단지,15515,18128,33643,1
2021-01-04,경부선,서울역,3576,1108,4684,1
2021-01-04,7호선,가산디지털단지,43236,43364,86600,1
2021-01-04,2호선,잠실(송파구청),47940,47735,95675,1
2021-01-04,경의선,서울역,3370,4096,7466,1
2021-01-04,경의선,홍대입구,1120,1212,2332,1
2021-01-04,9호선,고속터미널,8088,9702,17790,1
2021-01-04,2호선,선릉,47528,42197,89725,1
2021-01-04,2호선,강남,63583,62032,125615,1
2021-01-04,2호선,사당,27259,29542,56801,1
2021-01-04,2호선,신림,51040,50754,101794,1
2021-01-04,2호선,구로디지털단지,51813,52528,104341,1
2021-01-04,2호선,홍대입구,32358,33288,65646,1
2021-01-04,4호선,서울역,8841,10657,19498,1
2021-01-04,4호선,사당,18371,15731,34102,1
2021-01-04,공항철도 1호선,서울역,4854,4252,9106,1
2021-01-04,공항철도 1호선,홍대입구,5280,5727,11007,1
2021-01-04,분당선,선릉,11708,16873,28581,1
2021-01-04,3호선,고속터미널,27740,25043,52783,1
2021-01-05,4호선,서울역,8622,10450,19072,1
2021-01-05,3호선,고속터미널,27387,25865,53252,1
2021-01-05,1호선,서울역,30857,28197,59054,1
2021-01-05,2호선,홍대입구,32625,33337,65962,1
2021-01-05,2호선,구로디지털단지,51608,52102,103710,1
2021-01-05,2호선,신림,51247,50498,101745,1
2021-01-05,2호선,사당,27487,29669,57156,1
2021-01-05,2호선,강남,63855,61870,125725,1
2021-01-05,2호선,선릉,47259,42005,89264,1
2021-01-05,2호선,잠실(송파구청),48673,48552,97225,1
2021-01-05,분당선,선릉,11616,16768,28384,1
2021-01-05,공항철도 1호선,홍대입구,5231,5462,10693,1
2021-01-05,공항철도 1호선,서울역,4458,3909,8367,1
2021-01-05,경의선,홍대입구,1109,1221,2330,1
2021-01-05,경의선,서울역,3141,3989,7130,1
2021-01-05,경부선,가산디지털단지,15011,17810,32821,1
2021-01-05,경부선,서울역,2671,997,3668,1
2021-01-05,9호선,고속터미널,7939,9845,17784,1
2021-01-05,8호선,잠실(송파구청),10896,12030,22926,1
2021-01-05,7호선,가산디지털단지,42727,42706,85433,1
2021-01-05,7호선,고속터미널,11600,10218,21818,1
2021-01-05,4호선,사당,18574,15738,34312,1
2021-01-06,분당선,선릉,13679,17338,31017,1
2021-01-06,공항철도 1호선,홍대입구,5501,5737,11238,1
2021-01-06,공항철도 1호선,서울역,4575,4120,8695,1
2021-01-06,경의선,홍대입구,1130,1201,2331,1
2021-01-06,경의선,서울역,3197,3772,6969,1
2021-01-06,경부선,가산디지털단지,16786,17813,34599,1
2021-01-06,경부선,서울역,2895,1019,3914,1
2021-01-06,9호선,고속터미널,8579,10497,19076,1
2021-01-06,8호선,잠실(송파구청),11783,11783,23566,1
2021-01-06,7호선,가산디지털단지,49345,42564,91909,1
2021-01-06,7호선,고속터미널,12478,10601,23079,1
2021-01-06,4호선,사당,21679,16239,37918,1
2021-01-06,4호선,서울역,8968,11028,19996,1
2021-01-06,3호선,고속터미널,28731,26216,54947,1
2021-01-06,2호선,홍대입구,34345,34489,68834,1
2021-01-06,2호선,구로디지털단지,54849,53817,108666,1
2021-01-06,2호선,신림,53737,55550,109287,1
2021-01-06,2호선,사당,30964,31578,62542,1
2021-01-06,2호선,강남,71783,61576,133359,1
2021-01-06,2호선,선릉,52838,43048,95886,1
2021-01-06,2호선,잠실(송파구청),48080,47104,95184,1
2021-01-06,1호선,서울역,31582,28321,59903,1
2021-01-07,1호선,서울역,32384,30004,62388,1
2021-01-07,분당선,선릉,13084,19289,32373,1
2021-01-07,공항철도 1호선,홍대입구,5346,5641,10987,1
2021-01-07,공항철도 1호선,서울역,4989,4357,9346,1
2021-01-07,경의선,홍대입구,1071,1169,2240,1
2021-01-07,경의선,서울역,3175,3953,7128,1
2021-01-07,경부선,가산디지털단지,15785,19289,35074,1
2021-01-07,경부선,서울역,3607,1194,4801,1
2021-01-07,9호선,고속터미널,8479,10385,18864,1
2021-01-07,8호선,잠실(송파구청),12795,14774,27569,1
2021-01-07,7호선,가산디지털단지,47001,48318,95319,1
2021-01-07,7호선,고속터미널,12081,11399,23480,1
2021-01-07,2호선,잠실(송파구청),49531,50603,100134,1
2021-01-07,2호선,선릉,49997,44540,94537,1
2021-01-07,2호선,강남,65803,64377,130180,1
2021-01-07,2호선,사당,29715,30679,60394,1
2021-01-07,2호선,신림,54950,53288,108238,1
2021-01-07,2호선,구로디지털단지,54839,55375,110214,1
2021-01-07,2호선,홍대입구,32724,33515,66239,1
2021-01-07,3호선,고속터미널,28764,27538,56302,1
2021-01-07,4호선,서울역,9096,11979,21075,1
2021-01-07,4호선,사당,19965,16357,36322,1
2021-01-08,분당선,선릉,11760,17336,29096,1
2021-01-08,공항철도 1호선,홍대입구,5380,5621,11001,1
2021-01-08,공항철도 1호선,서울역,5367,4906,10273,1
2021-01-08,2호선,잠실(송파구청),49866,49656,99522,1
2021-01-08,2호선,선릉,46786,41464,88250,1
2021-01-08,2호선,강남,65328,63676,129004,1
2021-01-08,2호선,사당,27744,29684,57428,1
2021-01-08,2호선,신림,53149,51801,104950,1
2021-01-08,2호선,구로디지털단지,51544,51685,103229,1
2021-01-08,2호선,홍대입구,35086,36500,71586,1
2021-01-08,3호선,고속터미널,31197,32258,63455,1
2021-01-08,4호선,서울역,8454,11513,19967,1
2021-01-08,4호선,사당,18938,15543,34481,1
2021-01-08,7호선,고속터미널,12334,10928,23262,1
2021-01-08,7호선,가산디지털단지,43142,43267,86409,1
2021-01-08,8호선,잠실(송파구청),12138,13484,25622,1
2021-01-08,9호선,고속터미널,8638,11298,19936,1
2021-01-08,경부선,서울역,4090,1391,5481,1
2021-01-08,경부선,가산디지털단지,14738,17572,32310,1
2021-01-08,경의선,서울역,2975,3686,6661,1
2021-01-08,경의선,홍대입구,1096,1155,2251,1
2021-01-08,1호선,서울역,32133,30399,62532,1
2021-01-09,분당선,선릉,3524,5138,8662,1
2021-01-09,공항철도 1호선,홍대입구,4761,4800,9561,1
2021-01-09,공항철도 1호선,서울역,3444,3378,6822,1
2021-01-09,경의선,홍대입구,820,931,1751,1
2021-01-09,경의선,서울역,589,664,1253,1
2021-01-09,경부선,가산디지털단지,3829,5300,9129,1
2021-01-09,경부선,서울역,2336,775,3111,1
2021-01-09,9호선,고속터미널,6598,8880,15478,1
2021-01-09,8호선,잠실(송파구청),9048,9634,18682,1
2021-01-09,7호선,가산디지털단지,11121,10329,21450,1
2021-01-09,7호선,고속터미널,7516,6647,14163,1
2021-01-09,4호선,사당,11590,9885,21475,1
2021-01-09,4호선,서울역,3078,5493,8571,1
2021-01-09,3호선,고속터미널,28566,28244,56810,1
2021-01-09,2호선,홍대입구,28225,29239,57464,1
2021-01-09,2호선,구로디지털단지,23215,23597,46812,1
2021-01-09,2호선,신림,35077,34224,69301,1
2021-01-09,2호선,사당,17801,18888,36689,1
2021-01-09,2호선,강남,36597,35527,72124,1
2021-01-09,2호선,선릉,15665,14007,29672,1
2021-01-09,2호선,잠실(송파구청),35370,34201,69571,1
2021-01-09,1호선,서울역,15359,14965,30324,1
2021-01-10,2호선,선릉,8310,7174,15484,1
2021-01-10,2호선,강남,17351,16793,34144,1
2021-01-10,2호선,사당,11467,12736,24203,1
2021-01-10,2호선,신림,23886,23482,47368,1
2021-01-10,2호선,구로디지털단지,14857,14606,29463,1
2021-01-10,2호선,홍대입구,20726,20287,41013,1
2021-01-10,분당선,선릉,1847,2532,4379,1
2021-01-10,공항철도 1호선,홍대입구,3779,3464,7243,1
2021-01-10,공항철도 1호선,서울역,3342,2723,6065,1
2021-01-10,경의선,홍대입구,683,683,1366,1
2021-01-10,경의선,서울역,450,450,900,1
2021-01-10,경부선,가산디지털단지,2720,3668,6388,1
2021-01-10,경부선,서울역,2766,678,3444,1
2021-01-10,9호선,고속터미널,5219,6506,11725,1
2021-01-10,8호선,잠실(송파구청),6210,6409,12619,1
2021-01-10,7호선,가산디지털단지,7230,6687,13917,1
2021-01-10,7호선,고속터미널,6412,4717,11129,1
2021-01-10,4호선,사당,7774,7898,15672,1
2021-01-10,4호선,서울역,2268,4107,6375,1
2021-01-10,3호선,고속터미널,22270,21035,43305,1
2021-01-10,1호선,서울역,12915,11442,24357,1
2021-01-10,2호선,잠실(송파구청),24208,23250,47458,1
2021-01-11,1호선,서울역,32106,29674,61780,1
2021-01-11,2호선,잠실(송파구청),49061,49331,98392,1
2021-01-11,2호선,선릉,49089,43808,92897,1
2021-01-11,2호선,강남,65277,63671,128948,1
2021-01-11,2호선,사당,27978,30599,58577,1
2021-01-11,2호선,신림,52727,51654,104381,1
2021-01-11,2호선,구로디지털단지,53556,53850,107406,1
2021-01-11,2호선,홍대입구,33231,34203,67434,1
2021-01-11,3호선,고속터미널,28719,26665,55384,1
2021-01-11,4호선,서울역,8838,11203,20041,1
2021-01-11,4호선,사당,18705,15631,34336,1
2021-01-11,7호선,고속터미널,12265,10588,22853,1
2021-01-11,7호선,가산디지털단지,44412,44430,88842,1
2021-01-11,8호선,잠실(송파구청),11280,12445,23725,1
2021-01-11,9호선,고속터미널,8473,10271,18744,1
2021-01-11,경부선,서울역,3529,1191,4720,1
2021-01-11,경부선,가산디지털단지,15971,18472,34443,1
2021-01-11,경의선,서울역,2235,3708,5943,1
2021-01-11,경의선,홍대입구,1091,1206,2297,1
2021-01-11,경의선,서울역,1048,210,1258,1
2021-01-11,공항철도 1호선,서울역,4937,4552,9489,1
2021-01-11,공항철도 1호선,홍대입구,5559,5630,11189,1
2021-01-11,분당선,선릉,12193,17718,29911,1
2021-01-12,1호선,서울역,34716,31369,66085,1
2021-01-12,분당선,선릉,13851,18184,32035,1
2021-01-12,공항철도 1호선,홍대입구,5917,6042,11959,1
2021-01-12,공항철도 1호선,서울역,5254,4591,9845,1
2021-01-12,경의선,홍대입구,1199,1288,2487,1
2021-01-12,경의선,서울역,3616,4077,7693,1
2021-01-12,경부선,가산디지털단지,16789,18641,35430,1
2021-01-12,경부선,서울역,3488,1168,4656,1
2021-01-12,9호선,고속터미널,8605,11000,19605,1
2021-01-12,8호선,잠실(송파구청),13125,13161,26286,1
2021-01-12,7호선,가산디지털단지,49408,43941,93349,1
2021-01-12,7호선,고속터미널,13170,11089,24259,1
2021-01-12,2호선,잠실(송파구청),52316,49696,102012,1
2021-01-12,2호선,선릉,53249,44682,97931,1
2021-01-12,2호선,강남,71916,64938,136854,1
2021-01-12,2호선,사당,29373,31273,60646,1
2021-01-12,2호선,신림,54070,55740,109810,1
2021-01-12,2호선,구로디지털단지,56015,55281,111296,1
2021-01-12,2호선,홍대입구,35494,36213,71707,1
2021-01-12,3호선,고속터미널,30238,28551,58789,1
2021-01-12,4호선,서울역,9519,12140,21659,1
2021-01-12,4호선,사당,19248,16041,35289,1
2021-01-13,4호선,사당,19499,16493,35992,1
2021-01-13,4호선,서울역,9193,11985,21178,1
2021-01-13,3호선,고속터미널,29242,28073,57315,1
2021-01-13,2호선,홍대입구,36374,37681,74055,1
2021-01-13,2호선,구로디지털단지,54546,55340,109886,1
2021-01-13,2호선,신림,55273,53230,108503,1
2021-01-13,2호선,사당,29576,31958,61534,1
2021-01-13,2호선,강남,65998,65071,131069,1
2021-01-13,2호선,선릉,49481,44932,94413,1
2021-01-13,2호선,잠실(송파구청),51875,51766,103641,1
2021-01-13,1호선,서울역,33699,31454,65153,1
2021-01-13,공항철도 1호선,서울역,5100,4603,9703,1
2021-01-13,공항철도 1호선,홍대입구,6079,6076,12155,1
2021-01-13,분당선,선릉,12205,18079,30284,1
2021-01-13,경의선,홍대입구,1265,1385,2650,1
2021-01-13,경의선,서울역,3486,4279,7765,1
2021-01-13,경부선,가산디지털단지,16084,19350,35434,1
2021-01-13,경부선,서울역,3507,1161,4668,1
2021-01-13,9호선,고속터미널,8877,11118,19995,1
2021-01-13,8호선,잠실(송파구청),11789,13235,25024,1
2021-01-13,7호선,가산디지털단지,44320,46278,90598,1
2021-01-13,7호선,고속터미널,12342,11254,23596,1
2021-01-14,1호선,서울역,33817,31496,65313,1
2021-01-14,2호선,잠실(송파구청),52026,51506,103532,1
2021-01-14,2호선,선릉,49565,44494,94059,1
2021-01-14,2호선,강남,66947,65233,132180,1
2021-01-14,2호선,사당,29544,32259,61803,1
2021-01-14,2호선,신림,54206,53033,107239,1
2021-01-14,2호선,구로디지털단지,53814,54195,108009,1
2021-01-14,2호선,홍대입구,36575,37969,74544,1
2021-01-14,3호선,고속터미널,30111,29340,59451,1
2021-01-14,4호선,서울역,9046,12020,21066,1
2021-01-14,4호선,사당,19479,16450,35929,1
2021-01-14,7호선,고속터미널,12556,11040,23596,1
2021-01-14,7호선,가산디지털단지,43594,43671,87265,1
2021-01-14,8호선,잠실(송파구청),11718,12889,24607,1
2021-01-14,9호선,고속터미널,9022,11179,20201,1
2021-01-14,경부선,서울역,3519,1119,4638,1
2021-01-14,경부선,가산디지털단지,15929,18530,34459,1
2021-01-14,경의선,서울역,3402,4150,7552,1
2021-01-14,경의선,홍대입구,1251,1314,2565,1
2021-01-14,공항철도 1호선,서울역,5231,4650,9881,1
2021-01-14,공항철도 1호선,홍대입구,6145,6282,12427,1
2021-01-14,분당선,선릉,12304,17368,29672,1
2021-01-15,7호선,고속터미널,14040,12060,26100,1
2021-01-15,7호선,가산디지털단지,43219,43024,86243,1
2021-01-15,8호선,잠실(송파구청),11922,13356,25278,1
2021-01-15,9호선,고속터미널,9791,13154,22945,1
2021-01-15,경부선,서울역,4283,1499,5782,1
2021-01-15,경부선,가산디지털단지,15803,18210,34013,1
2021-01-15,경의선,서울역,3427,4211,7638,1
2021-01-15,경의선,홍대입구,1215,1408,2623,1
2021-01-15,공항철도 1호선,서울역,5969,5567,11536,1
2021-01-15,공항철도 1호선,홍대입구,6533,6804,13337,1
2021-01-15,분당선,선릉,12154,17539,29693,1
2021-01-15,4호선,사당,20194,16625,36819,1
2021-01-15,4호선,서울역,9107,12872,21979,1
2021-01-15,3호선,고속터미널,34299,36772,71071,1
2021-01-15,2호선,홍대입구,38982,41048,80030,1
2021-01-15,2호선,구로디지털단지,54085,54146,108231,1
2021-01-15,2호선,신림,55199,54058,109257,1
2021-01-15,2호선,사당,30951,32890,63841,1
2021-01-15,2호선,강남,69966,67767,137733,1
2021-01-15,2호선,선릉,49148,44045,93193,1
2021-01-15,2호선,잠실(송파구청),53894,53187,107081,1
2021-01-15,1호선,서울역,35401,33855,69256,1
2021-01-16,1호선,서울역,18125,17851,35976,1
2021-01-16,2호선,잠실(송파구청),39752,37982,77734,1
2021-01-16,2호선,선릉,17347,15251,32598,1
2021-01-16,2호선,강남,40353,39736,80089,1
2021-01-16,2호선,사당,19741,21643,41384,1
2021-01-16,2호선,신림,38116,37059,75175,1
2021-01-16,2호선,구로디지털단지,26077,26266,52343,1
2021-01-16,2호선,홍대입구,34850,36369,71219,1
2021-01-16,3호선,고속터미널,31694,32232,63926,1
2021-01-16,4호선,서울역,3586,6546,10132,1
2021-01-16,4호선,사당,13540,11448,24988,1
2021-01-16,7호선,고속터미널,8770,7230,16000,1
2021-01-16,7호선,가산디지털단지,11878,10773,22651,1
2021-01-16,8호선,잠실(송파구청),9550,10100,19650,1
2021-01-16,9호선,고속터미널,7737,10089,17826,1
2021-01-16,경부선,서울역,2830,881,3711,1
2021-01-16,경부선,가산디지털단지,4399,6058,10457,1
2021-01-16,경의선,서울역,747,805,1552,1
2021-01-16,경의선,홍대입구,1029,1196,2225,1
2021-01-16,공항철도 1호선,서울역,3907,3856,7763,1
2021-01-16,공항철도 1호선,홍대입구,5975,5830,11805,1
2021-01-16,분당선,선릉,3910,5549,9459,1
2021-01-17,9호선,고속터미널,6045,7190,13235,1
2021-01-17,8호선,잠실(송파구청),7159,6982,14141,1
2021-01-17,7호선,가산디지털단지,7977,7260,15237,1
2021-01-17,7호선,고속터미널,8020,5229,13249,1
2021-01-17,분당선,선릉,2008,2852,4860,1
2021-01-17,공항철도 1호선,홍대입구,4647,4094,8741,1
2021-01-17,공항철도 1호선,서울역,3989,3450,7439,1
2021-01-17,경의선,홍대입구,832,925,1757,1
2021-01-17,경의선,서울역,559,554,1113,1
2021-01-17,1호선,서울역,15198,13900,29098,1
2021-01-17,2호선,잠실(송파구청),27903,26484,54387,1
2021-01-17,2호선,선릉,8964,7776,16740,1
2021-01-17,2호선,강남,20856,19654,40510,1
2021-01-17,2호선,사당,13388,14539,27927,1
2021-01-17,2호선,신림,25732,26180,51912,1
2021-01-17,2호선,구로디지털단지,16481,16494,32975,1
2021-01-17,2호선,홍대입구,24361,23774,48135,1
2021-01-17,3호선,고속터미널,25846,23623,49469,1
2021-01-17,4호선,서울역,2475,4866,7341,1
2021-01-17,4호선,사당,9083,8714,17797,1
2021-01-17,경부선,서울역,3498,774,4272,1
2021-01-17,경부선,가산디지털단지,3067,4188,7255,1
2021-01-18,3호선,고속터미널,29577,27659,57236,1
2021-01-18,공항철도 1호선,홍대입구,5986,6194,12180,1
2021-01-18,공항철도 1호선,서울역,5407,4867,10274,1
2021-01-18,경의선,홍대입구,1187,1303,2490,1
2021-01-18,경의선,서울역,3517,4529,8046,1
2021-01-18,경부선,가산디지털단지,16804,19721,36525,1
2021-01-18,경부선,서울역,4398,1303,5701,1
2021-01-18,9호선,고속터미널,8902,11080,19982,1
2021-01-18,7호선,가산디지털단지,47216,47254,94470,1
2021-01-18,7호선,고속터미널,13408,11550,24958,1
2021-01-18,4호선,사당,19531,16802,36333,1
2021-01-18,4호선,서울역,9650,12846,22496,1
2021-01-18,2호선,홍대입구,37042,38268,75310,1
2021-01-18,2호선,구로디지털단지,56390,56849,113239,1
2021-01-18,2호선,신림,55465,54484,109949,1
2021-01-18,2호선,사당,29192,32018,61210,1
2021-01-18,2호선,잠실(송파구청),52175,52597,104772,1
2021-01-18,분당선,선릉,12962,19142,32104,1
2021-01-18,2호선,강남,72347,70618,142965,1
2021-01-18,2호선,선릉,52131,46389,98520,1
2021-01-18,1호선,서울역,35369,32561,67930,1
2021-01-18,8호선,잠실(송파구청),12231,13659,25890,1
2021-01-19,3호선,고속터미널,29792,28634,58426,1
2021-01-19,1호선,서울역,33685,31254,64939,1
2021-01-19,2호선,잠실(송파구청),53100,52514,105614,1
2021-01-19,2호선,선릉,51366,45553,96919,1
2021-01-19,2호선,강남,72269,70358,142627,1
2021-01-19,2호선,사당,29707,32333,62040,1
2021-01-19,2호선,신림,54843,53965,108808,1
2021-01-19,2호선,구로디지털단지,54657,55241,109898,1
2021-01-19,2호선,홍대입구,37432,38619,76051,1
2021-01-19,4호선,서울역,9282,12173,21455,1
2021-01-19,4호선,사당,19942,16515,36457,1
2021-01-19,7호선,고속터미널,12729,10978,23707,1
2021-01-19,7호선,가산디지털단지,45308,45066,90374,1
2021-01-19,8호선,잠실(송파구청),11853,13035,24888,1
2021-01-19,9호선,고속터미널,8760,10864,19624,1
2021-01-19,경부선,서울역,3663,1142,4805,1
2021-01-19,경부선,가산디지털단지,16155,18683,34838,1
2021-01-19,경의선,서울역,3361,4145,7506,1
2021-01-19,경의선,홍대입구,1201,1284,2485,1
2021-01-19,공항철도 1호선,서울역,5281,4612,9893,1
2021-01-19,공항철도 1호선,홍대입구,6308,6235,12543,1
2021-01-19,분당선,선릉,12753,18380,31133,1
2021-01-20,분당선,선릉,12787,18486,31273,1
2021-01-20,공항철도 1호선,홍대입구,6822,6685,13507,1
2021-01-20,공항철도 1호선,서울역,5386,5011,10397,1
2021-01-20,경의선,홍대입구,1341,1435,2776,1
2021-01-20,경의선,서울역,3558,4255,7813,1
2021-01-20,경부선,가산디지털단지,16636,19219,35855,1
2021-01-20,경부선,서울역,3694,1165,4859,1
2021-01-20,9호선,고속터미널,9376,11618,20994,1
2021-01-20,8호선,잠실(송파구청),12017,13365,25382,1
2021-01-20,7호선,가산디지털단지,45760,45472,91232,1
2021-01-20,7호선,고속터미널,13193,11459,24652,1
2021-01-20,4호선,사당,20809,17471,38280,1
2021-01-20,4호선,서울역,9719,12873,22592,1
2021-01-20,3호선,고속터미널,31993,30845,62838,1
2021-01-20,2호선,홍대입구,40581,42050,82631,1
2021-01-20,2호선,구로디지털단지,56137,56638,112775,1
2021-01-20,2호선,신림,56588,55694,112282,1
2021-01-20,2호선,사당,31449,34180,65629,1
2021-01-20,2호선,강남,73685,71195,144880,1
2021-01-20,2호선,선릉,53087,47315,100402,1
2021-01-20,2호선,잠실(송파구청),55599,55172,110771,1
2021-01-20,1호선,서울역,36349,33357,69706,1
2021-01-21,2호선,잠실(송파구청),54348,53588,107936,1
2021-01-21,1호선,서울역,35657,33079,68736,1
2021-01-21,2호선,홍대입구,38853,39745,78598,1
2021-01-21,2호선,구로디지털단지,55009,55394,110403,1
2021-01-21,2호선,신림,55747,54546,110293,1
2021-01-21,2호선,사당,30566,33155,63721,1
2021-01-21,2호선,강남,72750,69953,142703,1
2021-01-21,2호선,선릉,51990,46227,98217,1
2021-01-21,분당선,선릉,12932,18486,31418,1
2021-01-21,공항철도 1호선,홍대입구,6337,6574,12911,1
2021-01-21,공항철도 1호선,서울역,5346,4894,10240,1
2021-01-21,경의선,홍대입구,1207,1346,2553,1
2021-01-21,경의선,서울역,3304,4184,7488,1
2021-01-21,경부선,가산디지털단지,15974,19016,34990,1
2021-01-21,경부선,서울역,3971,1298,5269,1
2021-01-21,9호선,고속터미널,9177,11650,20827,1
2021-01-21,8호선,잠실(송파구청),12611,13439,26050,1
2021-01-21,7호선,가산디지털단지,45742,44978,90720,1
2021-01-21,7호선,고속터미널,12946,11224,24170,1
2021-01-21,4호선,사당,20617,17093,37710,1
2021-01-21,4호선,서울역,9709,12897,22606,1
2021-01-21,3호선,고속터미널,31999,30778,62777,1
2021-01-22,분당선,선릉,12709,18480,31189,1
2021-01-22,공항철도 1호선,홍대입구,7299,7526,14825,1
2021-01-22,공항철도 1호선,서울역,6149,5800,11949,1
2021-01-22,경의선,서울역,78,59,137,1
2021-01-22,경의선,홍대입구,1394,1509,2903,1
2021-01-22,경의선,서울역,3473,4454,7927,1
2021-01-22,경부선,가산디지털단지,16460,19006,35466,1
2021-01-22,경부선,서울역,4378,1515,5893,1
2021-01-22,9호선,고속터미널,10654,14326,24980,1
2021-01-22,8호선,잠실(송파구청),12587,14193,26780,1
2021-01-22,7호선,가산디지털단지,44620,44502,89122,1
2021-01-22,7호선,고속터미널,14788,12363,27151,1
2021-01-22,4호선,사당,21778,17995,39773,1
2021-01-22,4호선,서울역,9597,13798,23395,1
2021-01-22,3호선,고속터미널,37049,39307,76356,1
2021-01-22,2호선,홍대입구,42041,44667,86708,1
2021-01-22,2호선,구로디지털단지,56271,56462,112733,1
2021-01-22,2호선,신림,57577,56248,113825,1
2021-01-22,2호선,사당,32552,35161,67713,1
2021-01-22,2호선,강남,76848,74473,151321,1
2021-01-22,2호선,선릉,51924,46420,98344,1
2021-01-22,2호선,잠실(송파구청),58575,57757,116332,1
2021-01-22,1호선,서울역,37394,35627,73021,1
2021-01-23,1호선,서울역,19819,19572,39391,1
2021-01-23,2호선,잠실(송파구청),44166,42434,86600,1
2021-01-23,2호선,선릉,19097,16908,36005,1
2021-01-23,2호선,강남,46935,45811,92746,1
2021-01-23,2호선,사당,22582,24395,46977,1
2021-01-23,2호선,신림,41656,40024,81680,1
2021-01-23,2호선,구로디지털단지,28129,28501,56630,1
2021-01-23,2호선,홍대입구,41910,44057,85967,1
2021-01-23,3호선,고속터미널,33398,34387,67785,1
2021-01-23,4호선,서울역,3831,7331,11162,1
2021-01-23,4호선,사당,14793,13026,27819,1
2021-01-23,7호선,고속터미널,9807,7864,17671,1
2021-01-23,7호선,가산디지털단지,12427,11519,23946,1
2021-01-23,8호선,잠실(송파구청),9899,10697,20596,1
2021-01-23,9호선,고속터미널,8408,11355,19763,1
2021-01-23,경부선,서울역,3149,960,4109,1
2021-01-23,경부선,가산디지털단지,4968,6607,11575,1
2021-01-23,경의선,서울역,874,905,1779,1
2021-01-23,경의선,홍대입구,1320,1374,2694,1
2021-01-23,공항철도 1호선,서울역,4466,4274,8740,1
2021-01-23,공항철도 1호선,홍대입구,7364,7226,14590,1
2021-01-23,분당선,선릉,4250,6375,10625,1
2021-01-24,1호선,서울역,16049,14725,30774,1
2021-01-24,2호선,잠실(송파구청),31371,29238,60609,1
2021-01-24,2호선,선릉,9637,8228,17865,1
2021-01-24,2호선,강남,24876,23930,48806,1
2021-01-24,2호선,사당,15326,17155,32481,1
2021-01-24,2호선,신림,29027,28694,57721,1
2021-01-24,2호선,구로디지털단지,18036,17917,35953,1
2021-01-24,2호선,홍대입구,31486,31258,62744,1
2021-01-24,3호선,고속터미널,28080,25914,53994,1
2021-01-24,4호선,서울역,2831,5452,8283,1
2021-01-24,4호선,사당,10169,9987,20156,1
2021-01-24,7호선,고속터미널,8795,5992,14787,1
2021-01-24,7호선,가산디지털단지,8483,7953,16436,1
2021-01-24,8호선,잠실(송파구청),7184,7545,14729,1
2021-01-24,9호선,고속터미널,6668,8174,14842,1
2021-01-24,경부선,서울역,3484,790,4274,1
2021-01-24,경부선,가산디지털단지,3439,4734,8173,1
2021-01-24,경의선,서울역,622,612,1234,1
2021-01-24,경의선,홍대입구,1015,1056,2071,1
2021-01-24,공항철도 1호선,서울역,4265,3662,7927,1
2021-01-24,공항철도 1호선,홍대입구,6020,5465,11485,1
2021-01-24,분당선,선릉,2156,2916,5072,1
2021-01-25,1호선,서울역,35849,33368,69217,1
2021-01-25,2호선,잠실(송파구청),55748,55345,111093,1
2021-01-25,2호선,선릉,53284,47528,100812,1
2021-01-25,2호선,강남,74320,72759,147079,1
2021-01-25,2호선,사당,30988,34085,65073,1
2021-01-25,2호선,신림,56618,55722,112340,1
2021-01-25,2호선,구로디지털단지,56991,57527,114518,1
2021-01-25,2호선,홍대입구,40292,41898,82190,1
2021-01-25,3호선,고속터미널,32837,30731,63568,1
2021-01-25,4호선,서울역,9693,12606,22299,1
2021-01-25,4호선,사당,20757,17522,38279,1
2021-01-25,7호선,고속터미널,13943,11770,25713,1
2021-01-25,7호선,가산디지털단지,45927,46257,92184,1
2021-01-25,8호선,잠실(송파구청),11950,13288,25238,1
2021-01-25,9호선,고속터미널,9793,11835,21628,1
2021-01-25,경부선,서울역,4042,1223,5265,1
2021-01-25,경부선,가산디지털단지,17195,19731,36926,1
2021-01-25,경의선,서울역,3622,4438,8060,1
2021-01-25,경의선,홍대입구,1342,1469,2811,1
2021-01-25,공항철도 1호선,서울역,5507,5040,10547,1
2021-01-25,공항철도 1호선,홍대입구,6902,6773,13675,1
2021-01-25,분당선,선릉,12937,18915,31852,1
2021-01-26,1호선,서울역,35386,32816,68202,1
2021-01-26,2호선,잠실(송파구청),55572,55199,110771,1
2021-01-26,2호선,선릉,52989,47141,100130,1
2021-01-26,2호선,강남,75375,73221,148596,1
2021-01-26,2호선,사당,31500,34156,65656,1
2021-01-26,2호선,신림,56152,55261,111413,1
2021-01-26,2호선,구로디지털단지,56578,57292,113870,1
2021-01-26,2호선,홍대입구,40002,41326,81328,1
2021-01-26,3호선,고속터미널,32278,30724,63002,1
2021-01-26,4호선,서울역,9918,13005,22923,1
2021-01-26,4호선,사당,20913,17476,38389,1
2021-01-26,7호선,고속터미널,13368,11544,24912,1
2021-01-26,7호선,가산디지털단지,45561,45599,91160,1
2021-01-26,8호선,잠실(송파구청),12107,13447,25554,1
2021-01-26,9호선,고속터미널,9457,11708,21165,1
2021-01-26,경부선,서울역,3668,1217,4885,1
2021-01-26,경부선,가산디지털단지,16710,19400,36110,1
2021-01-26,경의선,서울역,3530,4420,7950,1
2021-01-26,경의선,홍대입구,1310,1404,2714,1
2021-01-26,공항철도 1호선,서울역,5410,4870,10280,1
2021-01-26,공항철도 1호선,홍대입구,6767,6906,13673,1
2021-01-26,분당선,선릉,12936,18741,31677,1
2021-01-27,1호선,서울역,36691,33846,70537,1
2021-01-27,2호선,잠실(송파구청),57606,57429,115035,1
2021-01-27,2호선,선릉,54075,48203,102278,1
2021-01-27,2호선,강남,76859,74540,151399,1
2021-01-27,2호선,사당,32842,35970,68812,1
2021-01-27,2호선,신림,58246,57102,115348,1
2021-01-27,2호선,구로디지털단지,57901,58409,116310,1
2021-01-27,2호선,홍대입구,43801,45041,88842,1
2021-01-27,3호선,고속터미널,33580,32055,65635,1
2021-01-27,4호선,서울역,9917,13116,23033,1
2021-01-27,4호선,사당,21763,18161,39924,1
2021-01-27,7호선,고속터미널,13471,11731,25202,1
2021-01-27,7호선,가산디지털단지,46349,46216,92565,1
2021-01-27,8호선,잠실(송파구청),12597,14081,26678,1
2021-01-27,9호선,고속터미널,10009,12395,22404,1
2021-01-27,경부선,서울역,3785,1281,5066,1
2021-01-27,경부선,가산디지털단지,17026,19694,36720,1
2021-01-27,경의선,서울역,3681,4531,8212,1
2021-01-27,경의선,홍대입구,1388,1542,2930,1
2021-01-27,공항철도 1호선,서울역,5643,5022,10665,1
2021-01-27,공항철도 1호선,홍대입구,7270,7171,14441,1
2021-01-27,분당선,선릉,13280,18985,32265,1
2021-01-28,1호선,서울역,36586,33774,70360,1
2021-01-28,2호선,잠실(송파구청),56009,55366,111375,1
2021-01-28,2호선,선릉,52789,47470,100259,1
2021-01-28,2호선,강남,74434,73474,147908,1
2021-01-28,2호선,사당,31349,33675,65024,1
2021-01-28,2호선,신림,56238,53082,109320,1
2021-01-28,2호선,구로디지털단지,56841,56926,113767,1
2021-01-28,2호선,홍대입구,40711,41307,82018,1
2021-01-28,3호선,고속터미널,32696,31378,64074,1
2021-01-28,4호선,서울역,9948,13410,23358,1
2021-01-28,4호선,사당,20956,17522,38478,1
2021-01-28,7호선,고속터미널,13478,11812,25290,1
2021-01-28,7호선,가산디지털단지,46384,46043,92427,1
2021-01-28,8호선,잠실(송파구청),12772,14007,26779,1
2021-01-28,9호선,고속터미널,9433,12118,21551,1
2021-01-28,경부선,서울역,4022,1288,5310,1
2021-01-28,경부선,가산디지털단지,16525,19713,36238,1
2021-01-28,경의선,서울역,3614,4566,8180,1
2021-01-28,경의선,홍대입구,1259,1400,2659,1
2021-01-28,공항철도 1호선,서울역,5614,5183,10797,1
2021-01-28,공항철도 1호선,홍대입구,6722,6892,13614,1
2021-01-28,분당선,선릉,13079,18868,31947,1
2021-01-29,1호선,서울역,36778,34630,71408,1
2021-01-29,2호선,잠실(송파구청),57249,56910,114159,1
2021-01-29,2호선,선릉,51949,47060,99009,1
2021-01-29,2호선,강남,77789,75670,153459,1
2021-01-29,2호선,사당,31582,34048,65630,1
2021-01-29,2호선,신림,57241,55727,112968,1
2021-01-29,2호선,구로디지털단지,55673,55790,111463,1
2021-01-29,2호선,홍대입구,42908,44909,87817,1
2021-01-29,3호선,고속터미널,37060,39141,76201,1
2021-01-29,4호선,서울역,9467,13903,23370,1
2021-01-29,4호선,사당,21524,17259,38783,1
2021-01-29,7호선,고속터미널,14289,12022,26311,1
2021-01-29,7호선,가산디지털단지,44634,44540,89174,1
2021-01-29,8호선,잠실(송파구청),12965,14483,27448,1
2021-01-29,9호선,고속터미널,10323,14098,24421,1
2021-01-29,경부선,서울역,4515,1480,5995,1
2021-01-29,경부선,가산디지털단지,16232,18889,35121,1
2021-01-29,경의선,서울역,3363,4287,7650,1
2021-01-29,경의선,홍대입구,1269,1436,2705,1
2021-01-29,공항철도 1호선,서울역,6068,5725,11793,1
2021-01-29,공항철도 1호선,홍대입구,7281,7340,14621,1
2021-01-29,분당선,선릉,12599,18133,30732,1
2021-01-30,1호선,서울역,19916,19323,39239,1
2021-01-30,2호선,잠실(송파구청),45980,44184,90164,1
2021-01-30,2호선,선릉,19292,17171,36463,1
2021-01-30,2호선,강남,48890,48134,97024,1
2021-01-30,2호선,사당,22676,24606,47282,1
2021-01-30,2호선,신림,41411,40059,81470,1
2021-01-30,2호선,구로디지털단지,28651,28766,57417,1
2021-01-30,2호선,홍대입구,44160,46513,90673,1
2021-01-30,3호선,고속터미널,35084,35475,70559,1
2021-01-30,4호선,서울역,3937,7388,11325,1
2021-01-30,4호선,사당,14985,13060,28045,1
2021-01-30,7호선,고속터미널,10040,8301,18341,1
2021-01-30,7호선,가산디지털단지,12447,11568,24015,1
2021-01-30,8호선,잠실(송파구청),10371,11280,21651,1
2021-01-30,9호선,고속터미널,8713,11653,20366,1
2021-01-30,경부선,서울역,3154,878,4032,1
2021-01-30,경부선,가산디지털단지,4865,6525,11390,1
2021-01-30,경의선,서울역,850,1008,1858,1
2021-01-30,경의선,홍대입구,1266,1401,2667,1
2021-01-30,공항철도 1호선,서울역,4394,4250,8644,1
2021-01-30,공항철도 1호선,홍대입구,8013,7493,15506,1
2021-01-30,분당선,선릉,4241,6194,10435,1
2021-01-31,1호선,서울역,16353,15029,31382,1
2021-01-31,2호선,잠실(송파구청),32832,31151,63983,1
2021-01-31,2호선,선릉,9673,8596,18269,1
2021-01-31,2호선,강남,26240,25201,51441,1
2021-01-31,2호선,사당,15543,17251,32794,1
2021-01-31,2호선,신림,29480,29176,58656,1
2021-01-31,2호선,구로디지털단지,18969,18970,37939,1
2021-01-31,2호선,홍대입구,32732,32794,65526,1
2021-01-31,3호선,고속터미널,28289,26155,54444,1
2021-01-31,4호선,서울역,2914,5509,8423,1
2021-01-31,4호선,사당,10449,10214,20663,1
2021-01-31,7호선,고속터미널,8552,5677,14229,1
2021-01-31,7호선,가산디지털단지,8336,7703,16039,1
2021-01-31,8호선,잠실(송파구청),7744,8172,15916,1
2021-01-31,9호선,고속터미널,6962,8609,15571,1
2021-01-31,경부선,서울역,3488,757,4245,1
2021-01-31,경부선,가산디지털단지,3451,4883,8334,1
2021-01-31,경의선,서울역,679,582,1261,1
2021-01-31,경의선,홍대입구,1055,1116,2171,1
2021-01-31,공항철도 1호선,서울역,4296,3711,8007,1
2021-01-31,공항철도 1호선,홍대입구,6195,5711,11906,1
2021-01-31,분당선,선릉,2210,3229,5439,1
2021-02-01,분당선,선릉,13074,19017,32091,2
2021-02-01,공항철도 1호선,홍대입구,7135,7020,14155,2
2021-02-01,공항철도 1호선,서울역,5339,5034,10373,2
2021-02-01,경의선,홍대입구,1253,1409,2662,2
2021-02-01,경의선,서울역,3704,4392,8096,2
2021-02-01,경부선,가산디지털단지,17455,20075,37530,2
2021-02-01,경부선,서울역,4080,1261,5341,2
2021-02-01,9호선,고속터미널,9815,12119,21934,2
2021-02-01,8호선,잠실(송파구청),12339,13520,25859,2
2021-02-01,7호선,가산디지털단지,46772,46724,93496,2
2021-02-01,7호선,고속터미널,14204,11820,26024,2
2021-02-01,4호선,사당,20799,17572,38371,2
2021-02-01,4호선,서울역,9930,13113,23043,2
2021-02-01,3호선,고속터미널,32992,30906,63898,2
2021-02-01,2호선,홍대입구,41599,42684,84283,2
2021-02-01,2호선,구로디지털단지,57932,58583,116515,2
2021-02-01,2호선,신림,57124,56022,113146,2
2021-02-01,2호선,사당,31357,34473,65830,2
2021-02-01,2호선,강남,77926,76056,153982,2
2021-02-01,2호선,선릉,53457,46468,99925,2
2021-02-01,2호선,잠실(송파구청),56357,56358,112715,2
2021-02-01,1호선,서울역,35821,33113,68934,2
2021-02-02,분당선,선릉,12948,16633,29581,2
2021-02-02,공항철도 1호선,홍대입구,6864,6908,13772,2
2021-02-02,공항철도 1호선,서울역,5309,4804,10113,2
2021-02-02,경의선,홍대입구,1236,1344,2580,2
2021-02-02,경의선,서울역,3627,4478,8105,2
2021-02-02,경부선,가산디지털단지,16523,19584,36107,2
2021-02-02,경부선,서울역,3507,1205,4712,2
2021-02-02,9호선,고속터미널,9655,12127,21782,2
2021-02-02,8호선,잠실(송파구청),12083,13431,25514,2
2021-02-02,7호선,가산디지털단지,46760,46466,93226,2
2021-02-02,7호선,고속터미널,13405,11729,25134,2
2021-02-02,4호선,사당,21318,17947,39265,2
2021-02-02,4호선,서울역,9900,12981,22881,2
2021-02-02,3호선,고속터미널,32771,31509,64280,2
2021-02-02,2호선,홍대입구,41996,43206,85202,2
2021-02-02,2호선,구로디지털단지,57694,58042,115736,2
2021-02-02,2호선,신림,57335,56544,113879,2
2021-02-02,2호선,사당,31954,34782,66736,2
2021-02-02,2호선,강남,78830,76529,155359,2
2021-02-02,2호선,선릉,53717,47853,101570,2
2021-02-02,2호선,잠실(송파구청),56251,56103,112354,2
2021-02-02,1호선,서울역,35334,32874,68208,2
2021-02-03,8호선,잠실(송파구청),13276,14253,27529,2
2021-02-03,1호선,서울역,37234,34051,71285,2
2021-02-03,2호선,잠실(송파구청),59674,59021,118695,2
2021-02-03,2호선,선릉,55174,48278,103452,2
2021-02-03,2호선,강남,81042,76247,157289,2
2021-02-03,2호선,사당,33541,36059,69600,2
2021-02-03,2호선,신림,58881,58716,117597,2
2021-02-03,2호선,구로디지털단지,58947,58960,117907,2
2021-02-03,2호선,홍대입구,44506,45273,89779,2
2021-02-03,3호선,고속터미널,33832,32665,66497,2
2021-02-03,4호선,서울역,10206,13382,23588,2
2021-02-03,4호선,사당,21993,18323,40316,2
2021-02-03,7호선,고속터미널,13584,11748,25332,2
2021-02-03,7호선,가산디지털단지,48699,46680,95379,2
2021-02-03,9호선,고속터미널,10093,12666,22759,2
2021-02-03,경부선,서울역,3856,1279,5135,2
2021-02-03,경부선,가산디지털단지,17588,19696,37284,2
2021-02-03,경의선,서울역,3752,4644,8396,2
2021-02-03,경의선,홍대입구,1397,1490,2887,2
2021-02-03,공항철도 1호선,서울역,5609,5103,10712,2
2021-02-03,공항철도 1호선,홍대입구,7474,7429,14903,2
2021-02-03,분당선,선릉,13602,19239,32841,2
2021-02-04,1호선,서울역,36600,34669,71269,2
2021-02-04,2호선,잠실(송파구청),59188,59509,118697,2
2021-02-04,2호선,선릉,54422,48962,103384,2
2021-02-04,2호선,강남,78517,77550,156067,2
2021-02-04,2호선,사당,32830,35537,68367,2
2021-02-04,2호선,신림,59247,57440,116687,2
2021-02-04,2호선,구로디지털단지,58770,59228,117998,2
2021-02-04,2호선,홍대입구,44015,45094,89109,2
2021-02-04,3호선,고속터미널,34345,33046,67391,2
2021-02-04,4호선,서울역,10180,13864,24044,2
2021-02-04,4호선,사당,21879,18453,40332,2
2021-02-04,7호선,고속터미널,13599,12114,25713,2
2021-02-04,7호선,가산디지털단지,47437,48471,95908,2
2021-02-04,8호선,잠실(송파구청),13224,15022,28246,2
2021-02-04,9호선,고속터미널,10110,12650,22760,2
2021-02-04,경부선,서울역,4108,1264,5372,2
2021-02-04,경부선,가산디지털단지,17198,20301,37499,2
2021-02-04,경의선,서울역,3613,4533,8146,2
2021-02-04,경의선,홍대입구,1356,1504,2860,2
2021-02-04,공항철도 1호선,서울역,5737,5292,11029,2
2021-02-04,공항철도 1호선,홍대입구,7499,7488,14987,2
2021-02-04,분당선,선릉,13274,19846,33120,2
2021-02-05,2호선,잠실(송파구청),62060,61516,123576,2
2021-02-05,1호선,서울역,38838,36842,75680,2
2021-02-05,분당선,선릉,13256,19262,32518,2
2021-02-05,공항철도 1호선,홍대입구,8367,8439,16806,2
2021-02-05,공항철도 1호선,서울역,6542,6089,12631,2
2021-02-05,경의선,홍대입구,1497,1663,3160,2
2021-02-05,경의선,서울역,3760,4607,8367,2
2021-02-05,경부선,가산디지털단지,17184,19910,37094,2
2021-02-05,경부선,서울역,4562,1535,6097,2
2021-02-05,9호선,고속터미널,11448,15071,26519,2
2021-02-05,8호선,잠실(송파구청),13610,15439,29049,2
2021-02-05,7호선,가산디지털단지,46503,46160,92663,2
2021-02-05,7호선,고속터미널,15100,12507,27607,2
2021-02-05,4호선,사당,22680,19057,41737,2
2021-02-05,4호선,서울역,9595,13780,23375,2
2021-02-05,3호선,고속터미널,39439,40896,80335,2
2021-02-05,2호선,홍대입구,47924,50971,98895,2
2021-02-05,2호선,구로디지털단지,59061,59346,118407,2
2021-02-05,2호선,신림,60366,59014,119380,2
2021-02-05,2호선,사당,34697,37140,71837,2
2021-02-05,2호선,강남,82975,81476,164451,2
2021-02-05,2호선,선릉,54511,48514,103025,2
2021-02-06,2호선,잠실(송파구청),48865,46847,95712,2
2021-02-06,2호선,선릉,19671,17481,37152,2
2021-02-06,2호선,강남,50933,50582,101515,2
2021-02-06,1호선,서울역,20172,20327,40499,2
2021-02-06,2호선,사당,24876,26678,51554,2
2021-02-06,2호선,신림,43649,42048,85697,2
2021-02-06,2호선,구로디지털단지,30101,30119,60220,2
2021-02-06,2호선,홍대입구,46793,49822,96615,2
2021-02-06,3호선,고속터미널,36983,37371,74354,2
2021-02-06,4호선,서울역,4050,7763,11813,2
2021-02-06,4호선,사당,15875,13981,29856,2
2021-02-06,7호선,고속터미널,10013,8279,18292,2
2021-02-06,7호선,가산디지털단지,13344,12283,25627,2
2021-02-06,8호선,잠실(송파구청),10708,11711,22419,2
2021-02-06,9호선,고속터미널,9170,12641,21811,2
2021-02-06,경부선,서울역,3381,984,4365,2
2021-02-06,경부선,가산디지털단지,4960,6847,11807,2
2021-02-06,경의선,서울역,880,951,1831,2
2021-02-06,경의선,홍대입구,1422,1550,2972,2
2021-02-06,공항철도 1호선,서울역,4513,4437,8950,2
2021-02-06,공항철도 1호선,홍대입구,8633,8144,16777,2
2021-02-06,분당선,선릉,4306,6324,10630,2
2021-02-07,분당선,선릉,2142,3075,5217,2
2021-02-07,공항철도 1호선,홍대입구,6711,5992,12703,2
2021-02-07,공항철도 1호선,서울역,4091,4015,8106,2
2021-02-07,경의선,홍대입구,1115,1184,2299,2
2021-02-07,경의선,서울역,698,676,1374,2
2021-02-07,경부선,가산디지털단지,3465,4802,8267,2
2021-02-07,경부선,서울역,3473,874,4347,2
2021-02-07,9호선,고속터미널,6828,9100,15928,2
2021-02-07,8호선,잠실(송파구청),8363,8584,16947,2
2021-02-07,7호선,가산디지털단지,8856,8035,16891,2
2021-02-07,1호선,서울역,16216,15540,31756,2
2021-02-07,7호선,고속터미널,7812,5848,13660,2
2021-02-07,4호선,사당,10582,10335,20917,2
2021-02-07,4호선,서울역,2958,5825,8783,2
2021-02-07,3호선,고속터미널,29290,28652,57942,2
2021-02-07,2호선,홍대입구,35830,35093,70923,2
2021-02-07,2호선,구로디지털단지,19948,19924,39872,2
2021-02-07,2호선,신림,30461,29752,60213,2
2021-02-07,2호선,사당,15970,17839,33809,2
2021-02-07,2호선,강남,27923,26788,54711,2
2021-02-07,2호선,선릉,9836,8675,18511,2
2021-02-07,2호선,잠실(송파구청),34938,33188,68126,2
2021-02-08,1호선,서울역,37150,35977,73127,2
2021-02-08,2호선,잠실(송파구청),58913,58815,117728,2
2021-02-08,2호선,선릉,55167,49392,104559,2
2021-02-08,2호선,강남,82308,79973,162281,2
2021-02-08,2호선,사당,32074,35304,67378,2
2021-02-08,2호선,신림,58664,57230,115894,2
2021-02-08,2호선,구로디지털단지,58775,59021,117796,2
2021-02-08,2호선,홍대입구,44552,45333,89885,2
2021-02-08,3호선,고속터미널,36456,37151,73607,2
2021-02-08,4호선,서울역,10075,14190,24265,2
2021-02-08,4호선,사당,22007,18270,40277,2
2021-02-08,7호선,고속터미널,14233,12242,26475,2
2021-02-08,7호선,가산디지털단지,47510,47068,94578,2
2021-02-08,8호선,잠실(송파구청),12919,14409,27328,2
2021-02-08,9호선,고속터미널,10537,14267,24804,2
2021-02-08,경부선,서울역,4143,1468,5611,2
2021-02-08,경부선,가산디지털단지,17301,20147,37448,2
2021-02-08,경의선,서울역,3568,4610,8178,2
2021-02-08,경의선,홍대입구,1335,1451,2786,2
2021-02-08,공항철도 1호선,서울역,5710,5736,11446,2
2021-02-08,공항철도 1호선,홍대입구,7274,7223,14497,2
2021-02-08,분당선,선릉,13544,19369,32913,2
2021-02-09,분당선,선릉,13355,19284,32639,2
2021-02-09,공항철도 1호선,홍대입구,8086,7651,15737,2
2021-02-09,공항철도 1호선,서울역,5638,5762,11400,2
2021-02-09,경의선,홍대입구,1448,1528,2976,2
2021-02-09,경의선,서울역,3569,4537,8106,2
2021-02-09,경부선,가산디지털단지,17553,20238,37791,2
2021-02-09,경부선,서울역,3542,1484,5026,2
2021-02-09,9호선,고속터미널,10575,16239,26814,2
2021-02-09,8호선,잠실(송파구청),13118,14556,27674,2
2021-02-09,7호선,가산디지털단지,47034,46650,93684,2
2021-02-09,7호선,고속터미널,14196,13543,27739,2
2021-02-09,4호선,사당,22104,18089,40193,2
2021-02-09,4호선,서울역,9582,13468,23050,2
2021-02-09,3호선,고속터미널,37631,45248,82879,2
2021-02-09,2호선,홍대입구,46288,47746,94034,2
2021-02-09,2호선,구로디지털단지,59108,58857,117965,2
2021-02-09,2호선,신림,59181,57003,116184,2
2021-02-09,2호선,사당,33206,36177,69383,2
2021-02-09,2호선,강남,83006,81087,164093,2
2021-02-09,2호선,선릉,54922,48689,103611,2
2021-02-09,2호선,잠실(송파구청),60840,60182,121022,2
2021-02-09,1호선,서울역,36135,36127,72262,2
2021-02-10,1호선,서울역,35214,36627,71841,2
2021-02-10,2호선,잠실(송파구청),58681,59025,117706,2
2021-02-10,2호선,선릉,47006,41247,88253,2
2021-02-10,2호선,강남,78325,76577,154902,2
2021-02-10,2호선,사당,32002,36247,68249,2
2021-02-10,2호선,신림,58790,52982,111772,2
2021-02-10,2호선,구로디지털단지,55595,54089,109684,2
2021-02-10,2호선,홍대입구,47314,48701,96015,2
2021-02-10,3호선,고속터미널,40487,68076,108563,2
2021-02-10,4호선,서울역,8853,13496,22349,2
2021-02-10,4호선,사당,21704,18234,39938,2
2021-02-10,7호선,고속터미널,14086,16198,30284,2
2021-02-10,7호선,가산디지털단지,41750,40413,82163,2
2021-02-10,8호선,잠실(송파구청),13084,14629,27713,2
2021-02-10,9호선,고속터미널,11466,22642,34108,2
2021-02-10,경부선,서울역,3671,1510,5181,2
2021-02-10,경부선,가산디지털단지,15421,17503,32924,2
2021-02-10,경의선,서울역,3192,4176,7368,2
2021-02-10,경의선,홍대입구,1447,1547,2994,2
2021-02-10,공항철도 1호선,서울역,6093,6196,12289,2
2021-02-10,공항철도 1호선,홍대입구,8462,7837,16299,2
2021-02-10,분당선,선릉,11506,16711,28217,2
2021-02-11,2호선,홍대입구,28236,27682,55918,2
2021-02-11,2호선,구로디지털단지,17568,15665,33233,2
2021-02-11,2호선,신림,28692,22068,50760,2
2021-02-11,2호선,사당,12757,13794,26551,2
2021-02-11,2호선,강남,25421,24961,50382,2
2021-02-11,2호선,선릉,8346,6974,15320,2
2021-02-11,2호선,잠실(송파구청),27373,26876,54249,2
2021-02-11,1호선,서울역,14110,19009,33119,2
2021-02-11,분당선,선릉,1809,2277,4086,2
2021-02-11,공항철도 1호선,홍대입구,5628,4632,10260,2
2021-02-11,공항철도 1호선,서울역,3164,4698,7862,2
2021-02-11,경의선,홍대입구,891,791,1682,2
2021-02-11,경의선,서울역,648,653,1301,2
2021-02-11,경부선,가산디지털단지,3692,4469,8161,2
2021-02-11,경부선,서울역,1860,984,2844,2
2021-02-11,9호선,고속터미널,5061,12369,17430,2
2021-02-11,8호선,잠실(송파구청),6586,7141,13727,2
2021-02-11,7호선,가산디지털단지,8571,6893,15464,2
2021-02-11,7호선,고속터미널,5887,7303,13190,2
2021-02-11,4호선,사당,9314,7967,17281,2
2021-02-11,4호선,서울역,2610,6845,9455,2
2021-02-11,3호선,고속터미널,18760,36663,55423,2
2021-02-12,1호선,서울역,13174,12858,26032,2
2021-02-12,2호선,잠실(송파구청),20395,18677,39072,2
2021-02-12,2호선,선릉,4293,3837,8130,2
2021-02-12,2호선,강남,12443,12309,24752,2
2021-02-12,2호선,사당,8720,9564,18284,2
2021-02-12,2호선,신림,18612,19128,37740,2
2021-02-12,2호선,구로디지털단지,11353,11708,23061,2
2021-02-12,2호선,홍대입구,18000,19255,37255,2
2021-02-12,3호선,고속터미널,14576,12138,26714,2
2021-02-12,4호선,서울역,2056,4346,6402,2
2021-02-12,4호선,사당,6491,5824,12315,2
2021-02-12,7호선,고속터미널,6592,3466,10058,2
2021-02-12,7호선,가산디지털단지,5937,5314,11251,2
2021-02-12,8호선,잠실(송파구청),4638,5144,9782,2
2021-02-12,9호선,고속터미널,3763,4597,8360,2
2021-02-12,경부선,서울역,2504,635,3139,2
2021-02-12,경부선,가산디지털단지,2513,3796,6309,2
2021-02-12,경의선,서울역,568,531,1099,2
2021-02-12,경의선,홍대입구,592,736,1328,2
2021-02-12,공항철도 1호선,서울역,3375,3051,6426,2
2021-02-12,공항철도 1호선,홍대입구,3339,3332,6671,2
2021-02-12,분당선,선릉,945,1357,2302,2
2021-02-13,2호선,잠실(송파구청),38212,35590,73802,2
2021-02-13,1호선,서울역,19374,14324,33698,2
2021-02-13,2호선,홍대입구,35347,39122,74469,2
2021-02-13,3호선,고속터미널,39503,24201,63704,2
2021-02-13,2호선,선릉,7862,7493,15355,2
2021-02-13,2호선,강남,25420,25063,50483,2
2021-02-13,2호선,사당,15681,17454,33135,2
2021-02-13,2호선,신림,26538,29288,55826,2
2021-02-13,2호선,구로디지털단지,17463,18626,36089,2
2021-02-13,4호선,서울역,2849,5304,8153,2
2021-02-13,4호선,사당,10423,9835,20258,2
2021-02-13,7호선,고속터미널,12885,5192,18077,2
2021-02-13,7호선,가산디지털단지,9564,9238,18802,2
2021-02-13,8호선,잠실(송파구청),9425,9968,19393,2
2021-02-13,9호선,고속터미널,9239,8644,17883,2
2021-02-13,경부선,서울역,4000,617,4617,2
2021-02-13,경부선,가산디지털단지,3688,5764,9452,2
2021-02-13,경의선,서울역,731,669,1400,2
2021-02-13,경의선,홍대입구,1129,1374,2503,2
2021-02-13,공항철도 1호선,서울역,4957,3264,8221,2
2021-02-13,공항철도 1호선,홍대입구,6784,6954,13738,2
2021-02-13,분당선,선릉,1833,2755,4588,2
2021-02-14,분당선,선릉,1796,2694,4490,2
2021-02-14,공항철도 1호선,홍대입구,6645,6558,13203,2
2021-02-14,공항철도 1호선,서울역,5047,3875,8922,2
2021-02-14,경의선,홍대입구,1173,1349,2522,2
2021-02-14,경의선,서울역,683,681,1364,2
2021-02-14,경부선,가산디지털단지,3506,5335,8841,2
2021-02-14,경부선,서울역,5117,854,5971,2
2021-02-14,9호선,고속터미널,10938,9036,19974,2
2021-02-14,8호선,잠실(송파구청),8010,8523,16533,2
2021-02-14,7호선,가산디지털단지,8746,8663,17409,2
2021-02-14,7호선,고속터미널,16987,5791,22778,2
2021-02-14,4호선,사당,10243,10275,20518,2
2021-02-14,4호선,서울역,2817,5259,8076,2
2021-02-14,3호선,고속터미널,46854,27780,74634,2
2021-02-14,2호선,홍대입구,34249,36113,70362,2
2021-02-14,2호선,구로디지털단지,17496,18365,35861,2
2021-02-14,2호선,신림,27130,30521,57651,2
2021-02-14,2호선,사당,15363,17409,32772,2
2021-02-14,2호선,강남,24652,24027,48679,2
2021-02-14,2호선,선릉,8081,7604,15685,2
2021-02-14,2호선,잠실(송파구청),34562,32548,67110,2
2021-02-14,1호선,서울역,19379,14674,34053,2
2021-02-15,분당선,선릉,12726,18585,31311,2
2021-02-15,4호선,사당,20864,17516,38380,2
2021-02-15,4호선,서울역,9596,12233,21829,2
2021-02-15,3호선,고속터미널,40421,33141,73562,2
2021-02-15,2호선,홍대입구,44801,46529,91330,2
2021-02-15,2호선,구로디지털단지,56424,56967,113391,2
2021-02-15,2호선,신림,56403,56640,113043,2
2021-02-15,2호선,사당,30732,34226,64958,2
2021-02-15,2호선,강남,79541,77401,156942,2
2021-02-15,2호선,선릉,51883,46358,98241,2
2021-02-15,2호선,잠실(송파구청),56915,56851,113766,2
2021-02-15,1호선,서울역,37791,32541,70332,2
2021-02-15,공항철도 1호선,홍대입구,7224,7715,14939,2
2021-02-15,공항철도 1호선,서울역,6565,5128,11693,2
2021-02-15,경의선,홍대입구,1280,1467,2747,2
2021-02-15,경의선,서울역,3578,4516,8094,2
2021-02-15,경부선,가산디지털단지,15929,19088,35017,2
2021-02-15,경부선,서울역,5516,1352,6868,2
2021-02-15,9호선,고속터미널,11088,13064,24152,2
2021-02-15,8호선,잠실(송파구청),12888,14153,27041,2
2021-02-15,7호선,가산디지털단지,45249,44730,89979,2
2021-02-15,7호선,고속터미널,17318,11973,29291,2
2021-02-16,분당선,선릉,13461,19645,33106,2
2021-02-16,공항철도 1호선,홍대입구,7288,7557,14845,2
2021-02-16,공항철도 1호선,서울역,6451,5512,11963,2
2021-02-16,경의선,홍대입구,1374,1531,2905,2
2021-02-16,경의선,서울역,3878,4690,8568,2
2021-02-16,경부선,가산디지털단지,17067,20152,37219,2
2021-02-16,경부선,서울역,5042,1383,6425,2
2021-02-16,9호선,고속터미널,10442,13257,23699,2
2021-02-16,1호선,서울역,40058,35325,75383,2
2021-02-16,2호선,잠실(송파구청),60716,60342,121058,2
2021-02-16,2호선,선릉,54854,49039,103893,2
2021-02-16,2호선,강남,83284,81590,164874,2
2021-02-16,2호선,사당,32923,36087,69010,2
2021-02-16,2호선,신림,58609,58026,116635,2
2021-02-16,2호선,구로디지털단지,58911,59475,118386,2
2021-02-16,2호선,홍대입구,45742,47426,93168,2
2021-02-16,3호선,고속터미널,37106,34186,71292,2
2021-02-16,4호선,서울역,10455,14003,24458,2
2021-02-16,4호선,사당,22141,18531,40672,2
2021-02-16,8호선,잠실(송파구청),13381,15023,28404,2
2021-02-16,7호선,가산디지털단지,47708,47211,94919,2
2021-02-16,7호선,고속터미널,14976,12273,27249,2
2021-02-17,1호선,서울역,37960,35160,73120,2
2021-02-17,2호선,잠실(송파구청),58200,57975,116175,2
2021-02-17,2호선,선릉,54937,48546,103483,2
2021-02-17,2호선,강남,82823,80269,163092,2
2021-02-17,2호선,사당,32512,35757,68269,2
2021-02-17,2호선,신림,58303,57560,115863,2
2021-02-17,2호선,구로디지털단지,58508,59138,117646,2
2021-02-17,2호선,홍대입구,47155,48338,95493,2
2021-02-17,3호선,고속터미널,35682,33839,69521,2
2021-02-17,4호선,서울역,10128,13700,23828,2
2021-02-17,4호선,사당,22362,18266,40628,2
2021-02-17,7호선,고속터미널,13917,11856,25773,2
2021-02-17,7호선,가산디지털단지,47022,46503,93525,2
2021-02-17,8호선,잠실(송파구청),12675,14077,26752,2
2021-02-17,9호선,고속터미널,10224,12999,23223,2
2021-02-17,경부선,서울역,4418,1338,5756,2
2021-02-17,경부선,가산디지털단지,16703,19717,36420,2
2021-02-17,경의선,서울역,3718,4653,8371,2
2021-02-17,경의선,홍대입구,1350,1480,2830,2
2021-02-17,공항철도 1호선,서울역,6257,5632,11889,2
2021-02-17,공항철도 1호선,홍대입구,7477,7769,15246,2
2021-02-17,분당선,선릉,13518,19746,33264,2
2021-02-18,1호선,서울역,38765,35499,74264,2
2021-02-18,3호선,고속터미널,36413,34608,71021,2
2021-02-18,4호선,서울역,10132,13865,23997,2
2021-02-18,4호선,사당,22132,18287,40419,2
2021-02-18,경의선,홍대입구,1449,1596,3045,2
2021-02-18,경의선,서울역,3731,4754,8485,2
2021-02-18,경부선,가산디지털단지,16930,19929,36859,2
2021-02-18,경부선,서울역,4475,1438,5913,2
2021-02-18,9호선,고속터미널,10337,13451,23788,2
2021-02-18,8호선,잠실(송파구청),13230,14766,27996,2
2021-02-18,7호선,가산디지털단지,46836,46716,93552,2
2021-02-18,7호선,고속터미널,14202,12063,26265,2
2021-02-18,2호선,잠실(송파구청),61370,61699,123069,2
2021-02-18,2호선,선릉,54879,49148,104027,2
2021-02-18,2호선,강남,81898,79435,161333,2
2021-02-18,2호선,사당,32812,36341,69153,2
2021-02-18,2호선,신림,58753,57581,116334,2
2021-02-18,2호선,구로디지털단지,58687,59117,117804,2
2021-02-18,2호선,홍대입구,48780,50140,98920,2
2021-02-18,공항철도 1호선,서울역,6453,5879,12332,2
2021-02-18,공항철도 1호선,홍대입구,8162,8182,16344,2
2021-02-18,분당선,선릉,13709,19643,33352,2
2021-02-19,1호선,서울역,42457,39595,82052,2
2021-02-19,2호선,잠실(송파구청),66262,65769,132031,2
2021-02-19,2호선,선릉,55785,49734,105519,2
2021-02-19,2호선,강남,86800,80948,167748,2
2021-02-19,2호선,사당,36024,39217,75241,2
2021-02-19,2호선,신림,61532,60569,122101,2
2021-02-19,2호선,구로디지털단지,60476,60497,120973,2
2021-02-19,2호선,홍대입구,52874,56281,109155,2
2021-02-19,3호선,고속터미널,41239,42054,83293,2
2021-02-19,4호선,서울역,10297,15304,25601,2
2021-02-19,4호선,사당,23935,20123,44058,2
2021-02-19,7호선,고속터미널,15801,13139,28940,2
2021-02-19,7호선,가산디지털단지,46897,46724,93621,2
2021-02-19,8호선,잠실(송파구청),13846,15877,29723,2
2021-02-19,9호선,고속터미널,11669,15825,27494,2
2021-02-19,경부선,서울역,5822,1839,7661,2
2021-02-19,경부선,가산디지털단지,17726,20242,37968,2
2021-02-19,경의선,서울역,3896,4976,8872,2
2021-02-19,경의선,홍대입구,1602,1866,3468,2
2021-02-19,공항철도 1호선,서울역,7534,7244,14778,2
2021-02-19,공항철도 1호선,홍대입구,9303,9453,18756,2
2021-02-19,분당선,선릉,13671,19971,33642,2
2021-02-20,2호선,잠실(송파구청),55404,52812,108216,2
2021-02-20,2호선,선릉,21767,19460,41227,2
2021-02-20,2호선,강남,56460,53046,109506,2
2021-02-20,2호선,사당,26240,28703,54943,2
2021-02-20,2호선,신림,46128,44792,90920,2
2021-02-20,2호선,구로디지털단지,31986,31703,63689,2
2021-02-20,2호선,홍대입구,54166,58150,112316,2
2021-02-20,공항철도 1호선,서울역,5696,5756,11452,2
2021-02-20,공항철도 1호선,홍대입구,10031,9531,19562,2
2021-02-20,분당선,선릉,4822,7180,12002,2
2021-02-20,경의선,홍대입구,1595,1790,3385,2
2021-02-20,경의선,서울역,1106,1205,2311,2
2021-02-20,경부선,가산디지털단지,5548,7448,12996,2
2021-02-20,경부선,서울역,4380,1189,5569,2
2021-02-20,9호선,고속터미널,10186,14096,24282,2
2021-02-20,8호선,잠실(송파구청),11395,12870,24265,2
2021-02-20,7호선,가산디지털단지,13729,12791,26520,2
2021-02-20,4호선,사당,17148,14858,32006,2
2021-02-20,4호선,서울역,4532,9068,13600,2
2021-02-20,3호선,고속터미널,41778,41188,82966,2
2021-02-20,7호선,고속터미널,11279,8932,20211,2
2021-02-20,1호선,서울역,24061,23535,47596,2
2021-02-21,분당선,선릉,2470,3788,6258,2
2021-02-21,공항철도 1호선,홍대입구,8279,7254,15533,2
2021-02-21,공항철도 1호선,서울역,5234,4688,9922,2
2021-02-21,경의선,홍대입구,1320,1527,2847,2
2021-02-21,경의선,서울역,807,813,1620,2
2021-02-21,경부선,가산디지털단지,3911,5405,9316,2
2021-02-21,경부선,서울역,4462,1055,5517,2
2021-02-21,9호선,고속터미널,7909,10358,18267,2
2021-02-21,8호선,잠실(송파구청),8586,9298,17884,2
2021-02-21,7호선,가산디지털단지,9412,8770,18182,2
2021-02-21,7호선,고속터미널,8993,6631,15624,2
2021-02-21,4호선,사당,12075,11402,23477,2
2021-02-21,4호선,서울역,3334,6756,10090,2
2021-02-21,3호선,고속터미널,32519,30583,63102,2
2021-02-21,2호선,잠실(송파구청),39272,37175,76447,2
2021-02-21,2호선,선릉,11384,10100,21484,2
2021-02-21,2호선,강남,32075,31031,63106,2
2021-02-21,2호선,사당,17838,20139,37977,2
2021-02-21,2호선,신림,33364,32322,65686,2
2021-02-21,2호선,구로디지털단지,21140,20793,41933,2
2021-02-21,2호선,홍대입구,41508,42091,83599,2
2021-02-21,1호선,서울역,19650,17865,37515,2
2021-02-22,1호선,서울역,39434,36597,76031,2
2021-02-22,2호선,잠실(송파구청),61166,60668,121834,2
2021-02-22,2호선,선릉,55808,50424,106232,2
2021-02-22,2호선,강남,83602,81970,165572,2
2021-02-22,2호선,사당,33319,37268,70587,2
2021-02-22,2호선,신림,59989,58997,118986,2
2021-02-22,2호선,구로디지털단지,60867,61237,122104,2
2021-02-22,2호선,홍대입구,48127,49555,97682,2
2021-02-22,3호선,고속터미널,36720,34763,71483,2
2021-02-22,4호선,서울역,10160,13732,23892,2
2021-02-22,4호선,사당,22559,18851,41410,2
2021-02-22,7호선,고속터미널,14818,12324,27142,2
2021-02-22,7호선,가산디지털단지,47813,47777,95590,2
2021-02-22,8호선,잠실(송파구청),12809,14430,27239,2
2021-02-22,9호선,고속터미널,10708,13660,24368,2
2021-02-22,경부선,서울역,4748,1539,6287,2
2021-02-22,경부선,가산디지털단지,17806,20784,38590,2
2021-02-22,경의선,서울역,3862,5112,8974,2
2021-02-22,경의선,홍대입구,1472,1598,3070,2
2021-02-22,공항철도 1호선,서울역,6260,5828,12088,2
2021-02-22,공항철도 1호선,홍대입구,7882,7776,15658,2
2021-02-22,분당선,선릉,13636,19917,33553,2
2021-02-23,분당선,선릉,13689,20102,33791,2
2021-02-23,공항철도 1호선,홍대입구,7905,7952,15857,2
2021-02-23,공항철도 1호선,서울역,6190,5564,11754,2
2021-02-23,경의선,홍대입구,1406,1652,3058,2
2021-02-23,경의선,서울역,3824,4855,8679,2
2021-02-23,경부선,가산디지털단지,17535,20566,38101,2
2021-02-23,경부선,서울역,4374,1523,5897,2
2021-02-23,9호선,고속터미널,10479,13750,24229,2
2021-02-23,8호선,잠실(송파구청),13137,14837,27974,2
2021-02-23,7호선,가산디지털단지,47764,47720,95484,2
2021-02-23,7호선,고속터미널,14421,12176,26597,2
2021-02-23,4호선,사당,23174,19167,42341,2
2021-02-23,4호선,서울역,10204,14064,24268,2
2021-02-23,3호선,고속터미널,36468,33980,70448,2
2021-02-23,2호선,홍대입구,48044,49746,97790,2
2021-02-23,2호선,구로디지털단지,60641,61001,121642,2
2021-02-23,2호선,신림,59991,59073,119064,2
2021-02-23,2호선,사당,34658,37867,72525,2
2021-02-23,2호선,강남,84922,83364,168286,2
2021-02-23,2호선,선릉,56355,50387,106742,2
2021-02-23,2호선,잠실(송파구청),62534,61693,124227,2
2021-02-23,1호선,서울역,39101,36460,75561,2
2021-02-24,분당선,선릉,13560,19707,33267,2
2021-02-24,공항철도 1호선,홍대입구,8209,8382,16591,2
2021-02-24,공항철도 1호선,서울역,6356,5779,12135,2
2021-02-24,경의선,홍대입구,1508,1627,3135,2
2021-02-24,경의선,서울역,4112,5052,9164,2
2021-02-24,경부선,가산디지털단지,17597,20497,38094,2
2021-02-24,경부선,서울역,4400,1472,5872,2
2021-02-24,9호선,고속터미널,10944,14011,24955,2
2021-02-24,8호선,잠실(송파구청),13355,15239,28594,2
2021-02-24,7호선,가산디지털단지,47614,47528,95142,2
2021-02-24,7호선,고속터미널,14426,12290,26716,2
2021-02-24,4호선,사당,23390,19609,42999,2
2021-02-24,4호선,서울역,10569,14193,24762,2
2021-02-24,3호선,고속터미널,37321,33189,70510,2
2021-02-24,2호선,홍대입구,49588,51399,100987,2
2021-02-24,2호선,구로디지털단지,60885,61314,122199,2
2021-02-24,2호선,신림,61361,59640,121001,2
2021-02-24,2호선,사당,34978,38188,73166,2
2021-02-24,2호선,강남,84628,82667,167295,2
2021-02-24,2호선,선릉,56432,50336,106768,2
2021-02-24,2호선,잠실(송파구청),64708,63821,128529,2
2021-02-24,1호선,서울역,40202,37338,77540,2
2021-02-25,1호선,서울역,40416,37564,77980,2
2021-02-25,2호선,잠실(송파구청),63558,62773,126331,2
2021-02-25,2호선,선릉,56412,50396,106808,2
2021-02-25,2호선,강남,84374,82960,167334,2
2021-02-25,2호선,사당,34419,37909,72328,2
2021-02-25,2호선,신림,60669,59372,120041,2
2021-02-25,2호선,구로디지털단지,60700,60789,121489,2
2021-02-25,2호선,홍대입구,50667,52516,103183,2
2021-02-25,3호선,고속터미널,37038,33354,70392,2
2021-02-25,4호선,서울역,10547,14615,25162,2
2021-02-25,4호선,사당,23130,19290,42420,2
2021-02-25,7호선,고속터미널,14270,12282,26552,2
2021-02-25,7호선,가산디지털단지,47121,47455,94576,2
2021-02-25,8호선,잠실(송파구청),12966,15001,27967,2
2021-02-25,9호선,고속터미널,11046,14244,25290,2
2021-02-25,경부선,서울역,4821,1523,6344,2
2021-02-25,경부선,가산디지털단지,17753,20551,38304,2
2021-02-25,경의선,서울역,4024,4925,8949,2
2021-02-25,경의선,홍대입구,1481,1717,3198,2
2021-02-25,공항철도 1호선,서울역,6761,6182,12943,2
2021-02-25,공항철도 1호선,홍대입구,8592,8622,17214,2
2021-02-25,분당선,선릉,13457,19749,33206,2
2021-02-26,1호선,서울역,44373,43581,87954,2
2021-02-26,2호선,잠실(송파구청),67201,66400,133601,2
2021-02-26,2호선,선릉,55705,49868,105573,2
2021-02-26,2호선,강남,88904,87891,176795,2
2021-02-26,2호선,사당,36664,39827,76491,2
2021-02-26,2호선,신림,62677,60696,123373,2
2021-02-26,2호선,구로디지털단지,61720,61649,123369,2
2021-02-26,2호선,홍대입구,54628,58375,113003,2
2021-02-26,3호선,고속터미널,43182,42981,86163,2
2021-02-26,4호선,서울역,10523,16820,27343,2
2021-02-26,4호선,사당,24444,20391,44835,2
2021-02-26,7호선,고속터미널,16458,13590,30048,2
2021-02-26,7호선,가산디지털단지,47218,46891,94109,2
2021-02-26,8호선,잠실(송파구청),13882,16188,30070,2
2021-02-26,9호선,고속터미널,12706,17683,30389,2
2021-02-26,경부선,서울역,6233,2211,8444,2
2021-02-26,경부선,가산디지털단지,17894,20692,38586,2
2021-02-26,경의선,서울역,3989,5242,9231,2
2021-02-26,경의선,홍대입구,1542,1800,3342,2
2021-02-26,경의선,서울역,82,101,183,2
2021-02-26,경의선,홍대입구,206,221,427,2
2021-02-26,공항철도 1호선,서울역,7913,7834,15747,2
2021-02-26,공항철도 1호선,홍대입구,9749,9755,19504,2
2021-02-26,분당선,선릉,13510,19933,33443,2
2021-02-27,1호선,서울역,26442,28588,55030,2
2021-02-27,2호선,잠실(송파구청),56574,53383,109957,2
2021-02-27,2호선,선릉,21905,19682,41587,2
2021-02-27,2호선,강남,57464,57150,114614,2
2021-02-27,2호선,사당,26767,29730,56497,2
2021-02-27,2호선,신림,47205,44450,91655,2
2021-02-27,2호선,구로디지털단지,32169,31547,63716,2
2021-02-27,2호선,홍대입구,56129,60023,116152,2
2021-02-27,3호선,고속터미널,44514,47278,91792,2
2021-02-27,4호선,서울역,4746,11221,15967,2
2021-02-27,4호선,사당,18199,15623,33822,2
2021-02-27,7호선,고속터미널,12903,10234,23137,2
2021-02-27,7호선,가산디지털단지,14389,13127,27516,2
2021-02-27,8호선,잠실(송파구청),11415,12852,24267,2
2021-02-27,9호선,고속터미널,11120,16478,27598,2
2021-02-27,경부선,서울역,5215,1627,6842,2
2021-02-27,경부선,가산디지털단지,5770,7658,13428,2
2021-02-27,경의선,서울역,1215,1326,2541,2
2021-02-27,경의선,홍대입구,1711,2031,3742,2
2021-02-27,공항철도 1호선,서울역,6222,6895,13117,2
2021-02-27,공항철도 1호선,홍대입구,10436,10063,20499,2
2021-02-27,분당선,선릉,4788,7230,12018,2
2021-02-28,1호선,서울역,21297,19222,40519,2
2021-02-28,2호선,잠실(송파구청),43141,40772,83913,2
2021-02-28,2호선,선릉,11609,10305,21914,2
2021-02-28,2호선,강남,34214,33161,67375,2
2021-02-28,2호선,사당,19225,21952,41177,2
2021-02-28,2호선,신림,35241,34373,69614,2
2021-02-28,2호선,구로디지털단지,22678,21777,44455,2
2021-02-28,2호선,홍대입구,46495,48937,95432,2
2021-02-28,3호선,고속터미널,34902,33509,68411,2
2021-02-28,4호선,서울역,3625,7576,11201,2
2021-02-28,4호선,사당,13369,12384,25753,2
2021-02-28,7호선,고속터미널,9603,6831,16434,2
2021-02-28,7호선,가산디지털단지,10675,9906,20581,2
2021-02-28,8호선,잠실(송파구청),8840,9836,18676,2
2021-02-28,9호선,고속터미널,8450,11664,20114,2
2021-02-28,경부선,서울역,4501,1078,5579,2
2021-02-28,경부선,가산디지털단지,4283,5845,10128,2
2021-02-28,경의선,서울역,770,801,1571,2
2021-02-28,경의선,홍대입구,1476,1736,3212,2
2021-02-28,경의선,서울역,54,22,76,2
2021-02-28,공항철도 1호선,서울역,5283,4864,10147,2
2021-02-28,공항철도 1호선,홍대입구,8709,8048,16757,2
2021-02-28,분당선,선릉,2665,3896,6561,2
2021-03-01,1호선,서울역,22275,17654,39929,3
2021-03-01,2호선,잠실(송파구청),33350,31732,65082,3
2021-03-01,2호선,선릉,12022,10951,22973,3
2021-03-01,2호선,강남,27490,26223,53713,3
2021-03-01,2호선,사당,14316,15901,30217,3
2021-03-01,2호선,신림,28161,28557,56718,3
2021-03-01,2호선,구로디지털단지,19089,19818,38907,3
2021-03-01,2호선,홍대입구,28979,28407,57386,3
2021-03-01,3호선,고속터미널,34033,28463,62496,3
2021-03-01,4호선,서울역,2881,6115,8996,3
2021-03-01,4호선,사당,9852,9413,19265,3
2021-03-01,7호선,고속터미널,10359,5911,16270,3
2021-03-01,7호선,가산디지털단지,8676,8085,16761,3
2021-03-01,8호선,잠실(송파구청),8319,8891,17210,3
2021-03-01,9호선,고속터미널,7491,9964,17455,3
2021-03-01,경부선,서울역,5872,1128,7000,3
2021-03-01,경부선,가산디지털단지,3158,4725,7883,3
2021-03-01,경의선,서울역,822,720,1542,3
2021-03-01,경의선,홍대입구,758,880,1638,3
2021-03-01,공항철도 1호선,서울역,6019,6673,12692,3
2021-03-01,공항철도 1호선,홍대입구,5159,4873,10032,3
2021-03-01,분당선,선릉,2557,3878,6435,3
2021-03-02,분당선,선릉,13704,20190,33894,3
2021-03-02,공항철도 1호선,홍대입구,7289,7329,14618,3
2021-03-02,공항철도 1호선,서울역,6164,5516,11680,3
2021-03-02,경의선,홍대입구,1401,1473,2874,3
2021-03-02,경의선,서울역,4016,4995,9011,3
2021-03-02,경부선,가산디지털단지,17711,20680,38391,3
2021-03-02,경부선,서울역,4377,1363,5740,3
2021-03-02,9호선,고속터미널,10614,12803,23417,3
2021-03-02,8호선,잠실(송파구청),12590,14405,26995,3
2021-03-02,7호선,가산디지털단지,47565,47932,95497,3
2021-03-02,7호선,고속터미널,14547,12269,26816,3
2021-03-02,4호선,사당,22907,19204,42111,3
2021-03-02,4호선,서울역,10400,13269,23669,3
2021-03-02,3호선,고속터미널,34354,31976,66330,3
2021-03-02,2호선,홍대입구,43627,45029,88656,3
2021-03-02,2호선,구로디지털단지,60796,61013,121809,3
2021-03-02,2호선,신림,60561,59559,120120,3
2021-03-02,2호선,사당,33828,36964,70792,3
2021-03-02,2호선,강남,79733,78349,158082,3
2021-03-02,2호선,선릉,56065,50122,106187,3
2021-03-02,2호선,잠실(송파구청),58466,58325,116791,3
2021-03-02,1호선,서울역,38569,35327,73896,3
2021-03-03,1호선,서울역,38740,36086,74826,3
2021-03-03,2호선,잠실(송파구청),60818,60143,120961,3
2021-03-03,2호선,선릉,57196,50963,108159,3
2021-03-03,2호선,강남,81145,79518,160663,3
2021-03-03,2호선,사당,35329,38923,74252,3
2021-03-03,2호선,신림,61387,59986,121373,3
2021-03-03,2호선,구로디지털단지,61947,62303,124250,3
2021-03-03,2호선,홍대입구,45012,46953,91965,3
2021-03-03,3호선,고속터미널,34692,32717,67409,3
2021-03-03,4호선,서울역,10351,13633,23984,3
2021-03-03,4호선,사당,23531,19767,43298,3
2021-03-03,7호선,고속터미널,13818,12268,26086,3
2021-03-03,7호선,가산디지털단지,48228,48163,96391,3
2021-03-03,8호선,잠실(송파구청),12821,14906,27727,3
2021-03-03,9호선,고속터미널,10472,13231,23703,3
2021-03-03,경부선,서울역,3923,1335,5258,3
2021-03-03,경부선,가산디지털단지,18029,20963,38992,3
2021-03-03,경의선,서울역,4017,5103,9120,3
2021-03-03,경의선,홍대입구,1390,1541,2931,3
2021-03-03,공항철도 1호선,서울역,5952,5517,11469,3
2021-03-03,공항철도 1호선,홍대입구,7582,7608,15190,3
2021-03-03,분당선,선릉,13917,20471,34388,3
2021-03-04,1호선,서울역,39384,36459,75843,3
2021-03-04,2호선,잠실(송파구청),60923,60863,121786,3
2021-03-04,2호선,선릉,57096,51157,108253,3
2021-03-04,2호선,강남,81756,80376,162132,3
2021-03-04,2호선,사당,35214,38526,73740,3
2021-03-04,2호선,신림,60641,59204,119845,3
2021-03-04,2호선,구로디지털단지,61627,61838,123465,3
2021-03-04,2호선,홍대입구,45109,47052,92161,3
2021-03-04,3호선,고속터미널,34783,33338,68121,3
2021-03-04,4호선,서울역,10537,13869,24406,3
2021-03-04,4호선,사당,23411,19503,42914,3
2021-03-04,7호선,고속터미널,14215,12432,26647,3
2021-03-04,7호선,가산디지털단지,48021,48473,96494,3
2021-03-04,8호선,잠실(송파구청),12808,14681,27489,3
2021-03-04,9호선,고속터미널,10743,13475,24218,3
2021-03-04,경부선,서울역,4062,1369,5431,3
2021-03-04,경부선,가산디지털단지,18105,21083,39188,3
2021-03-04,경의선,서울역,3919,4977,8896,3
2021-03-04,경의선,홍대입구,1428,1563,2991,3
2021-03-04,공항철도 1호선,서울역,6150,5521,11671,3
2021-03-04,공항철도 1호선,홍대입구,7872,8005,15877,3
2021-03-04,분당선,선릉,14028,20387,34415,3
2021-03-05,분당선,선릉,13806,20640,34446,3
2021-03-05,공항철도 1호선,홍대입구,9237,9338,18575,3
2021-03-05,공항철도 1호선,서울역,7766,7160,14926,3
2021-03-05,경의선,홍대입구,1657,1871,3528,3
2021-03-05,경의선,서울역,4195,5378,9573,3
2021-03-05,경부선,가산디지털단지,18696,21511,40207,3
2021-03-05,경부선,서울역,5840,1903,7743,3
2021-03-05,9호선,고속터미널,12501,16161,28662,3
2021-03-05,8호선,잠실(송파구청),13777,16156,29933,3
2021-03-05,7호선,가산디지털단지,48591,48457,97048,3
2021-03-05,7호선,고속터미널,16256,13598,29854,3
2021-03-05,4호선,사당,25412,21391,46803,3
2021-03-05,4호선,서울역,10880,15527,26407,3
2021-03-05,3호선,고속터미널,41800,42513,84313,3
2021-03-05,2호선,홍대입구,53117,56850,109967,3
2021-03-05,2호선,구로디지털단지,63313,63282,126595,3
2021-03-05,2호선,신림,63820,61898,125718,3
2021-03-05,2호선,사당,38200,41670,79870,3
2021-03-05,2호선,강남,89702,89059,178761,3
2021-03-05,2호선,선릉,57041,51016,108057,3
2021-03-05,2호선,잠실(송파구청),66930,66117,133047,3
2021-03-05,1호선,서울역,43347,41173,84520,3
2021-03-06,1호선,서울역,24081,24111,48192,3
2021-03-06,2호선,잠실(송파구청),55515,52895,108410,3
2021-03-06,2호선,선릉,23052,20520,43572,3
2021-03-06,2호선,강남,59524,58708,118232,3
2021-03-06,2호선,사당,28105,31189,59294,3
2021-03-06,2호선,신림,47598,45867,93465,3
2021-03-06,2호선,구로디지털단지,32938,32423,65361,3
2021-03-06,2호선,홍대입구,58451,61417,119868,3
2021-03-06,3호선,고속터미널,42823,42520,85343,3
2021-03-06,4호선,서울역,4944,9390,14334,3
2021-03-06,4호선,사당,18761,16036,34797,3
2021-03-06,7호선,고속터미널,11916,9775,21691,3
2021-03-06,7호선,가산디지털단지,14546,13331,27877,3
2021-03-06,8호선,잠실(송파구청),11773,13136,24909,3
2021-03-06,9호선,고속터미널,11000,14878,25878,3
2021-03-06,경부선,서울역,4112,1211,5323,3
2021-03-06,경부선,가산디지털단지,5546,7766,13312,3
2021-03-06,경의선,서울역,1072,1264,2336,3
2021-03-06,경의선,홍대입구,1605,1920,3525,3
2021-03-06,공항철도 1호선,서울역,5498,5544,11042,3
2021-03-06,공항철도 1호선,홍대입구,10001,9838,19839,3
2021-03-06,분당선,선릉,4981,7820,12801,3
2021-03-07,분당선,선릉,2528,3854,6382,3
2021-03-07,공항철도 1호선,홍대입구,7781,7143,14924,3
2021-03-07,공항철도 1호선,서울역,5402,4942,10344,3
2021-03-07,경의선,홍대입구,1383,1459,2842,3
2021-03-07,경의선,서울역,870,823,1693,3
2021-03-07,경부선,가산디지털단지,4134,5701,9835,3
2021-03-07,경부선,서울역,4597,1104,5701,3
2021-03-07,9호선,고속터미널,8486,11326,19812,3
2021-03-07,8호선,잠실(송파구청),8884,9435,18319,3
2021-03-07,7호선,가산디지털단지,10548,9784,20332,3
2021-03-07,7호선,고속터미널,9618,6774,16392,3
2021-03-07,4호선,사당,13208,12372,25580,3
2021-03-07,4호선,서울역,3335,6719,10054,3
2021-03-07,3호선,고속터미널,33636,32105,65741,3
2021-03-07,2호선,홍대입구,42483,42177,84660,3
2021-03-07,2호선,구로디지털단지,21955,21273,43228,3
2021-03-07,2호선,신림,34161,33073,67234,3
2021-03-07,2호선,사당,19272,21512,40784,3
2021-03-07,2호선,강남,33301,31925,65226,3
2021-03-07,2호선,선릉,12067,10494,22561,3
2021-03-07,2호선,잠실(송파구청),39966,37372,77338,3
2021-03-07,1호선,서울역,20003,18339,38342,3
2021-03-08,1호선,서울역,38662,36316,74978,3
2021-03-08,2호선,잠실(송파구청),57580,57471,115051,3
2021-03-08,2호선,선릉,56343,50474,106817,3
2021-03-08,2호선,강남,81168,79812,160980,3
2021-03-08,2호선,사당,33897,37261,71158,3
2021-03-08,2호선,신림,61020,59197,120217,3
2021-03-08,2호선,구로디지털단지,61424,62001,123425,3
2021-03-08,2호선,홍대입구,44653,46173,90826,3
2021-03-08,3호선,고속터미널,35520,33408,68928,3
2021-03-08,4호선,서울역,10500,13693,24193,3
2021-03-08,4호선,사당,22773,19273,42046,3
2021-03-08,7호선,고속터미널,14845,12580,27425,3
2021-03-08,7호선,가산디지털단지,48455,48558,97013,3
2021-03-08,8호선,잠실(송파구청),12245,14063,26308,3
2021-03-08,9호선,고속터미널,10646,13378,24024,3
2021-03-08,경부선,서울역,4479,1477,5956,3
2021-03-08,경부선,가산디지털단지,18177,21400,39577,3
2021-03-08,경의선,서울역,4254,5199,9453,3
2021-03-08,경의선,홍대입구,1417,1589,3006,3
2021-03-08,공항철도 1호선,서울역,6063,5694,11757,3
2021-03-08,공항철도 1호선,홍대입구,7468,7540,15008,3
2021-03-08,분당선,선릉,13580,20135,33715,3
2021-03-09,1호선,서울역,38644,36039,74683,3
2021-03-09,2호선,잠실(송파구청),61665,60698,122363,3
2021-03-09,2호선,선릉,57309,51270,108579,3
2021-03-09,2호선,강남,82016,80941,162957,3
2021-03-09,2호선,사당,35273,38521,73794,3
2021-03-09,2호선,신림,61444,59862,121306,3
2021-03-09,2호선,구로디지털단지,62113,62839,124952,3
2021-03-09,2호선,홍대입구,45469,47338,92807,3
2021-03-09,3호선,고속터미널,34564,32944,67508,3
2021-03-09,4호선,서울역,10554,13924,24478,3
2021-03-09,4호선,사당,23923,19872,43795,3
2021-03-09,7호선,고속터미널,14176,12570,26746,3
2021-03-09,7호선,가산디지털단지,48402,48711,97113,3
2021-03-09,8호선,잠실(송파구청),12743,14681,27424,3
2021-03-09,9호선,고속터미널,10799,13405,24204,3
2021-03-09,경부선,서울역,3875,1389,5264,3
2021-03-09,경부선,가산디지털단지,18110,21204,39314,3
2021-03-09,경의선,서울역,4081,5367,9448,3
2021-03-09,경의선,홍대입구,1478,1596,3074,3
2021-03-09,공항철도 1호선,서울역,6119,5572,11691,3
2021-03-09,공항철도 1호선,홍대입구,7590,7775,15365,3
2021-03-09,분당선,선릉,13722,20577,34299,3
2021-03-10,1호선,서울역,39255,36809,76064,3
2021-03-10,2호선,잠실(송파구청),62491,62272,124763,3
2021-03-10,2호선,선릉,57369,51201,108570,3
2021-03-10,2호선,강남,83309,81805,165114,3
2021-03-10,2호선,사당,36111,39341,75452,3
2021-03-10,2호선,신림,62173,60718,122891,3
2021-03-10,2호선,구로디지털단지,62716,62985,125701,3
2021-03-10,2호선,홍대입구,47149,49320,96469,3
2021-03-10,3호선,고속터미널,35355,33785,69140,3
2021-03-10,4호선,서울역,10612,13907,24519,3
2021-03-10,4호선,사당,23991,20279,44270,3
2021-03-10,7호선,고속터미널,14087,12518,26605,3
2021-03-10,7호선,가산디지털단지,48087,48783,96870,3
2021-03-10,8호선,잠실(송파구청),12928,15023,27951,3
2021-03-10,9호선,고속터미널,11075,13637,24712,3
2021-03-10,경부선,서울역,4128,1316,5444,3
2021-03-10,경부선,가산디지털단지,18423,21155,39578,3
2021-03-10,경의선,서울역,4150,5334,9484,3
2021-03-10,경의선,홍대입구,1510,1700,3210,3
2021-03-10,공항철도 1호선,서울역,6151,5489,11640,3
2021-03-10,공항철도 1호선,홍대입구,8082,7871,15953,3
2021-03-10,분당선,선릉,13819,20360,34179,3
2021-03-11,1호선,서울역,40184,37250,77434,3
2021-03-11,2호선,잠실(송파구청),62684,61959,124643,3
2021-03-11,2호선,선릉,56811,51116,107927,3
2021-03-11,2호선,강남,82733,81555,164288,3
2021-03-11,2호선,사당,35856,38942,74798,3
2021-03-11,2호선,신림,61849,60209,122058,3
2021-03-11,2호선,구로디지털단지,62212,62391,124603,3
2021-03-11,2호선,홍대입구,47357,49197,96554,3
2021-03-11,3호선,고속터미널,35794,34588,70382,3
2021-03-11,4호선,서울역,10511,14137,24648,3
2021-03-11,4호선,사당,23979,20313,44292,3
2021-03-11,7호선,고속터미널,14422,12601,27023,3
2021-03-11,7호선,가산디지털단지,47903,48525,96428,3
2021-03-11,8호선,잠실(송파구청),12991,14897,27888,3
2021-03-11,9호선,고속터미널,11114,13682,24796,3
2021-03-11,경부선,서울역,4364,1328,5692,3
2021-03-11,경부선,가산디지털단지,18372,21425,39797,3
2021-03-11,경의선,서울역,4113,5326,9439,3
2021-03-11,경의선,홍대입구,1447,1621,3068,3
2021-03-11,공항철도 1호선,서울역,6504,5894,12398,3
2021-03-11,공항철도 1호선,홍대입구,8159,8113,16272,3
2021-03-11,분당선,선릉,13953,20507,34460,3
2021-03-12,1호선,서울역,44072,42114,86186,3
2021-03-12,2호선,잠실(송파구청),66191,65893,132084,3
2021-03-12,2호선,선릉,56797,50999,107796,3
2021-03-12,2호선,강남,88373,87425,175798,3
2021-03-12,2호선,사당,38060,41376,79436,3
2021-03-12,2호선,신림,63728,61843,125571,3
2021-03-12,2호선,구로디지털단지,62467,62291,124758,3
2021-03-12,2호선,홍대입구,52695,56863,109558,3
2021-03-12,3호선,고속터미널,42444,44819,87263,3
2021-03-12,4호선,서울역,10914,16167,27081,3
2021-03-12,4호선,사당,25410,21386,46796,3
2021-03-12,7호선,고속터미널,16938,13866,30804,3
2021-03-12,7호선,가산디지털단지,47595,47357,94952,3
2021-03-12,8호선,잠실(송파구청),13886,16126,30012,3
2021-03-12,9호선,고속터미널,12406,16812,29218,3
2021-03-12,경부선,서울역,6033,2034,8067,3
2021-03-12,경부선,가산디지털단지,18228,21239,39467,3
2021-03-12,경의선,서울역,4213,5406,9619,3
2021-03-12,경의선,홍대입구,1665,1938,3603,3
2021-03-12,공항철도 1호선,서울역,8138,7449,15587,3
2021-03-12,공항철도 1호선,홍대입구,9287,9412,18699,3
2021-03-12,분당선,선릉,13719,20256,33975,3
2021-03-13,1호선,서울역,25323,25416,50739,3
2021-03-13,2호선,잠실(송파구청),57842,54807,112649,3
2021-03-13,2호선,선릉,23357,20937,44294,3
2021-03-13,2호선,강남,59848,59603,119451,3
2021-03-13,2호선,사당,28554,31504,60058,3
2021-03-13,2호선,신림,49382,46983,96365,3
2021-03-13,2호선,구로디지털단지,33358,33282,66640,3
2021-03-13,2호선,홍대입구,59481,64133,123614,3
2021-03-13,3호선,고속터미널,45132,45280,90412,3
2021-03-13,4호선,서울역,4906,9748,14654,3
2021-03-13,4호선,사당,19090,16636,35726,3
2021-03-13,7호선,고속터미널,12568,10210,22778,3
2021-03-13,7호선,가산디지털단지,14992,13842,28834,3
2021-03-13,8호선,잠실(송파구청),11858,13420,25278,3
2021-03-13,9호선,고속터미널,11426,16251,27677,3
2021-03-13,경부선,서울역,4466,1317,5783,3
2021-03-13,경부선,가산디지털단지,5846,7905,13751,3
2021-03-13,경의선,서울역,1136,1306,2442,3
2021-03-13,경의선,홍대입구,1879,2058,3937,3
2021-03-13,공항철도 1호선,서울역,5985,5937,11922,3
2021-03-13,공항철도 1호선,홍대입구,10967,10486,21453,3
2021-03-13,분당선,선릉,5122,7784,12906,3
2021-03-14,경의선,서울역,836,811,1647,3
2021-03-14,경부선,가산디지털단지,4332,6190,10522,3
2021-03-14,경부선,서울역,5061,1108,6169,3
2021-03-14,9호선,고속터미널,9066,12475,21541,3
2021-03-14,8호선,잠실(송파구청),8579,9468,18047,3
2021-03-14,7호선,가산디지털단지,10600,9961,20561,3
2021-03-14,7호선,고속터미널,10770,7319,18089,3
2021-03-14,4호선,사당,13072,12183,25255,3
2021-03-14,4호선,서울역,3626,7149,10775,3
2021-03-14,3호선,고속터미널,36561,34745,71306,3
2021-03-14,분당선,선릉,2652,3934,6586,3
2021-03-14,공항철도 1호선,홍대입구,8610,7795,16405,3
2021-03-14,공항철도 1호선,서울역,5772,5345,11117,3
2021-03-14,1호선,서울역,21400,19108,40508,3
2021-03-14,2호선,홍대입구,43930,43360,87290,3
2021-03-14,경의선,홍대입구,1505,1688,3193,3
2021-03-14,2호선,구로디지털단지,22322,22004,44326,3
2021-03-14,2호선,신림,34807,34430,69237,3
2021-03-14,2호선,사당,19066,21489,40555,3
2021-03-14,2호선,강남,33791,32573,66364,3
2021-03-14,2호선,선릉,12274,10751,23025,3
2021-03-14,2호선,잠실(송파구청),40886,37801,78687,3
2021-03-15,2호선,사당,33524,37197,70721,3
2021-03-15,2호선,강남,81488,80158,161646,3
2021-03-15,2호선,선릉,56136,50418,106554,3
2021-03-15,2호선,잠실(송파구청),60019,59968,119987,3
2021-03-15,1호선,서울역,39870,37210,77080,3
2021-03-15,2호선,신림,60315,58729,119044,3
2021-03-15,2호선,구로디지털단지,61767,61982,123749,3
2021-03-15,2호선,홍대입구,44449,46531,90980,3
2021-03-15,3호선,고속터미널,31481,28942,60423,3
2021-03-15,4호선,서울역,10650,13987,24637,3
2021-03-15,4호선,사당,22944,19324,42268,3
2021-03-15,7호선,고속터미널,14737,12357,27094,3
2021-03-15,7호선,가산디지털단지,47815,48037,95852,3
2021-03-15,8호선,잠실(송파구청),12505,14576,27081,3
2021-03-15,9호선,고속터미널,10292,12987,23279,3
2021-03-15,경부선,서울역,4800,1516,6316,3
2021-03-15,경부선,가산디지털단지,18141,21213,39354,3
2021-03-15,경의선,서울역,4262,5387,9649,3
2021-03-15,경의선,홍대입구,1438,1599,3037,3
2021-03-15,공항철도 1호선,서울역,6278,5984,12262,3
2021-03-15,공항철도 1호선,홍대입구,7501,7521,15022,3
2021-03-15,분당선,선릉,13691,20081,33772,3
2021-03-16,경의선,서울역,4145,5285,9430,3
2021-03-16,경의선,홍대입구,1403,1612,3015,3
2021-03-16,공항철도 1호선,서울역,5939,5617,11556,3
2021-03-16,공항철도 1호선,홍대입구,7686,7722,15408,3
2021-03-16,분당선,선릉,13654,20435,34089,3
2021-03-16,1호선,서울역,39227,37069,76296,3
2021-03-16,2호선,잠실(송파구청),61353,60595,121948,3
2021-03-16,2호선,선릉,57424,51265,108689,3
2021-03-16,2호선,강남,83012,81696,164708,3
2021-03-16,2호선,사당,35199,38336,73535,3
2021-03-16,2호선,신림,61287,60072,121359,3
2021-03-16,2호선,구로디지털단지,62791,62972,125763,3
2021-03-16,2호선,홍대입구,45090,46846,91936,3
2021-03-16,3호선,고속터미널,35901,34184,70085,3
2021-03-16,4호선,서울역,10721,13976,24697,3
2021-03-16,4호선,사당,23562,19873,43435,3
2021-03-16,7호선,고속터미널,14416,12690,27106,3
2021-03-16,7호선,가산디지털단지,48278,48390,96668,3
2021-03-16,8호선,잠실(송파구청),12974,14816,27790,3
2021-03-16,9호선,고속터미널,10836,13452,24288,3
2021-03-16,경부선,서울역,4026,1371,5397,3
2021-03-16,경부선,가산디지털단지,18283,21309,39592,3
2021-03-17,경의선,서울역,4131,5383,9514,3
2021-03-17,경의선,홍대입구,1594,1673,3267,3
2021-03-17,1호선,서울역,39716,37292,77008,3
2021-03-17,2호선,잠실(송파구청),63335,62878,126213,3
2021-03-17,2호선,선릉,56944,51193,108137,3
2021-03-17,2호선,강남,84066,82461,166527,3
2021-03-17,2호선,사당,36218,39251,75469,3
2021-03-17,2호선,신림,61933,60611,122544,3
2021-03-17,2호선,구로디지털단지,62922,63109,126031,3
2021-03-17,2호선,홍대입구,47589,49776,97365,3
2021-03-17,3호선,고속터미널,36134,34763,70897,3
2021-03-17,4호선,서울역,10973,14322,25295,3
2021-03-17,4호선,사당,24105,20353,44458,3
2021-03-17,7호선,고속터미널,14313,12627,26940,3
2021-03-17,7호선,가산디지털단지,47851,48403,96254,3
2021-03-17,8호선,잠실(송파구청),12800,15019,27819,3
2021-03-17,9호선,고속터미널,11161,13824,24985,3
2021-03-17,경부선,서울역,4059,1443,5502,3
2021-03-17,경부선,가산디지털단지,18504,21328,39832,3
2021-03-17,공항철도 1호선,서울역,6188,5746,11934,3
2021-03-17,공항철도 1호선,홍대입구,8039,8084,16123,3
2021-03-17,분당선,선릉,13768,20344,34112,3
2021-03-18,4호선,사당,24281,20608,44889,3
2021-03-18,4호선,서울역,10688,14523,25211,3
2021-03-18,3호선,고속터미널,37095,35383,72478,3
2021-03-18,2호선,홍대입구,47569,49923,97492,3
2021-03-18,2호선,구로디지털단지,62707,62825,125532,3
2021-03-18,2호선,신림,62252,60259,122511,3
2021-03-18,2호선,사당,36509,39764,76273,3
2021-03-18,2호선,강남,83454,82493,165947,3
2021-03-18,2호선,선릉,57161,51581,108742,3
2021-03-18,2호선,잠실(송파구청),63751,63381,127132,3
2021-03-18,1호선,서울역,41475,38755,80230,3
2021-03-18,분당선,선릉,13765,20313,34078,3
2021-03-18,공항철도 1호선,홍대입구,8273,8234,16507,3
2021-03-18,공항철도 1호선,서울역,6797,6175,12972,3
2021-03-18,경의선,홍대입구,1506,1688,3194,3
2021-03-18,경의선,서울역,4319,5432,9751,3
2021-03-18,경부선,가산디지털단지,18576,21644,40220,3
2021-03-18,경부선,서울역,4601,1453,6054,3
2021-03-18,9호선,고속터미널,11353,14172,25525,3
2021-03-18,8호선,잠실(송파구청),13148,15313,28461,3
2021-03-18,7호선,가산디지털단지,47823,48369,96192,3
2021-03-18,7호선,고속터미널,14692,12755,27447,3
2021-03-19,1호선,서울역,45184,44029,89213,3
2021-03-19,2호선,잠실(송파구청),69316,68844,138160,3
2021-03-19,2호선,선릉,57215,51345,108560,3
2021-03-19,2호선,강남,90065,90321,180386,3
2021-03-19,2호선,사당,38771,42427,81198,3
2021-03-19,2호선,신림,64876,62705,127581,3
2021-03-19,2호선,구로디지털단지,64301,64083,128384,3
2021-03-19,2호선,홍대입구,54713,59655,114368,3
2021-03-19,3호선,고속터미널,44452,46649,91101,3
2021-03-19,4호선,서울역,10750,16361,27111,3
2021-03-19,4호선,사당,26214,21805,48019,3
2021-03-19,7호선,고속터미널,17043,14132,31175,3
2021-03-19,7호선,가산디지털단지,47413,47447,94860,3
2021-03-19,8호선,잠실(송파구청),13962,16453,30415,3
2021-03-19,9호선,고속터미널,13337,17613,30950,3
2021-03-19,경부선,서울역,6454,2070,8524,3
2021-03-19,경부선,가산디지털단지,18503,21495,39998,3
2021-03-19,경의선,서울역,4261,5626,9887,3
2021-03-19,경의선,홍대입구,1803,1949,3752,3
2021-03-19,공항철도 1호선,서울역,8220,7883,16103,3
2021-03-19,공항철도 1호선,홍대입구,10008,10069,20077,3
2021-03-19,분당선,선릉,13724,20497,34221,3
2021-03-20,경의선,홍대입구,1663,1776,3439,3
2021-03-20,경의선,서울역,1051,1196,2247,3
2021-03-20,분당선,선릉,4634,7207,11841,3
2021-03-20,공항철도 1호선,홍대입구,9816,9950,19766,3
2021-03-20,공항철도 1호선,서울역,5721,5725,11446,3
2021-03-20,1호선,서울역,24995,24978,49973,3
2021-03-20,2호선,잠실(송파구청),54613,52258,106871,3
2021-03-20,2호선,선릉,22128,19827,41955,3
2021-03-20,2호선,강남,59408,58252,117660,3
2021-03-20,2호선,사당,26370,28941,55311,3
2021-03-20,2호선,신림,45755,42805,88560,3
2021-03-20,2호선,구로디지털단지,31924,31765,63689,3
2021-03-20,2호선,홍대입구,53907,58015,111922,3
2021-03-20,3호선,고속터미널,43498,43569,87067,3
2021-03-20,4호선,서울역,4585,9501,14086,3
2021-03-20,4호선,사당,17782,15228,33010,3
2021-03-20,7호선,고속터미널,12287,9563,21850,3
2021-03-20,7호선,가산디지털단지,13763,12694,26457,3
2021-03-20,8호선,잠실(송파구청),11232,12933,24165,3
2021-03-20,9호선,고속터미널,10339,15133,25472,3
2021-03-20,경부선,서울역,4549,1396,5945,3
2021-03-20,경부선,가산디지털단지,5502,7474,12976,3
2021-03-21,1호선,서울역,22852,20681,43533,3
2021-03-21,2호선,잠실(송파구청),42409,39373,81782,3
2021-03-21,2호선,선릉,12219,10869,23088,3
2021-03-21,2호선,강남,34376,33107,67483,3
2021-03-21,2호선,사당,20072,22047,42119,3
2021-03-21,2호선,신림,34889,34177,69066,3
2021-03-21,2호선,구로디지털단지,22863,22496,45359,3
2021-03-21,2호선,홍대입구,45513,44339,89852,3
2021-03-21,3호선,고속터미널,37132,34791,71923,3
2021-03-21,4호선,서울역,3670,7701,11371,3
2021-03-21,4호선,사당,13405,12731,26136,3
2021-03-21,7호선,고속터미널,11170,7381,18551,3
2021-03-21,7호선,가산디지털단지,10586,9807,20393,3
2021-03-21,8호선,잠실(송파구청),9107,9950,19057,3
2021-03-21,9호선,고속터미널,8751,12145,20896,3
2021-03-21,경부선,서울역,5506,1207,6713,3
2021-03-21,경부선,가산디지털단지,4192,5919,10111,3
2021-03-21,경의선,서울역,937,932,1869,3
2021-03-21,경의선,홍대입구,1336,1648,2984,3
2021-03-21,공항철도 1호선,서울역,6058,5414,11472,3
2021-03-21,공항철도 1호선,홍대입구,8268,7749,16017,3
2021-03-21,분당선,선릉,2747,4049,6796,3
2021-03-22,1호선,서울역,40305,37285,77590,3
2021-03-22,2호선,잠실(송파구청),59551,59294,118845,3
2021-03-22,2호선,선릉,55922,50523,106445,3
2021-03-22,2호선,강남,80530,79585,160115,3
2021-03-22,2호선,사당,33734,37422,71156,3
2021-03-22,2호선,신림,60437,58860,119297,3
2021-03-22,2호선,구로디지털단지,61890,62305,124195,3
2021-03-22,2호선,홍대입구,44230,46188,90418,3
2021-03-22,3호선,고속터미널,36198,33989,70187,3
2021-03-22,4호선,서울역,10617,14005,24622,3
2021-03-22,4호선,사당,23105,19350,42455,3
2021-03-22,7호선,고속터미널,14987,12620,27607,3
2021-03-22,7호선,가산디지털단지,47851,48068,95919,3
2021-03-22,8호선,잠실(송파구청),12555,14323,26878,3
2021-03-22,9호선,고속터미널,10796,13509,24305,3
2021-03-22,경부선,서울역,4940,1471,6411,3
2021-03-22,경부선,가산디지털단지,18251,21196,39447,3
2021-03-22,경의선,서울역,4174,5395,9569,3
2021-03-22,경의선,홍대입구,1392,1562,2954,3
2021-03-22,공항철도 1호선,서울역,6172,6030,12202,3
2021-03-22,공항철도 1호선,홍대입구,7677,7497,15174,3
2021-03-22,분당선,선릉,13515,19949,33464,3
2021-03-23,분당선,선릉,13781,20420,34201,3
2021-03-23,공항철도 1호선,홍대입구,8118,8023,16141,3
2021-03-23,공항철도 1호선,서울역,6279,5755,12034,3
2021-03-23,경의선,홍대입구,1515,1626,3141,3
2021-03-23,경의선,서울역,4189,5490,9679,3
2021-03-23,경부선,가산디지털단지,18378,21426,39804,3
2021-03-23,경부선,서울역,4201,1429,5630,3
2021-03-23,9호선,고속터미널,10927,13556,24483,3
2021-03-23,8호선,잠실(송파구청),13077,14980,28057,3
2021-03-23,7호선,가산디지털단지,48359,48694,97053,3
2021-03-23,7호선,고속터미널,14417,12752,27169,3
2021-03-23,4호선,사당,24156,20438,44594,3
2021-03-23,4호선,서울역,10854,14370,25224,3
2021-03-23,3호선,고속터미널,35871,33899,69770,3
2021-03-23,2호선,잠실(송파구청),62691,62040,124731,3
2021-03-23,1호선,서울역,40034,37504,77538,3
2021-03-23,2호선,홍대입구,46279,48273,94552,3
2021-03-23,2호선,구로디지털단지,62927,63450,126377,3
2021-03-23,2호선,신림,61814,60450,122264,3
2021-03-23,2호선,사당,36034,39391,75425,3
2021-03-23,2호선,강남,82222,81004,163226,3
2021-03-23,2호선,선릉,57286,51150,108436,3
2021-03-24,공항철도 1호선,홍대입구,8058,8216,16274,3
2021-03-24,공항철도 1호선,서울역,6355,5762,12117,3
2021-03-24,경의선,홍대입구,1459,1674,3133,3
2021-03-24,경의선,서울역,4161,5476,9637,3
2021-03-24,경부선,가산디지털단지,18545,21369,39914,3
2021-03-24,경부선,서울역,4265,1498,5763,3
2021-03-24,9호선,고속터미널,11125,13870,24995,3
2021-03-24,4호선,사당,24395,20404,44799,3
2021-03-24,4호선,서울역,10907,14272,25179,3
2021-03-24,3호선,고속터미널,35850,34188,70038,3
2021-03-24,2호선,홍대입구,46986,49086,96072,3
2021-03-24,2호선,구로디지털단지,63164,63735,126899,3
2021-03-24,2호선,신림,62312,60465,122777,3
2021-03-24,2호선,사당,36080,39302,75382,3
2021-03-24,2호선,강남,82239,81082,163321,3
2021-03-24,2호선,선릉,56930,51213,108143,3
2021-03-24,2호선,잠실(송파구청),63634,63131,126765,3
2021-03-24,1호선,서울역,40385,38022,78407,3
2021-03-24,7호선,고속터미널,14312,12613,26925,3
2021-03-24,분당선,선릉,13761,20231,33992,3
2021-03-24,7호선,가산디지털단지,47879,48278,96157,3
2021-03-24,8호선,잠실(송파구청),13035,15027,28062,3
2021-03-25,2호선,홍대입구,48634,50712,99346,3
2021-03-25,2호선,구로디지털단지,63380,63683,127063,3
2021-03-25,2호선,신림,62574,60783,123357,3
2021-03-25,분당선,선릉,13671,20587,34258,3
2021-03-25,공항철도 1호선,홍대입구,8438,8430,16868,3
2021-03-25,공항철도 1호선,서울역,6779,6221,13000,3
2021-03-25,경의선,홍대입구,1569,1821,3390,3
2021-03-25,경의선,서울역,4208,5402,9610,3
2021-03-25,2호선,사당,36803,40189,76992,3
2021-03-25,경부선,가산디지털단지,18624,21629,40253,3
2021-03-25,경부선,서울역,4632,1471,6103,3
2021-03-25,9호선,고속터미널,11593,14645,26238,3
2021-03-25,8호선,잠실(송파구청),13268,15152,28420,3
2021-03-25,7호선,가산디지털단지,48002,48459,96461,3
2021-03-25,7호선,고속터미널,15072,12917,27989,3
2021-03-25,4호선,사당,24551,20635,45186,3
2021-03-25,4호선,서울역,11102,15028,26130,3
2021-03-25,3호선,고속터미널,37130,36059,73189,3
2021-03-25,1호선,서울역,41632,39415,81047,3
2021-03-25,2호선,잠실(송파구청),64533,63880,128413,3
2021-03-25,2호선,선릉,57646,51722,109368,3
2021-03-25,2호선,강남,82861,81889,164750,3
2021-03-26,분당선,선릉,13617,20520,34137,3
2021-03-26,공항철도 1호선,홍대입구,9862,9864,19726,3
2021-03-26,공항철도 1호선,서울역,8406,8254,16660,3
2021-03-26,경의선,홍대입구,1875,2014,3889,3
2021-03-26,경의선,서울역,4392,5740,10132,3
2021-03-26,경부선,가산디지털단지,18847,21642,40489,3
2021-03-26,경부선,서울역,6704,2200,8904,3
2021-03-26,9호선,고속터미널,13315,18122,31437,3
2021-03-26,8호선,잠실(송파구청),14338,16778,31116,3
2021-03-26,7호선,가산디지털단지,47918,47608,95526,3
2021-03-26,7호선,고속터미널,17486,14640,32126,3
2021-03-26,4호선,사당,26211,22078,48289,3
2021-03-26,4호선,서울역,11323,17419,28742,3
2021-03-26,3호선,고속터미널,44929,47212,92141,3
2021-03-26,2호선,홍대입구,55181,59604,114785,3
2021-03-26,2호선,구로디지털단지,64011,63753,127764,3
2021-03-26,2호선,신림,64460,62134,126594,3
2021-03-26,2호선,사당,38874,42657,81531,3
2021-03-26,2호선,강남,89747,89547,179294,3
2021-03-26,2호선,선릉,57339,51285,108624,3
2021-03-26,2호선,잠실(송파구청),69977,69502,139479,3
2021-03-26,1호선,서울역,46290,45215,91505,3
2021-03-27,공항철도 1호선,홍대입구,8860,8712,17572,3
2021-03-27,공항철도 1호선,서울역,5833,7061,12894,3
2021-03-27,분당선,선릉,4991,7445,12436,3
2021-03-27,경의선,홍대입구,1442,1746,3188,3
2021-03-27,경의선,서울역,1082,1176,2258,3
2021-03-27,경부선,가산디지털단지,5227,7218,12445,3
2021-03-27,경부선,서울역,5016,1536,6552,3
2021-03-27,9호선,고속터미널,10571,15353,25924,3
2021-03-27,8호선,잠실(송파구청),12369,13811,26180,3
2021-03-27,7호선,가산디지털단지,13775,12624,26399,3
2021-03-27,7호선,고속터미널,12348,9881,22229,3
2021-03-27,1호선,서울역,25680,26331,52011,3
2021-03-27,2호선,잠실(송파구청),54645,52199,106844,3
2021-03-27,2호선,선릉,22528,20323,42851,3
2021-03-27,2호선,강남,58994,57950,116944,3
2021-03-27,2호선,사당,26439,28947,55386,3
2021-03-27,2호선,신림,45280,43400,88680,3
2021-03-27,2호선,구로디지털단지,31733,31574,63307,3
2021-03-27,2호선,홍대입구,51026,53740,104766,3
2021-03-27,3호선,고속터미널,44464,44664,89128,3
2021-03-27,4호선,서울역,4752,10188,14940,3
2021-03-27,4호선,사당,18154,15611,33765,3
2021-03-28,경의선,서울역,857,729,1586,3
2021-03-28,경부선,가산디지털단지,4022,5520,9542,3
2021-03-28,경부선,서울역,5864,1253,7117,3
2021-03-28,9호선,고속터미널,8641,11746,20387,3
2021-03-28,8호선,잠실(송파구청),8781,9586,18367,3
2021-03-28,7호선,가산디지털단지,9754,9103,18857,3
2021-03-28,7호선,고속터미널,10736,7150,17886,3
2021-03-28,4호선,사당,12172,11371,23543,3
2021-03-28,4호선,서울역,3470,7220,10690,3
2021-03-28,3호선,고속터미널,35179,32826,68005,3
2021-03-28,2호선,홍대입구,38782,38277,77059,3
2021-03-28,2호선,구로디지털단지,21255,20845,42100,3
2021-03-28,2호선,신림,32292,31927,64219,3
2021-03-28,2호선,사당,17831,19643,37474,3
2021-03-28,2호선,강남,32904,31774,64678,3
2021-03-28,2호선,선릉,11854,10364,22218,3
2021-03-28,2호선,잠실(송파구청),39448,36770,76218,3
2021-03-28,1호선,서울역,22213,18710,40923,3
2021-03-28,분당선,선릉,2594,3872,6466,3
2021-03-28,공항철도 1호선,홍대입구,7323,6745,14068,3
2021-03-28,공항철도 1호선,서울역,5952,5208,11160,3
2021-03-28,경의선,홍대입구,1271,1461,2732,3
2021-03-29,분당선,선릉,13450,20223,33673,3
2021-03-29,공항철도 1호선,홍대입구,7542,7464,15006,3
2021-03-29,공항철도 1호선,서울역,6392,6114,12506,3
2021-03-29,경의선,홍대입구,1426,1641,3067,3
2021-03-29,경의선,서울역,4252,5325,9577,3
2021-03-29,경부선,가산디지털단지,18420,21509,39929,3
2021-03-29,경부선,서울역,5033,1550,6583,3
2021-03-29,9호선,고속터미널,10655,13354,24009,3
2021-03-29,8호선,잠실(송파구청),12940,15134,28074,3
2021-03-29,7호선,가산디지털단지,47845,48187,96032,3
2021-03-29,7호선,고속터미널,14893,12603,27496,3
2021-03-29,4호선,사당,23189,19220,42409,3
2021-03-29,4호선,서울역,10792,14061,24853,3
2021-03-29,3호선,고속터미널,35566,33555,69121,3
2021-03-29,2호선,홍대입구,43815,45292,89107,3
2021-03-29,2호선,구로디지털단지,62055,62481,124536,3
2021-03-29,2호선,신림,60718,59101,119819,3
2021-03-29,2호선,사당,33419,37111,70530,3
2021-03-29,2호선,강남,80241,79150,159391,3
2021-03-29,2호선,선릉,56489,50941,107430,3
2021-03-29,2호선,잠실(송파구청),61833,61470,123303,3
2021-03-29,1호선,서울역,40194,37825,78019,3
2021-03-30,공항철도 1호선,서울역,6227,5742,11969,3
2021-03-30,1호선,서울역,39617,37216,76833,3
2021-03-30,2호선,잠실(송파구청),67626,67175,134801,3
2021-03-30,2호선,선릉,57238,51812,109050,3
2021-03-30,2호선,강남,81959,80570,162529,3
2021-03-30,2호선,사당,35753,38821,74574,3
2021-03-30,2호선,신림,61916,60091,122007,3
2021-03-30,2호선,구로디지털단지,63001,63160,126161,3
2021-03-30,2호선,홍대입구,46062,47571,93633,3
2021-03-30,3호선,고속터미널,35577,33702,69279,3
2021-03-30,4호선,서울역,10954,14234,25188,3
2021-03-30,4호선,사당,24123,20357,44480,3
2021-03-30,7호선,고속터미널,14403,13007,27410,3
2021-03-30,7호선,가산디지털단지,48485,49051,97536,3
2021-03-30,8호선,잠실(송파구청),14100,16152,30252,3
2021-03-30,9호선,고속터미널,11004,13759,24763,3
2021-03-30,경부선,서울역,4201,1411,5612,3
2021-03-30,경부선,가산디지털단지,18596,21709,40305,3
2021-03-30,경의선,서울역,4264,5355,9619,3
2021-03-30,경의선,홍대입구,1586,1722,3308,3
2021-03-30,분당선,선릉,13741,20280,34021,3
2021-03-30,공항철도 1호선,홍대입구,8016,7984,16000,3
2021-03-31,1호선,서울역,40187,37994,78181,3
2021-03-31,2호선,잠실(송파구청),73859,73978,147837,3
2021-03-31,2호선,선릉,57087,51602,108689,3
2021-03-31,2호선,강남,81772,80539,162311,3
2021-03-31,2호선,사당,36284,39685,75969,3
2021-03-31,2호선,신림,62867,60661,123528,3
2021-03-31,2호선,구로디지털단지,63340,63341,126681,3
2021-03-31,2호선,홍대입구,47796,49794,97590,3
2021-03-31,3호선,고속터미널,36384,34881,71265,3
2021-03-31,4호선,서울역,11035,14487,25522,3
2021-03-31,4호선,사당,24522,20355,44877,3
2021-03-31,7호선,고속터미널,14611,13022,27633,3
2021-03-31,7호선,가산디지털단지,48115,48908,97023,3
2021-03-31,8호선,잠실(송파구청),15268,17718,32986,3
2021-03-31,9호선,고속터미널,11634,14159,25793,3
2021-03-31,경부선,서울역,4244,1349,5593,3
2021-03-31,경부선,가산디지털단지,18598,21417,40015,3
2021-03-31,경의선,서울역,4209,5383,9592,3
2021-03-31,경의선,홍대입구,1566,1807,3373,3
2021-03-31,공항철도 1호선,서울역,6323,5741,12064,3
2021-03-31,공항철도 1호선,홍대입구,8417,8536,16953,3
2021-03-31,분당선,선릉,13635,20270,33905,3
2021-04-01,분당선,선릉,13645,20147,33792,4
2021-04-01,공항철도 1호선,홍대입구,8974,8905,17879,4
2021-04-01,공항철도 1호선,서울역,6705,6216,12921,4
2021-04-01,1호선,서울역,41201,38888,80089,4
2021-04-01,8호선,잠실(송파구청),13362,15579,28941,4
2021-04-01,7호선,가산디지털단지,47745,48594,96339,4
2021-04-01,7호선,고속터미널,14629,12845,27474,4
2021-04-01,4호선,사당,24331,20229,44560,4
2021-04-01,4호선,서울역,11173,14866,26039,4
2021-04-01,3호선,고속터미널,37060,35823,72883,4
2021-04-01,경의선,홍대입구,1637,1772,3409,4
2021-04-01,경의선,서울역,4182,5461,9643,4
2021-04-01,경부선,가산디지털단지,18464,21614,40078,4
2021-04-01,경부선,서울역,4498,1525,6023,4
2021-04-01,9호선,고속터미널,11594,14322,25916,4
2021-04-01,2호선,잠실(송파구청),65893,65267,131160,4
2021-04-01,2호선,선릉,55920,50233,106153,4
2021-04-01,2호선,강남,82104,80714,162818,4
2021-04-01,2호선,사당,36371,39769,76140,4
2021-04-01,2호선,신림,62308,60029,122337,4
2021-04-01,2호선,구로디지털단지,62882,63151,126033,4
2021-04-01,2호선,홍대입구,48622,50877,99499,4
2021-04-02,분당선,선릉,13355,19713,33068,4
2021-04-02,공항철도 1호선,홍대입구,10087,9949,20036,4
2021-04-02,공항철도 1호선,서울역,8187,7905,16092,4
2021-04-02,경의선,홍대입구,1760,1973,3733,4
2021-04-02,경의선,서울역,4552,5521,10073,4
2021-04-02,경부선,가산디지털단지,18789,21678,40467,4
2021-04-02,경부선,서울역,6268,2128,8396,4
2021-04-02,9호선,고속터미널,13229,17706,30935,4
2021-04-02,8호선,잠실(송파구청),14363,16554,30917,4
2021-04-02,7호선,가산디지털단지,48346,47786,96132,4
2021-04-02,7호선,고속터미널,17057,14335,31392,4
2021-04-02,4호선,사당,26425,22027,48452,4
2021-04-02,4호선,서울역,11122,17070,28192,4
2021-04-02,3호선,고속터미널,44426,46753,91179,4
2021-04-02,2호선,홍대입구,54379,58913,113292,4
2021-04-02,2호선,구로디지털단지,63720,63423,127143,4
2021-04-02,2호선,신림,64584,61983,126567,4
2021-04-02,2호선,사당,38339,41835,80174,4
2021-04-02,2호선,강남,87966,87694,175660,4
2021-04-02,2호선,선릉,54841,49083,103924,4
2021-04-02,2호선,잠실(송파구청),70414,69576,139990,4
2021-04-02,1호선,서울역,45734,44788,90522,4
2021-04-03,2호선,강남,53882,53109,106991,4
2021-04-03,2호선,선릉,20764,18606,39370,4
2021-04-03,분당선,선릉,4551,6900,11451,4
2021-04-03,공항철도 1호선,홍대입구,8283,8082,16365,4
2021-04-03,공항철도 1호선,서울역,5636,5805,11441,4
2021-04-03,3호선,고속터미널,42696,42705,85401,4
2021-04-03,경의선,홍대입구,1236,1541,2777,4
2021-04-03,경의선,서울역,887,1086,1973,4
2021-04-03,4호선,서울역,4199,9203,13402,4
2021-04-03,4호선,사당,16584,14114,30698,4
2021-04-03,1호선,서울역,24119,23971,48090,4
2021-04-03,7호선,고속터미널,11820,9412,21232,4
2021-04-03,7호선,가산디지털단지,12478,11204,23682,4
2021-04-03,8호선,잠실(송파구청),11807,13595,25402,4
2021-04-03,9호선,고속터미널,9810,14377,24187,4
2021-04-03,경부선,서울역,4780,1503,6283,4
2021-04-03,경부선,가산디지털단지,4798,6669,11467,4
2021-04-03,2호선,잠실(송파구청),51663,49800,101463,4
2021-04-03,2호선,홍대입구,45310,47709,93019,4
2021-04-03,2호선,구로디지털단지,28844,28847,57691,4
2021-04-03,2호선,신림,41559,40081,81640,4
2021-04-03,2호선,사당,24081,26316,50397,4
2021-04-04,분당선,선릉,2605,3803,6408,4
2021-04-04,공항철도 1호선,홍대입구,8378,7548,15926,4
2021-04-04,공항철도 1호선,서울역,5999,5276,11275,4
2021-04-04,경부선,서울역,5588,1176,6764,4
2021-04-04,경부선,가산디지털단지,4450,6152,10602,4
2021-04-04,경의선,서울역,934,873,1807,4
2021-04-04,경의선,홍대입구,1413,1638,3051,4
2021-04-04,1호선,서울역,23042,20211,43253,4
2021-04-04,2호선,잠실(송파구청),42672,39566,82238,4
2021-04-04,2호선,선릉,11447,10088,21535,4
2021-04-04,2호선,강남,31950,31095,63045,4
2021-04-04,2호선,사당,18647,20667,39314,4
2021-04-04,2호선,신림,33981,33471,67452,4
2021-04-04,2호선,구로디지털단지,22197,21999,44196,4
2021-04-04,2호선,홍대입구,42167,41757,83924,4
2021-04-04,3호선,고속터미널,36416,33645,70061,4
2021-04-04,4호선,서울역,3690,7334,11024,4
2021-04-04,4호선,사당,13217,12287,25504,4
2021-04-04,7호선,고속터미널,10892,7023,17915,4
2021-04-04,7호선,가산디지털단지,10793,9878,20671,4
2021-04-04,8호선,잠실(송파구청),9408,10098,19506,4
2021-04-04,9호선,고속터미널,9115,12014,21129,4
2021-04-05,4호선,사당,23697,19959,43656,4
2021-04-05,3호선,고속터미널,36439,34498,70937,4
2021-04-05,4호선,서울역,10700,14194,24894,4
2021-04-05,1호선,서울역,40877,37981,78858,4
2021-04-05,경의선,서울역,4231,5427,9658,4
2021-04-05,경의선,홍대입구,1471,1618,3089,4
2021-04-05,경부선,가산디지털단지,18459,21632,40091,4
2021-04-05,경부선,서울역,4938,1484,6422,4
2021-04-05,9호선,고속터미널,11182,13759,24941,4
2021-04-05,7호선,고속터미널,15157,12680,27837,4
2021-04-05,7호선,가산디지털단지,48782,48975,97757,4
2021-04-05,8호선,잠실(송파구청),12841,14710,27551,4
2021-04-05,공항철도 1호선,홍대입구,7893,7838,15731,4
2021-04-05,공항철도 1호선,서울역,6409,5931,12340,4
2021-04-05,분당선,선릉,13418,19947,33365,4
2021-04-05,2호선,홍대입구,45405,46827,92232,4
2021-04-05,2호선,구로디지털단지,62296,62693,124989,4
2021-04-05,2호선,신림,61982,59950,121932,4
2021-04-05,2호선,사당,34399,38341,72740,4
2021-04-05,2호선,강남,81771,80369,162140,4
2021-04-05,2호선,선릉,56217,50252,106469,4
2021-04-05,2호선,잠실(송파구청),61384,61325,122709,4
2021-04-06,1호선,서울역,40131,38017,78148,4
2021-04-06,분당선,선릉,13583,20194,33777,4
2021-04-06,공항철도 1호선,홍대입구,8223,8247,16470,4
2021-04-06,공항철도 1호선,서울역,6245,5692,11937,4
2021-04-06,2호선,잠실(송파구청),63387,62675,126062,4
2021-04-06,2호선,선릉,57056,51218,108274,4
2021-04-06,2호선,강남,83390,81634,165024,4
2021-04-06,2호선,사당,35962,39868,75830,4
2021-04-06,2호선,신림,62427,60453,122880,4
2021-04-06,2호선,구로디지털단지,62962,63489,126451,4
2021-04-06,2호선,홍대입구,46664,48801,95465,4
2021-04-06,3호선,고속터미널,36429,34381,70810,4
2021-04-06,4호선,서울역,11174,14227,25401,4
2021-04-06,4호선,사당,24513,20289,44802,4
2021-04-06,경의선,홍대입구,1591,1680,3271,4
2021-04-06,경의선,서울역,4290,5361,9651,4
2021-04-06,경부선,가산디지털단지,18640,21890,40530,4
2021-04-06,경부선,서울역,4304,1407,5711,4
2021-04-06,9호선,고속터미널,11223,13929,25152,4
2021-04-06,8호선,잠실(송파구청),12898,14981,27879,4
2021-04-06,7호선,가산디지털단지,49081,49132,98213,4
2021-04-06,7호선,고속터미널,14748,12955,27703,4
2021-04-07,분당선,선릉,13295,19847,33142,4
2021-04-07,공항철도 1호선,홍대입구,8416,8315,16731,4
2021-04-07,공항철도 1호선,서울역,6379,5668,12047,4
2021-04-07,경의선,홍대입구,1579,1707,3286,4
2021-04-07,경의선,서울역,4326,5287,9613,4
2021-04-07,경부선,가산디지털단지,18605,21706,40311,4
2021-04-07,경부선,서울역,4112,1392,5504,4
2021-04-07,9호선,고속터미널,11464,14057,25521,4
2021-04-07,8호선,잠실(송파구청),12813,14953,27766,4
2021-04-07,7호선,가산디지털단지,48431,48634,97065,4
2021-04-07,7호선,고속터미널,14359,12553,26912,4
2021-04-07,4호선,사당,24264,20356,44620,4
2021-04-07,4호선,서울역,10984,14467,25451,4
2021-04-07,3호선,고속터미널,36230,34403,70633,4
2021-04-07,2호선,홍대입구,47732,49434,97166,4
2021-04-07,2호선,구로디지털단지,62302,62490,124792,4
2021-04-07,2호선,신림,62180,60505,122685,4
2021-04-07,2호선,사당,36222,39468,75690,4
2021-04-07,2호선,강남,82911,80823,163734,4
2021-04-07,2호선,선릉,55916,50100,106016,4
2021-04-07,2호선,잠실(송파구청),64291,63685,127976,4
2021-04-07,1호선,서울역,40190,37629,77819,4
2021-04-08,경부선,가산디지털단지,19027,21895,40922,4
2021-04-08,경부선,서울역,4451,1540,5991,4
2021-04-08,9호선,고속터미널,11576,14348,25924,4
2021-04-08,8호선,잠실(송파구청),13136,15192,28328,4
2021-04-08,7호선,가산디지털단지,48314,48867,97181,4
2021-04-08,7호선,고속터미널,14428,13018,27446,4
2021-04-08,4호선,사당,24113,20563,44676,4
2021-04-08,4호선,서울역,11040,14752,25792,4
2021-04-08,3호선,고속터미널,36619,34945,71564,4
2021-04-08,2호선,홍대입구,47669,49731,97400,4
2021-04-08,2호선,구로디지털단지,62801,62902,125703,4
2021-04-08,2호선,신림,62143,60316,122459,4
2021-04-08,2호선,사당,36522,39707,76229,4
2021-04-08,2호선,강남,82303,80708,163011,4
2021-04-08,2호선,선릉,56143,50351,106494,4
2021-04-08,2호선,잠실(송파구청),64347,63579,127926,4
2021-04-08,1호선,서울역,40529,38593,79122,4
2021-04-08,경의선,서울역,4208,5436,9644,4
2021-04-08,경의선,홍대입구,1566,1758,3324,4
2021-04-08,공항철도 1호선,서울역,6810,6179,12989,4
2021-04-08,공항철도 1호선,홍대입구,8457,8524,16981,4
2021-04-08,분당선,선릉,13426,19981,33407,4
2021-04-09,7호선,가산디지털단지,47147,47138,94285,4
2021-04-09,8호선,잠실(송파구청),13941,16332,30273,4
2021-04-09,9호선,고속터미널,13017,17730,30747,4
2021-04-09,경부선,서울역,6268,2198,8466,4
2021-04-09,경부선,가산디지털단지,18808,21348,40156,4
2021-04-09,경의선,서울역,4196,5494,9690,4
2021-04-09,경의선,홍대입구,1769,2007,3776,4
2021-04-09,공항철도 1호선,서울역,8096,7876,15972,4
2021-04-09,공항철도 1호선,홍대입구,9687,9584,19271,4
2021-04-09,분당선,선릉,13385,19879,33264,4
2021-04-09,1호선,서울역,44358,43789,88147,4
2021-04-09,2호선,사당,38214,41884,80098,4
2021-04-09,2호선,신림,63902,61708,125610,4
2021-04-09,2호선,구로디지털단지,63564,63365,126929,4
2021-04-09,2호선,홍대입구,53281,56951,110232,4
2021-04-09,3호선,고속터미널,43870,47015,90885,4
2021-04-09,4호선,서울역,10521,16101,26622,4
2021-04-09,4호선,사당,25610,21656,47266,4
2021-04-09,2호선,잠실(송파구청),68594,67836,136430,4
2021-04-09,2호선,선릉,55863,50087,105950,4
2021-04-09,2호선,강남,88811,87764,176575,4
2021-04-09,7호선,고속터미널,16351,14229,30580,4
2021-04-10,분당선,선릉,4993,7500,12493,4
2021-04-10,공항철도 1호선,홍대입구,10325,10101,20426,4
2021-04-10,공항철도 1호선,서울역,6442,6555,12997,4
2021-04-10,경의선,홍대입구,1669,1878,3547,4
2021-04-10,경의선,서울역,1226,1389,2615,4
2021-04-10,경부선,가산디지털단지,6278,8393,14671,4
2021-04-10,경부선,서울역,5585,1569,7154,4
2021-04-10,9호선,고속터미널,12148,17048,29196,4
2021-04-10,8호선,잠실(송파구청),11835,13382,25217,4
2021-04-10,7호선,가산디지털단지,15133,13831,28964,4
2021-04-10,7호선,고속터미널,12773,10443,23216,4
2021-04-10,4호선,사당,19600,16643,36243,4
2021-04-10,4호선,서울역,5177,11335,16512,4
2021-04-10,2호선,잠실(송파구청),59567,56683,116250,4
2021-04-10,2호선,선릉,22748,20343,43091,4
2021-04-10,2호선,강남,57271,57591,114862,4
2021-04-10,2호선,사당,28086,31192,59278,4
2021-04-10,2호선,신림,48507,45796,94303,4
2021-04-10,2호선,구로디지털단지,33728,33076,66804,4
2021-04-10,2호선,홍대입구,55504,59588,115092,4
2021-04-10,1호선,서울역,28324,28916,57240,4
2021-04-10,3호선,고속터미널,46911,47160,94071,4
2021-04-11,분당선,선릉,2775,4167,6942,4
2021-04-11,공항철도 1호선,홍대입구,8327,7700,16027,4
2021-04-11,공항철도 1호선,서울역,6434,5542,11976,4
2021-04-11,경의선,홍대입구,1392,1540,2932,4
2021-04-11,경의선,서울역,978,864,1842,4
2021-04-11,경부선,가산디지털단지,4488,6251,10739,4
2021-04-11,경부선,서울역,6116,1238,7354,4
2021-04-11,9호선,고속터미널,9464,12389,21853,4
2021-04-11,8호선,잠실(송파구청),8325,9094,17419,4
2021-04-11,7호선,가산디지털단지,10908,10206,21114,4
2021-04-11,7호선,고속터미널,11559,7243,18802,4
2021-04-11,4호선,사당,13382,12690,26072,4
2021-04-11,4호선,서울역,3792,7806,11598,4
2021-04-11,3호선,고속터미널,37507,33795,71302,4
2021-04-11,2호선,홍대입구,40473,40225,80698,4
2021-04-11,2호선,구로디지털단지,22588,22461,45049,4
2021-04-11,2호선,신림,34350,34202,68552,4
2021-04-11,2호선,사당,19479,21981,41460,4
2021-04-11,2호선,강남,31961,31210,63171,4
2021-04-11,2호선,선릉,12248,10610,22858,4
2021-04-11,2호선,잠실(송파구청),42232,39230,81462,4
2021-04-11,1호선,서울역,24053,20521,44574,4
2021-04-12,4호선,사당,22109,18713,40822,4
2021-04-12,1호선,서울역,39422,36523,75945,4
2021-04-12,2호선,잠실(송파구청),56727,56459,113186,4
2021-04-12,2호선,선릉,55244,48922,104166,4
2021-04-12,2호선,강남,78755,76766,155521,4
2021-04-12,2호선,사당,32011,35365,67376,4
2021-04-12,2호선,신림,58768,58226,116994,4
2021-04-12,2호선,구로디지털단지,60449,60921,121370,4
2021-04-12,2호선,홍대입구,40959,41208,82167,4
2021-04-12,경부선,서울역,4995,1562,6557,4
2021-04-12,4호선,서울역,10655,13672,24327,4
2021-04-12,3호선,고속터미널,34656,32323,66979,4
2021-04-12,분당선,선릉,13478,19649,33127,4
2021-04-12,공항철도 1호선,홍대입구,6671,7079,13750,4
2021-04-12,공항철도 1호선,서울역,6333,6128,12461,4
2021-04-12,경의선,홍대입구,1244,1419,2663,4
2021-04-12,경의선,서울역,3986,5118,9104,4
2021-04-12,7호선,가산디지털단지,49082,47965,97047,4
2021-04-12,7호선,고속터미널,14766,12244,27010,4
2021-04-12,9호선,고속터미널,10333,12939,23272,4
2021-04-12,8호선,잠실(송파구청),12590,14010,26600,4
2021-04-12,경부선,가산디지털단지,17833,21064,38897,4
2021-04-13,1호선,서울역,39550,37340,76890,4
2021-04-13,2호선,잠실(송파구청),60505,60160,120665,4
2021-04-13,2호선,선릉,56621,50633,107254,4
2021-04-13,2호선,강남,81433,79809,161242,4
2021-04-13,2호선,사당,35185,38145,73330,4
2021-04-13,2호선,신림,61180,59658,120838,4
2021-04-13,2호선,구로디지털단지,61686,62312,123998,4
2021-04-13,2호선,홍대입구,44399,45553,89952,4
2021-04-13,3호선,고속터미널,34721,33333,68054,4
2021-04-13,4호선,서울역,10721,13802,24523,4
2021-04-13,4호선,사당,23242,19666,42908,4
2021-04-13,7호선,고속터미널,13875,12424,26299,4
2021-04-13,7호선,가산디지털단지,48842,48859,97701,4
2021-04-13,8호선,잠실(송파구청),12624,14537,27161,4
2021-04-13,9호선,고속터미널,10655,13283,23938,4
2021-04-13,경부선,서울역,4033,1402,5435,4
2021-04-13,경부선,가산디지털단지,18469,21680,40149,4
2021-04-13,경의선,서울역,4087,5107,9194,4
2021-04-13,경의선,홍대입구,1369,1447,2816,4
2021-04-13,공항철도 1호선,서울역,6041,5472,11513,4
2021-04-13,공항철도 1호선,홍대입구,7362,7624,14986,4
2021-04-13,분당선,선릉,13520,19972,33492,4
2021-04-14,경의선,홍대입구,1531,1643,3174,4
2021-04-14,공항철도 1호선,서울역,6214,5786,12000,4
2021-04-14,공항철도 1호선,홍대입구,7991,8058,16049,4
2021-04-14,분당선,선릉,13534,20198,33732,4
2021-04-14,경의선,서울역,4141,5360,9501,4
2021-04-14,경부선,가산디지털단지,18515,21643,40158,4
2021-04-14,경부선,서울역,4115,1370,5485,4
2021-04-14,9호선,고속터미널,10871,13548,24419,4
2021-04-14,8호선,잠실(송파구청),12337,14313,26650,4
2021-04-14,7호선,가산디지털단지,48610,48460,97070,4
2021-04-14,7호선,고속터미널,13970,12300,26270,4
2021-04-14,4호선,사당,24065,20218,44283,4
2021-04-14,4호선,서울역,10872,14194,25066,4
2021-04-14,3호선,고속터미널,34968,33441,68409,4
2021-04-14,2호선,홍대입구,46197,47683,93880,4
2021-04-14,2호선,구로디지털단지,62403,62836,125239,4
2021-04-14,2호선,신림,62177,60459,122636,4
2021-04-14,2호선,사당,35731,39154,74885,4
2021-04-14,2호선,강남,82094,80122,162216,4
2021-04-14,2호선,선릉,57098,51083,108181,4
2021-04-14,2호선,잠실(송파구청),60530,60223,120753,4
2021-04-14,1호선,서울역,39909,37916,77825,4
2021-04-15,1호선,서울역,40937,38661,79598,4
2021-04-15,공항철도 1호선,서울역,6653,6152,12805,4
2021-04-15,공항철도 1호선,홍대입구,8234,8220,16454,4
2021-04-15,분당선,선릉,13671,20051,33722,4
2021-04-15,경의선,홍대입구,1445,1639,3084,4
2021-04-15,경의선,서울역,4187,5423,9610,4
2021-04-15,경부선,가산디지털단지,18531,21714,40245,4
2021-04-15,경부선,서울역,4506,1504,6010,4
2021-04-15,9호선,고속터미널,11218,13957,25175,4
2021-04-15,8호선,잠실(송파구청),12916,14893,27809,4
2021-04-15,7호선,가산디지털단지,48060,48235,96295,4
2021-04-15,7호선,고속터미널,14354,12888,27242,4
2021-04-15,4호선,사당,23850,20151,44001,4
2021-04-15,4호선,서울역,10876,14637,25513,4
2021-04-15,3호선,고속터미널,36065,34739,70804,4
2021-04-15,2호선,홍대입구,46469,48220,94689,4
2021-04-15,2호선,구로디지털단지,62283,62508,124791,4
2021-04-15,2호선,신림,61814,59755,121569,4
2021-04-15,2호선,사당,35569,39114,74683,4
2021-04-15,2호선,강남,81157,79418,160575,4
2021-04-15,2호선,선릉,56464,50734,107198,4
2021-04-15,2호선,잠실(송파구청),62007,61788,123795,4
2021-04-16,1호선,서울역,42996,42247,85243,4
2021-04-16,2호선,잠실(송파구청),64112,63859,127971,4
2021-04-16,2호선,선릉,55010,49288,104298,4
2021-04-16,2호선,강남,84596,83259,167855,4
2021-04-16,2호선,사당,36274,39204,75478,4
2021-04-16,2호선,신림,62364,60140,122504,4
2021-04-16,2호선,구로디지털단지,61722,61797,123519,4
2021-04-16,2호선,홍대입구,49337,52868,102205,4
2021-04-16,3호선,고속터미널,40859,44027,84886,4
2021-04-16,4호선,서울역,10616,16005,26621,4
2021-04-16,4호선,사당,24719,20713,45432,4
2021-04-16,7호선,고속터미널,15955,13745,29700,4
2021-04-16,7호선,가산디지털단지,47014,46865,93879,4
2021-04-16,8호선,잠실(송파구청),13649,15819,29468,4
2021-04-16,9호선,고속터미널,11973,16463,28436,4
2021-04-16,경부선,서울역,5791,2085,7876,4
2021-04-16,경부선,가산디지털단지,18385,20916,39301,4
2021-04-16,경의선,서울역,4103,5241,9344,4
2021-04-16,경의선,홍대입구,1559,1827,3386,4
2021-04-16,공항철도 1호선,서울역,7773,7623,15396,4
2021-04-16,공항철도 1호선,홍대입구,8892,9118,18010,4
2021-04-16,분당선,선릉,13163,19711,32874,4
2021-04-17,7호선,가산디지털단지,14009,12709,26718,4
2021-04-17,8호선,잠실(송파구청),10893,12420,23313,4
2021-04-17,9호선,고속터미널,10795,14903,25698,4
2021-04-17,경부선,서울역,4889,1494,6383,4
2021-04-17,경부선,가산디지털단지,5702,7740,13442,4
2021-04-17,경의선,서울역,1113,1241,2354,4
2021-04-17,경의선,홍대입구,1501,1759,3260,4
2021-04-17,공항철도 1호선,서울역,5839,6265,12104,4
2021-04-17,공항철도 1호선,홍대입구,9493,9242,18735,4
2021-04-17,7호선,고속터미널,12721,10035,22756,4
2021-04-17,4호선,사당,18056,15560,33616,4
2021-04-17,4호선,서울역,4846,10155,15001,4
2021-04-17,3호선,고속터미널,42377,43468,85845,4
2021-04-17,2호선,홍대입구,51111,54201,105312,4
2021-04-17,2호선,구로디지털단지,32114,31304,63418,4
2021-04-17,2호선,신림,46824,44792,91616,4
2021-04-17,2호선,사당,26866,29315,56181,4
2021-04-17,2호선,강남,54726,54513,109239,4
2021-04-17,2호선,선릉,22185,19828,42013,4
2021-04-17,2호선,잠실(송파구청),54019,51925,105944,4
2021-04-17,1호선,서울역,26161,26600,52761,4
2021-04-17,분당선,선릉,4961,7458,12419,4
2021-04-18,공항철도 1호선,홍대입구,8032,7007,15039,4
2021-04-18,공항철도 1호선,서울역,6236,5339,11575,4
2021-04-18,경의선,홍대입구,1314,1489,2803,4
2021-04-18,경의선,서울역,922,875,1797,4
2021-04-18,경부선,가산디지털단지,4371,5965,10336,4
2021-04-18,경부선,서울역,5733,1145,6878,4
2021-04-18,9호선,고속터미널,8931,11722,20653,4
2021-04-18,8호선,잠실(송파구청),8409,8979,17388,4
2021-04-18,7호선,가산디지털단지,10272,9413,19685,4
2021-04-18,7호선,고속터미널,10919,6838,17757,4
2021-04-18,4호선,사당,12980,12237,25217,4
2021-04-18,4호선,서울역,3638,7409,11047,4
2021-04-18,3호선,고속터미널,35600,32425,68025,4
2021-04-18,2호선,홍대입구,37447,36959,74406,4
2021-04-18,2호선,구로디지털단지,21532,21268,42800,4
2021-04-18,2호선,신림,34142,33519,67661,4
2021-04-18,2호선,사당,18773,20976,39749,4
2021-04-18,2호선,강남,30176,28916,59092,4
2021-04-18,2호선,선릉,11856,10425,22281,4
2021-04-18,2호선,잠실(송파구청),39482,37061,76543,4
2021-04-18,1호선,서울역,23488,19721,43209,4
2021-04-18,분당선,선릉,2640,3920,6560,4
2021-04-19,분당선,선릉,13180,19813,32993,4
2021-04-19,공항철도 1호선,홍대입구,7557,7566,15123,4
2021-04-19,공항철도 1호선,서울역,6428,5885,12313,4
2021-04-19,경의선,홍대입구,1356,1546,2902,4
2021-04-19,경의선,서울역,4263,5376,9639,4
2021-04-19,7호선,가산디지털단지,48164,48328,96492,4
2021-04-19,7호선,고속터미널,14919,12571,27490,4
2021-04-19,경부선,서울역,4915,1502,6417,4
2021-04-19,경부선,가산디지털단지,18792,21831,40623,4
2021-04-19,4호선,사당,22830,19206,42036,4
2021-04-19,4호선,서울역,10573,13758,24331,4
2021-04-19,3호선,고속터미널,30886,28665,59551,4
2021-04-19,2호선,홍대입구,42295,43633,85928,4
2021-04-19,2호선,구로디지털단지,61638,61818,123456,4
2021-04-19,2호선,신림,59788,58388,118176,4
2021-04-19,2호선,사당,33457,37033,70490,4
2021-04-19,2호선,강남,78579,77409,155988,4
2021-04-19,2호선,선릉,55497,49437,104934,4
2021-04-19,2호선,잠실(송파구청),55955,55692,111647,4
2021-04-19,1호선,서울역,40111,37225,77336,4
2021-04-19,8호선,잠실(송파구청),11812,13590,25402,4
2021-04-19,9호선,고속터미널,10421,12749,23170,4
2021-04-20,8호선,잠실(송파구청),12672,14899,27571,4
2021-04-20,7호선,고속터미널,14393,12700,27093,4
2021-04-20,7호선,가산디지털단지,48570,48524,97094,4
2021-04-20,3호선,고속터미널,35320,33854,69174,4
2021-04-20,2호선,선릉,56467,50482,106949,4
2021-04-20,2호선,잠실(송파구청),61959,60934,122893,4
2021-04-20,경의선,홍대입구,1477,1631,3108,4
2021-04-20,경의선,서울역,4140,5157,9297,4
2021-04-20,2호선,홍대입구,43415,44984,88399,4
2021-04-20,2호선,구로디지털단지,62429,62790,125219,4
2021-04-20,2호선,신림,61597,59850,121447,4
2021-04-20,2호선,사당,34885,38152,73037,4
2021-04-20,2호선,강남,80151,79109,159260,4
2021-04-20,1호선,서울역,39441,37340,76781,4
2021-04-20,4호선,사당,23481,19832,43313,4
2021-04-20,4호선,서울역,10673,14006,24679,4
2021-04-20,분당선,선릉,13413,19962,33375,4
2021-04-20,공항철도 1호선,홍대입구,7630,7840,15470,4
2021-04-20,공항철도 1호선,서울역,6289,5656,11945,4
2021-04-20,경부선,가산디지털단지,18884,22076,40960,4
2021-04-20,경부선,서울역,4277,1466,5743,4
2021-04-20,9호선,고속터미널,10893,13448,24341,4
2021-04-21,3호선,고속터미널,35427,33936,69363,4
2021-04-21,2호선,홍대입구,44638,46407,91045,4
2021-04-21,2호선,구로디지털단지,62024,62391,124415,4
2021-04-21,2호선,신림,61859,59836,121695,4
2021-04-21,2호선,사당,35635,38776,74411,4
2021-04-21,2호선,강남,80239,78917,159156,4
2021-04-21,2호선,선릉,56276,50372,106648,4
2021-04-21,2호선,잠실(송파구청),62877,62050,124927,4
2021-04-21,1호선,서울역,39607,37714,77321,4
2021-04-21,분당선,선릉,13475,19931,33406,4
2021-04-21,공항철도 1호선,홍대입구,7977,8150,16127,4
2021-04-21,공항철도 1호선,서울역,6375,5878,12253,4
2021-04-21,경의선,홍대입구,1450,1625,3075,4
2021-04-21,경의선,서울역,4170,5342,9512,4
2021-04-21,경부선,가산디지털단지,18794,21740,40534,4
2021-04-21,경부선,서울역,4381,1409,5790,4
2021-04-21,9호선,고속터미널,11388,14081,25469,4
2021-04-21,8호선,잠실(송파구청),12742,14990,27732,4
2021-04-21,7호선,가산디지털단지,48068,48333,96401,4
2021-04-21,7호선,고속터미널,14272,12722,26994,4
2021-04-21,4호선,사당,23882,20090,43972,4
2021-04-21,4호선,서울역,10629,14199,24828,4
2021-04-22,4호선,사당,23656,19876,43532,4
2021-04-22,4호선,서울역,10780,14553,25333,4
2021-04-22,3호선,고속터미널,35859,35021,70880,4
2021-04-22,1호선,서울역,40615,38481,79096,4
2021-04-22,2호선,잠실(송파구청),62225,61665,123890,4
2021-04-22,2호선,선릉,56173,50063,106236,4
2021-04-22,2호선,강남,80165,79009,159174,4
2021-04-22,2호선,사당,35285,39089,74374,4
2021-04-22,2호선,신림,61551,59423,120974,4
2021-04-22,2호선,구로디지털단지,61881,61906,123787,4
2021-04-22,2호선,홍대입구,45737,48079,93816,4
2021-04-22,분당선,선릉,13273,19829,33102,4
2021-04-22,공항철도 1호선,홍대입구,8314,8385,16699,4
2021-04-22,공항철도 1호선,서울역,6701,6095,12796,4
2021-04-22,경의선,홍대입구,1502,1690,3192,4
2021-04-22,경의선,서울역,4205,5316,9521,4
2021-04-22,경부선,가산디지털단지,18544,21535,40079,4
2021-04-22,경부선,서울역,4778,1572,6350,4
2021-04-22,9호선,고속터미널,11350,14169,25519,4
2021-04-22,8호선,잠실(송파구청),12800,15138,27938,4
2021-04-22,7호선,가산디지털단지,47596,48072,95668,4
2021-04-22,7호선,고속터미널,14530,12634,27164,4
2021-04-23,경부선,서울역,6356,2187,8543,4
2021-04-23,경부선,가산디지털단지,18673,21473,40146,4
2021-04-23,경의선,서울역,4345,5295,9640,4
2021-04-23,경의선,홍대입구,1691,2016,3707,4
2021-04-23,공항철도 1호선,서울역,8058,7806,15864,4
2021-04-23,공항철도 1호선,홍대입구,9550,9672,19222,4
2021-04-23,분당선,선릉,13290,19937,33227,4
2021-04-23,3호선,고속터미널,42403,45590,87993,4
2021-04-23,2호선,홍대입구,51818,55896,107714,4
2021-04-23,2호선,구로디지털단지,62390,62010,124400,4
2021-04-23,2호선,신림,62989,60605,123594,4
2021-04-23,2호선,사당,37031,40270,77301,4
2021-04-23,2호선,강남,85026,84261,169287,4
2021-04-23,2호선,선릉,55264,49765,105029,4
2021-04-23,2호선,잠실(송파구청),65635,65095,130730,4
2021-04-23,1호선,서울역,44451,43306,87757,4
2021-04-23,4호선,서울역,10771,16611,27382,4
2021-04-23,4호선,사당,24996,21012,46008,4
2021-04-23,7호선,고속터미널,16988,14299,31287,4
2021-04-23,7호선,가산디지털단지,47494,47333,94827,4
2021-04-23,8호선,잠실(송파구청),13308,15768,29076,4
2021-04-23,9호선,고속터미널,12870,17316,30186,4
2021-04-24,7호선,고속터미널,12844,10251,23095,4
2021-04-24,경부선,가산디지털단지,5985,8046,14031,4
2021-04-24,경부선,서울역,5245,1490,6735,4
2021-04-24,9호선,고속터미널,11841,16793,28634,4
2021-04-24,경의선,홍대입구,1669,1901,3570,4
2021-04-24,경의선,서울역,1254,1430,2684,4
2021-04-24,분당선,선릉,4745,7337,12082,4
2021-04-24,공항철도 1호선,홍대입구,10380,9991,20371,4
2021-04-24,공항철도 1호선,서울역,6552,6530,13082,4
2021-04-24,8호선,잠실(송파구청),10666,12234,22900,4
2021-04-24,7호선,가산디지털단지,14322,13162,27484,4
2021-04-24,1호선,서울역,27220,28071,55291,4
2021-04-24,2호선,잠실(송파구청),54554,51944,106498,4
2021-04-24,2호선,선릉,22019,19593,41612,4
2021-04-24,2호선,강남,54441,54637,109078,4
2021-04-24,2호선,사당,26945,29929,56874,4
2021-04-24,2호선,신림,47518,45042,92560,4
2021-04-24,2호선,구로디지털단지,32268,31508,63776,4
2021-04-24,2호선,홍대입구,53290,57772,111062,4
2021-04-24,3호선,고속터미널,44123,44870,88993,4
2021-04-24,4호선,서울역,5046,10867,15913,4
2021-04-24,4호선,사당,18477,16067,34544,4
2021-04-25,분당선,선릉,2735,3899,6634,4
2021-04-25,공항철도 1호선,홍대입구,8386,7602,15988,4
2021-04-25,공항철도 1호선,서울역,6273,5497,11770,4
2021-04-25,경의선,홍대입구,1356,1589,2945,4
2021-04-25,경의선,서울역,915,875,1790,4
2021-04-25,경부선,가산디지털단지,4368,6186,10554,4
2021-04-25,경부선,서울역,6035,1281,7316,4
2021-04-25,9호선,고속터미널,9557,12314,21871,4
2021-04-25,8호선,잠실(송파구청),8169,8964,17133,4
2021-04-25,7호선,가산디지털단지,10776,9873,20649,4
2021-04-25,7호선,고속터미널,11400,7564,18964,4
2021-04-25,4호선,사당,13172,12394,25566,4
2021-04-25,4호선,서울역,3700,7607,11307,4
2021-04-25,3호선,고속터미널,36816,33367,70183,4
2021-04-25,2호선,홍대입구,38718,38931,77649,4
2021-04-25,2호선,구로디지털단지,21148,20937,42085,4
2021-04-25,2호선,신림,34319,33452,67771,4
2021-04-25,2호선,사당,18753,21291,40044,4
2021-04-25,2호선,강남,30091,29319,59410,4
2021-04-25,2호선,선릉,11810,10417,22227,4
2021-04-25,2호선,잠실(송파구청),40132,37095,77227,4
2021-04-25,1호선,서울역,23478,20137,43615,4
2021-04-26,분당선,선릉,13373,20116,33489,4
2021-04-26,공항철도 1호선,홍대입구,7645,7706,15351,4
2021-04-26,공항철도 1호선,서울역,6590,6252,12842,4
2021-04-26,경의선,홍대입구,1425,1603,3028,4
2021-04-26,경의선,서울역,4316,5444,9760,4
2021-04-26,경부선,가산디지털단지,18725,21681,40406,4
2021-04-26,경부선,서울역,5010,1626,6636,4
2021-04-26,9호선,고속터미널,11384,14122,25506,4
2021-04-26,8호선,잠실(송파구청),12380,14569,26949,4
2021-04-26,7호선,가산디지털단지,47975,48165,96140,4
2021-04-26,7호선,고속터미널,15222,12731,27953,4
2021-04-26,4호선,사당,23049,19382,42431,4
2021-04-26,4호선,서울역,10426,13920,24346,4
2021-04-26,3호선,고속터미널,36175,34163,70338,4
2021-04-26,2호선,홍대입구,44478,45864,90342,4
2021-04-26,2호선,구로디지털단지,61564,61874,123438,4
2021-04-26,2호선,신림,60921,59223,120144,4
2021-04-26,2호선,사당,33374,37257,70631,4
2021-04-26,2호선,강남,79039,78186,157225,4
2021-04-26,2호선,선릉,56332,50012,106344,4
2021-04-26,2호선,잠실(송파구청),60691,60511,121202,4
2021-04-26,1호선,서울역,40245,37827,78072,4
2021-04-27,2호선,잠실(송파구청),62870,62125,124995,4
2021-04-27,2호선,선릉,56443,50438,106881,4
2021-04-27,2호선,강남,81329,79878,161207,4
2021-04-27,2호선,사당,34820,38070,72890,4
2021-04-27,2호선,신림,61556,60088,121644,4
2021-04-27,2호선,구로디지털단지,62423,62639,125062,4
2021-04-27,2호선,홍대입구,46297,47684,93981,4
2021-04-27,3호선,고속터미널,35321,33996,69317,4
2021-04-27,4호선,서울역,10851,14107,24958,4
2021-04-27,4호선,사당,23902,19896,43798,4
2021-04-27,7호선,고속터미널,14346,12708,27054,4
2021-04-27,7호선,가산디지털단지,48876,48571,97447,4
2021-04-27,8호선,잠실(송파구청),12829,15062,27891,4
2021-04-27,9호선,고속터미널,11106,13563,24669,4
2021-04-27,경부선,서울역,4375,1448,5823,4
2021-04-27,경부선,가산디지털단지,18554,21823,40377,4
2021-04-27,분당선,선릉,13448,19978,33426,4
2021-04-27,공항철도 1호선,홍대입구,8027,8189,16216,4
2021-04-27,공항철도 1호선,서울역,6243,5744,11987,4
2021-04-27,경의선,서울역,4226,3895,8121,4
2021-04-27,경의선,홍대입구,1384,1688,3072,4
2021-04-27,경의선,서울역,75,1505,1580,4
2021-04-27,1호선,서울역,40091,37557,77648,4
2021-04-28,분당선,선릉,13486,20132,33618,4
2021-04-28,공항철도 1호선,홍대입구,8474,8454,16928,4
2021-04-28,공항철도 1호선,서울역,6350,5811,12161,4
2021-04-28,경의선,홍대입구,1592,1749,3341,4
2021-04-28,경의선,서울역,4188,5333,9521,4
2021-04-28,경부선,가산디지털단지,18443,21648,40091,4
2021-04-28,경부선,서울역,4468,1480,5948,4
2021-04-28,9호선,고속터미널,11450,14238,25688,4
2021-04-28,8호선,잠실(송파구청),13042,15063,28105,4
2021-04-28,7호선,가산디지털단지,48621,48680,97301,4
2021-04-28,7호선,고속터미널,14043,12508,26551,4
2021-04-28,4호선,사당,24006,20180,44186,4
2021-04-28,4호선,서울역,10713,14383,25096,4
2021-04-28,3호선,고속터미널,34971,33954,68925,4
2021-04-28,2호선,홍대입구,48006,49834,97840,4
2021-04-28,2호선,구로디지털단지,62006,62291,124297,4
2021-04-28,2호선,신림,61945,60081,122026,4
2021-04-28,2호선,사당,35369,38759,74128,4
2021-04-28,2호선,강남,81364,80076,161440,4
2021-04-28,2호선,선릉,56550,50562,107112,4
2021-04-28,2호선,잠실(송파구청),63949,63719,127668,4
2021-04-28,1호선,서울역,40416,38091,78507,4
2021-04-29,1호선,서울역,41115,39292,80407,4
2021-04-29,2호선,선릉,56075,50276,106351,4
2021-04-29,2호선,강남,80816,79560,160376,4
2021-04-29,2호선,사당,35378,38654,74032,4
2021-04-29,2호선,신림,62305,60566,122871,4
2021-04-29,2호선,구로디지털단지,62169,62668,124837,4
2021-04-29,2호선,홍대입구,49702,51648,101350,4
2021-04-29,3호선,고속터미널,36435,35476,71911,4
2021-04-29,4호선,서울역,10793,14625,25418,4
2021-04-29,4호선,사당,23992,20065,44057,4
2021-04-29,7호선,고속터미널,14668,12714,27382,4
2021-04-29,7호선,가산디지털단지,47892,48323,96215,4
2021-04-29,8호선,잠실(송파구청),13421,15582,29003,4
2021-04-29,9호선,고속터미널,11382,14034,25416,4
2021-04-29,경부선,서울역,4714,1596,6310,4
2021-04-29,경부선,가산디지털단지,18589,21585,40174,4
2021-04-29,경의선,서울역,4281,5408,9689,4
2021-04-29,경의선,홍대입구,1566,1790,3356,4
2021-04-29,공항철도 1호선,서울역,6909,6290,13199,4
2021-04-29,공항철도 1호선,홍대입구,8783,8679,17462,4
2021-04-29,분당선,선릉,13467,19994,33461,4
2021-04-29,2호선,잠실(송파구청),64721,64505,129226,4
2021-04-30,1호선,서울역,45826,45476,91302,4
2021-04-30,2호선,잠실(송파구청),69682,68966,138648,4
2021-04-30,2호선,선릉,55573,50127,105700,4
2021-04-30,2호선,강남,85939,85133,171072,4
2021-04-30,2호선,사당,37196,40502,77698,4
2021-04-30,2호선,신림,64071,61725,125796,4
2021-04-30,2호선,구로디지털단지,62902,63042,125944,4
2021-04-30,2호선,홍대입구,55104,58872,113976,4
2021-04-30,3호선,고속터미널,44409,48776,93185,4
2021-04-30,4호선,서울역,10939,17204,28143,4
2021-04-30,4호선,사당,25729,21171,46900,4
2021-04-30,7호선,고속터미널,17165,14574,31739,4
2021-04-30,7호선,가산디지털단지,48014,47678,95692,4
2021-04-30,8호선,잠실(송파구청),14077,16590,30667,4
2021-04-30,9호선,고속터미널,13185,18360,31545,4
2021-04-30,경부선,서울역,6734,2377,9111,4
2021-04-30,경부선,가산디지털단지,18969,21896,40865,4
2021-04-30,경의선,서울역,4429,5687,10116,4
2021-04-30,경의선,홍대입구,1707,2083,3790,4
2021-04-30,공항철도 1호선,서울역,8387,8350,16737,4
2021-04-30,공항철도 1호선,홍대입구,9858,10084,19942,4
2021-04-30,분당선,선릉,13355,19973,33328,4
2021-05-01,4호선,사당,17920,15152,33072,5
2021-05-01,4호선,서울역,4511,10607,15118,5
2021-05-01,3호선,고속터미널,43958,45622,89580,5
2021-05-01,2호선,홍대입구,57658,59726,117384,5
2021-05-01,2호선,구로디지털단지,29607,28754,58361,5
2021-05-01,2호선,신림,44694,42146,86840,5
2021-05-01,2호선,사당,25293,27730,53023,5
2021-05-01,2호선,강남,51837,50791,102628,5
2021-05-01,2호선,선릉,20328,18438,38766,5
2021-05-01,2호선,잠실(송파구청),55405,53059,108464,5
2021-05-01,1호선,서울역,26548,27986,54534,5
2021-05-01,7호선,고속터미널,12226,9514,21740,5
2021-05-01,7호선,가산디지털단지,13779,12664,26443,5
2021-05-01,8호선,잠실(송파구청),12089,13600,25689,5
2021-05-01,9호선,고속터미널,11244,16329,27573,5
2021-05-01,경부선,서울역,5011,1588,6599,5
2021-05-01,경부선,가산디지털단지,5335,7374,12709,5
2021-05-01,경의선,서울역,1052,1237,2289,5
2021-05-01,경의선,홍대입구,1680,2146,3826,5
2021-05-01,공항철도 1호선,서울역,6245,6707,12952,5
2021-05-01,공항철도 1호선,홍대입구,11150,11187,22337,5
2021-05-01,분당선,선릉,4454,6955,11409,5
2021-05-02,1호선,서울역,25058,21978,47036,5
2021-05-02,2호선,잠실(송파구청),44466,41505,85971,5
2021-05-02,2호선,선릉,11931,10446,22377,5
2021-05-02,2호선,강남,32515,31048,63563,5
2021-05-02,2호선,사당,19060,21504,40564,5
2021-05-02,2호선,신림,34610,34314,68924,5
2021-05-02,2호선,구로디지털단지,22087,21642,43729,5
2021-05-02,2호선,홍대입구,45763,45830,91593,5
2021-05-02,3호선,고속터미널,38639,35327,73966,5
2021-05-02,4호선,서울역,3735,8023,11758,5
2021-05-02,4호선,사당,13468,12683,26151,5
2021-05-02,7호선,고속터미널,12260,7709,19969,5
2021-05-02,7호선,가산디지털단지,10803,9926,20729,5
2021-05-02,8호선,잠실(송파구청),9006,9935,18941,5
2021-05-02,9호선,고속터미널,10100,13399,23499,5
2021-05-02,경부선,서울역,6636,1332,7968,5
2021-05-02,경부선,가산디지털단지,4378,6108,10486,5
2021-05-02,경의선,서울역,970,990,1960,5
2021-05-02,경의선,홍대입구,1468,1747,3215,5
2021-05-02,공항철도 1호선,서울역,6575,5974,12549,5
2021-05-02,공항철도 1호선,홍대입구,9543,8682,18225,5
2021-05-02,분당선,선릉,2656,3884,6540,5
2021-05-03,1호선,서울역,41152,38541,79693,5
2021-05-03,분당선,선릉,13347,19847,33194,5
2021-05-03,공항철도 1호선,홍대입구,8660,8785,17445,5
2021-05-03,공항철도 1호선,서울역,6624,6308,12932,5
2021-05-03,경의선,홍대입구,1544,1832,3376,5
2021-05-03,경의선,서울역,4231,5498,9729,5
2021-05-03,경부선,가산디지털단지,18981,21959,40940,5
2021-05-03,경부선,서울역,5321,1651,6972,5
2021-05-03,9호선,고속터미널,11583,14591,26174,5
2021-05-03,8호선,잠실(송파구청),12956,15012,27968,5
2021-05-03,7호선,가산디지털단지,48064,48599,96663,5
2021-05-03,7호선,고속터미널,15874,13285,29159,5
2021-05-03,4호선,사당,23412,19646,43058,5
2021-05-03,4호선,서울역,10592,14539,25131,5
2021-05-03,3호선,고속터미널,37923,35614,73537,5
2021-05-03,2호선,홍대입구,48059,49428,97487,5
2021-05-03,2호선,구로디지털단지,61825,62035,123860,5
2021-05-03,2호선,신림,61709,59463,121172,5
2021-05-03,2호선,사당,34263,38020,72283,5
2021-05-03,2호선,강남,81653,80324,161977,5
2021-05-03,2호선,선릉,55133,49575,104708,5
2021-05-03,2호선,잠실(송파구청),64038,63896,127934,5
2021-05-04,4호선,사당,23985,20137,44122,5
2021-05-04,공항철도 1호선,서울역,7102,6954,14056,5
2021-05-04,공항철도 1호선,홍대입구,8284,8673,16957,5
2021-05-04,분당선,선릉,13657,19954,33611,5
2021-05-04,1호선,서울역,41511,39743,81254,5
2021-05-04,경의선,홍대입구,1465,1664,3129,5
2021-05-04,경의선,서울역,3989,5211,9200,5
2021-05-04,경부선,가산디지털단지,18198,21394,39592,5
2021-05-04,경부선,서울역,5625,2013,7638,5
2021-05-04,9호선,고속터미널,11314,15112,26426,5
2021-05-04,8호선,잠실(송파구청),13694,15906,29600,5
2021-05-04,7호선,가산디지털단지,48351,48198,96549,5
2021-05-04,7호선,고속터미널,15158,13081,28239,5
2021-05-04,4호선,서울역,10496,15078,25574,5
2021-05-04,2호선,잠실(송파구청),63162,63003,126165,5
2021-05-04,2호선,홍대입구,48412,50430,98842,5
2021-05-04,2호선,구로디지털단지,61618,61931,123549,5
2021-05-04,2호선,신림,61366,59803,121169,5
2021-05-04,2호선,사당,35747,38741,74488,5
2021-05-04,2호선,강남,84857,82680,167537,5
2021-05-04,2호선,선릉,55360,49375,104735,5
2021-05-04,3호선,고속터미널,38490,38983,77473,5
2021-05-05,1호선,서울역,22203,21221,43424,5
2021-05-05,2호선,잠실(송파구청),50404,48064,98468,5
2021-05-05,2호선,선릉,15520,13734,29254,5
2021-05-05,2호선,강남,38489,37507,75996,5
2021-05-05,2호선,사당,21524,23842,45366,5
2021-05-05,2호선,신림,40044,38191,78235,5
2021-05-05,2호선,구로디지털단지,27079,26470,53549,5
2021-05-05,2호선,홍대입구,55851,57119,112970,5
2021-05-05,3호선,고속터미널,37533,34884,72417,5
2021-05-05,4호선,서울역,4169,7737,11906,5
2021-05-05,4호선,사당,15447,13577,29024,5
2021-05-05,7호선,고속터미널,8955,7141,16096,5
2021-05-05,7호선,가산디지털단지,12662,11648,24310,5
2021-05-05,8호선,잠실(송파구청),10905,12015,22920,5
2021-05-05,9호선,고속터미널,10206,13454,23660,5
2021-05-05,경부선,서울역,3829,1133,4962,5
2021-05-05,경부선,가산디지털단지,5064,6760,11824,5
2021-05-05,경의선,서울역,1172,1071,2243,5
2021-05-05,경의선,홍대입구,1788,2185,3973,5
2021-05-05,공항철도 1호선,서울역,5349,5028,10377,5
2021-05-05,공항철도 1호선,홍대입구,11045,10546,21591,5
2021-05-05,분당선,선릉,3219,4848,8067,5
2021-05-06,9호선,고속터미널,11806,15420,27226,5
2021-05-06,경부선,서울역,5133,1653,6786,5
2021-05-06,경부선,가산디지털단지,18435,21524,39959,5
2021-05-06,경의선,서울역,4295,5426,9721,5
2021-05-06,경의선,홍대입구,1744,1988,3732,5
2021-05-06,공항철도 1호선,서울역,6962,6739,13701,5
2021-05-06,공항철도 1호선,홍대입구,9528,9598,19126,5
2021-05-06,1호선,서울역,41911,40169,82080,5
2021-05-06,2호선,잠실(송파구청),67364,66877,134241,5
2021-05-06,2호선,선릉,56184,50694,106878,5
2021-05-06,2호선,강남,82832,81538,164370,5
2021-05-06,분당선,선릉,13728,20210,33938,5
2021-05-06,2호선,사당,35631,39329,74960,5
2021-05-06,2호선,신림,62276,60173,122449,5
2021-05-06,2호선,구로디지털단지,61910,62250,124160,5
2021-05-06,2호선,홍대입구,52156,53576,105732,5
2021-05-06,3호선,고속터미널,38472,37701,76173,5
2021-05-06,4호선,서울역,10663,15279,25942,5
2021-05-06,4호선,사당,24256,20126,44382,5
2021-05-06,7호선,고속터미널,15083,12865,27948,5
2021-05-06,7호선,가산디지털단지,47456,47983,95439,5
2021-05-06,8호선,잠실(송파구청),13263,15602,28865,5
2021-05-07,4호선,사당,25274,20653,45927,5
2021-05-07,7호선,고속터미널,16806,14721,31527,5
2021-05-07,7호선,가산디지털단지,47401,46516,93917,5
2021-05-07,8호선,잠실(송파구청),13858,16267,30125,5
2021-05-07,9호선,고속터미널,12887,19523,32410,5
2021-05-07,경부선,서울역,6534,2473,9007,5
2021-05-07,경부선,가산디지털단지,18180,20747,38927,5
2021-05-07,분당선,선릉,13428,19833,33261,5
2021-05-07,2호선,홍대입구,54997,57907,112904,5
2021-05-07,2호선,구로디지털단지,61552,60841,122393,5
2021-05-07,2호선,신림,63321,59767,123088,5
2021-05-07,2호선,사당,36433,39553,75986,5
2021-05-07,2호선,강남,86962,85690,172652,5
2021-05-07,2호선,선릉,55465,49508,104973,5
2021-05-07,2호선,잠실(송파구청),68122,68097,136219,5
2021-05-07,4호선,서울역,10727,17437,28164,5
2021-05-07,1호선,서울역,45018,45709,90727,5
2021-05-07,경의선,서울역,4382,5447,9829,5
2021-05-07,3호선,고속터미널,43983,53185,97168,5
2021-05-07,공항철도 1호선,홍대입구,10147,10093,20240,5
2021-05-07,공항철도 1호선,서울역,8329,8536,16865,5
2021-05-07,경의선,홍대입구,1793,2009,3802,5
2021-05-08,1호선,서울역,24691,26067,50758,5
2021-05-08,2호선,잠실(송파구청),49192,47232,96424,5
2021-05-08,2호선,선릉,19438,17034,36472,5
2021-05-08,2호선,강남,48809,47951,96760,5
2021-05-08,2호선,사당,22669,25095,47764,5
2021-05-08,2호선,신림,43343,40596,83939,5
2021-05-08,2호선,구로디지털단지,29413,28452,57865,5
2021-05-08,2호선,홍대입구,47947,50371,98318,5
2021-05-08,3호선,고속터미널,40874,45879,86753,5
2021-05-08,4호선,서울역,4390,9689,14079,5
2021-05-08,4호선,사당,15911,13893,29804,5
2021-05-08,7호선,고속터미널,11934,9782,21716,5
2021-05-08,7호선,가산디지털단지,13281,11922,25203,5
2021-05-08,8호선,잠실(송파구청),10023,11566,21589,5
2021-05-08,9호선,고속터미널,10543,15869,26412,5
2021-05-08,경부선,서울역,4620,1497,6117,5
2021-05-08,경부선,가산디지털단지,5462,7251,12713,5
2021-05-08,경의선,서울역,1082,1201,2283,5
2021-05-08,경의선,홍대입구,1568,1811,3379,5
2021-05-08,공항철도 1호선,서울역,5969,6415,12384,5
2021-05-08,공항철도 1호선,홍대입구,9165,8679,17844,5
2021-05-08,분당선,선릉,4292,6312,10604,5
2021-05-09,2호선,잠실(송파구청),43228,39519,82747,5
2021-05-09,2호선,선릉,11721,10465,22186,5
2021-05-09,2호선,강남,32612,31654,64266,5
2021-05-09,2호선,사당,19094,21734,40828,5
2021-05-09,2호선,신림,33222,34750,67972,5
2021-05-09,2호선,구로디지털단지,21471,21719,43190,5
2021-05-09,2호선,홍대입구,44273,45515,89788,5
2021-05-09,분당선,선릉,2702,4011,6713,5
2021-05-09,공항철도 1호선,홍대입구,9324,8928,18252,5
2021-05-09,공항철도 1호선,서울역,7295,5679,12974,5
2021-05-09,경의선,홍대입구,1559,1973,3532,5
2021-05-09,경의선,서울역,1020,957,1977,5
2021-05-09,경부선,가산디지털단지,4232,6147,10379,5
2021-05-09,경부선,서울역,7143,1282,8425,5
2021-05-09,9호선,고속터미널,11071,12707,23778,5
2021-05-09,8호선,잠실(송파구청),8367,9245,17612,5
2021-05-09,7호선,가산디지털단지,10123,9860,19983,5
2021-05-09,7호선,고속터미널,14915,7546,22461,5
2021-05-09,3호선,고속터미널,42650,33485,76135,5
2021-05-09,4호선,서울역,3639,7510,11149,5
2021-05-09,4호선,사당,13490,12685,26175,5
2021-05-09,1호선,서울역,25486,20629,46115,5
2021-05-10,경부선,서울역,5615,1611,7226,5
2021-05-10,경부선,가산디지털단지,18421,21606,40027,5
2021-05-10,경의선,서울역,4293,5317,9610,5
2021-05-10,경의선,홍대입구,1472,1669,3141,5
2021-05-10,공항철도 1호선,서울역,6955,6324,13279,5
2021-05-10,공항철도 1호선,홍대입구,7673,8089,15762,5
2021-05-10,분당선,선릉,13623,20188,33811,5
2021-05-10,4호선,사당,22927,19287,42214,5
2021-05-10,4호선,서울역,10597,13937,24534,5
2021-05-10,3호선,고속터미널,35872,32620,68492,5
2021-05-10,2호선,홍대입구,43920,45134,89054,5
2021-05-10,2호선,구로디지털단지,60809,61533,122342,5
2021-05-10,2호선,신림,60060,58929,118989,5
2021-05-10,2호선,사당,33245,36721,69966,5
2021-05-10,2호선,강남,81207,80172,161379,5
2021-05-10,2호선,선릉,55545,49746,105291,5
2021-05-10,2호선,잠실(송파구청),59288,59260,118548,5
2021-05-10,1호선,서울역,41548,37411,78959,5
2021-05-10,7호선,고속터미널,16033,12491,28524,5
2021-05-10,7호선,가산디지털단지,48298,48619,96917,5
2021-05-10,8호선,잠실(송파구청),12285,14386,26671,5
2021-05-10,9호선,고속터미널,10879,13388,24267,5
2021-05-11,7호선,고속터미널,14819,12840,27659,5
2021-05-11,7호선,가산디지털단지,48743,49068,97811,5
2021-05-11,8호선,잠실(송파구청),13059,15201,28260,5
2021-05-11,9호선,고속터미널,11556,14332,25888,5
2021-05-11,경부선,서울역,4514,1461,5975,5
2021-05-11,경부선,가산디지털단지,18982,22154,41136,5
2021-05-11,경의선,서울역,4342,5623,9965,5
2021-05-11,경의선,홍대입구,1525,1790,3315,5
2021-05-11,공항철도 1호선,서울역,6622,6046,12668,5
2021-05-11,공항철도 1호선,홍대입구,8652,8780,17432,5
2021-05-11,분당선,선릉,13821,20434,34255,5
2021-05-11,1호선,서울역,41228,38422,79650,5
2021-05-11,2호선,잠실(송파구청),64327,63725,128052,5
2021-05-11,2호선,선릉,57155,51191,108346,5
2021-05-11,2호선,강남,84590,83597,168187,5
2021-05-11,2호선,사당,36036,39656,75692,5
2021-05-11,2호선,신림,62475,61025,123500,5
2021-05-11,2호선,구로디지털단지,62919,63459,126378,5
2021-05-11,2호선,홍대입구,49189,51107,100296,5
2021-05-11,3호선,고속터미널,37028,34512,71540,5
2021-05-11,4호선,서울역,10792,14557,25349,5
2021-05-11,4호선,사당,24597,20719,45316,5
2021-05-12,경의선,홍대입구,1677,1809,3486,5
2021-05-12,경의선,서울역,4365,5483,9848,5
2021-05-12,1호선,서울역,41350,39038,80388,5
2021-05-12,경부선,가산디지털단지,18914,21915,40829,5
2021-05-12,경부선,서울역,4640,1521,6161,5
2021-05-12,9호선,고속터미널,11778,14543,26321,5
2021-05-12,8호선,잠실(송파구청),12937,15392,28329,5
2021-05-12,7호선,가산디지털단지,48331,48817,97148,5
2021-05-12,7호선,고속터미널,14772,12976,27748,5
2021-05-12,4호선,사당,24787,20666,45453,5
2021-05-12,4호선,서울역,10832,14606,25438,5
2021-05-12,3호선,고속터미널,36324,34838,71162,5
2021-05-12,2호선,홍대입구,49857,52335,102192,5
2021-05-12,2호선,구로디지털단지,63005,63301,126306,5
2021-05-12,2호선,신림,62969,61136,124105,5
2021-05-12,2호선,사당,36449,40169,76618,5
2021-05-12,2호선,강남,84611,83055,167666,5
2021-05-12,2호선,선릉,57618,51306,108924,5
2021-05-12,2호선,잠실(송파구청),65753,65246,130999,5
2021-05-12,분당선,선릉,13690,20406,34096,5
2021-05-12,공항철도 1호선,홍대입구,8997,8908,17905,5
2021-05-12,공항철도 1호선,서울역,6659,6059,12718,5
2021-05-13,1호선,서울역,41919,39554,81473,5
2021-05-13,2호선,잠실(송파구청),65174,64994,130168,5
2021-05-13,2호선,선릉,57149,51562,108711,5
2021-05-13,2호선,강남,84330,83196,167526,5
2021-05-13,2호선,사당,36358,39944,76302,5
2021-05-13,2호선,신림,63143,61175,124318,5
2021-05-13,2호선,구로디지털단지,62445,62547,124992,5
2021-05-13,2호선,홍대입구,50550,52855,103405,5
2021-05-13,3호선,고속터미널,37477,35959,73436,5
2021-05-13,4호선,서울역,10759,15206,25965,5
2021-05-13,4호선,사당,24752,20695,45447,5
2021-05-13,7호선,고속터미널,14981,13006,27987,5
2021-05-13,7호선,가산디지털단지,48180,48671,96851,5
2021-05-13,8호선,잠실(송파구청),13009,15367,28376,5
2021-05-13,9호선,고속터미널,11899,15014,26913,5
2021-05-13,경부선,서울역,4909,1656,6565,5
2021-05-13,경부선,가산디지털단지,18857,22136,40993,5
2021-05-13,경의선,서울역,4337,5364,9701,5
2021-05-13,경의선,홍대입구,1540,1826,3366,5
2021-05-13,경의선,홍대입구,145,110,255,5
2021-05-13,공항철도 1호선,서울역,7220,6545,13765,5
2021-05-13,공항철도 1호선,홍대입구,9069,8971,18040,5
2021-05-13,분당선,선릉,13767,20402,34169,5
2021-05-14,1호선,서울역,46916,45584,92500,5
2021-05-14,4호선,서울역,11294,17408,28702,5
2021-05-14,4호선,사당,26279,22077,48356,5
2021-05-14,7호선,고속터미널,16529,13762,30291,5
2021-05-14,7호선,가산디지털단지,48063,47672,95735,5
2021-05-14,8호선,잠실(송파구청),13927,16672,30599,5
2021-05-14,9호선,고속터미널,13742,18865,32607,5
2021-05-14,경부선,서울역,7108,2412,9520,5
2021-05-14,경부선,가산디지털단지,18982,22091,41073,5
2021-05-14,경의선,서울역,4457,5712,10169,5
2021-05-14,경의선,홍대입구,1898,2180,4078,5
2021-05-14,공항철도 1호선,서울역,8587,8193,16780,5
2021-05-14,공항철도 1호선,홍대입구,10557,10848,21405,5
2021-05-14,분당선,선릉,13980,20656,34636,5
2021-05-14,3호선,고속터미널,45029,46852,91881,5
2021-05-14,2호선,홍대입구,57546,61753,119299,5
2021-05-14,2호선,구로디지털단지,62932,62758,125690,5
2021-05-14,2호선,신림,65077,62470,127547,5
2021-05-14,2호선,사당,38466,42018,80484,5
2021-05-14,2호선,강남,90118,89580,179698,5
2021-05-14,2호선,선릉,57487,51521,109008,5
2021-05-14,2호선,잠실(송파구청),70100,69634,139734,5
2021-05-15,2호선,홍대입구,56950,59996,116946,5
2021-05-15,3호선,고속터미널,45608,45516,91124,5
2021-05-15,4호선,서울역,4700,10722,15422,5
2021-05-15,4호선,사당,18925,16050,34975,5
2021-05-15,7호선,고속터미널,13224,10300,23524,5
2021-05-15,7호선,가산디지털단지,14034,12744,26778,5
2021-05-15,8호선,잠실(송파구청),11751,13592,25343,5
2021-05-15,9호선,고속터미널,11436,16598,28034,5
2021-05-15,경부선,서울역,5392,1702,7094,5
2021-05-15,경부선,가산디지털단지,5607,7807,13414,5
2021-05-15,경의선,서울역,1136,1338,2474,5
2021-05-15,경의선,홍대입구,1728,2091,3819,5
2021-05-15,공항철도 1호선,서울역,6247,6587,12834,5
2021-05-15,공항철도 1호선,홍대입구,10993,11007,22000,5
2021-05-15,분당선,선릉,5094,7858,12952,5
2021-05-15,1호선,서울역,27247,27632,54879,5
2021-05-15,2호선,잠실(송파구청),56906,54351,111257,5
2021-05-15,2호선,선릉,22703,20230,42933,5
2021-05-15,2호선,강남,59335,58005,117340,5
2021-05-15,2호선,사당,27190,29903,57093,5
2021-05-15,2호선,신림,47057,44697,91754,5
2021-05-15,2호선,구로디지털단지,31471,31394,62865,5
2021-05-16,1호선,서울역,22698,19370,42068,5
2021-05-16,2호선,잠실(송파구청),35222,33535,68757,5
2021-05-16,2호선,선릉,10453,9291,19744,5
2021-05-16,2호선,강남,29519,27966,57485,5
2021-05-16,2호선,사당,15913,17722,33635,5
2021-05-16,2호선,신림,29546,29549,59095,5
2021-05-16,2호선,구로디지털단지,18922,18550,37472,5
2021-05-16,2호선,홍대입구,35735,34676,70411,5
2021-05-16,3호선,고속터미널,34301,32132,66433,5
2021-05-16,4호선,서울역,3097,7099,10196,5
2021-05-16,4호선,사당,11422,10431,21853,5
2021-05-16,7호선,고속터미널,10365,6643,17008,5
2021-05-16,7호선,가산디지털단지,8391,7547,15938,5
2021-05-16,8호선,잠실(송파구청),8155,8910,17065,5
2021-05-16,9호선,고속터미널,7970,11277,19247,5
2021-05-16,경부선,서울역,6182,1333,7515,5
2021-05-16,경부선,가산디지털단지,3380,4919,8299,5
2021-05-16,경의선,서울역,856,742,1598,5
2021-05-16,경의선,홍대입구,1128,1462,2590,5
2021-05-16,공항철도 1호선,서울역,6406,5566,11972,5
2021-05-16,공항철도 1호선,홍대입구,7225,6754,13979,5
2021-05-16,분당선,선릉,2441,3498,5939,5
2021-05-17,4호선,사당,23191,19335,42526,5
2021-05-17,3호선,고속터미널,31890,30252,62142,5
2021-05-17,2호선,홍대입구,44750,46399,91149,5
2021-05-17,2호선,구로디지털단지,60961,61311,122272,5
2021-05-17,2호선,신림,60363,58531,118894,5
2021-05-17,2호선,사당,33562,37154,70716,5
2021-05-17,2호선,강남,81498,80403,161901,5
2021-05-17,2호선,선릉,56120,50103,106223,5
2021-05-17,2호선,잠실(송파구청),59050,59671,118721,5
2021-05-17,1호선,서울역,40400,38180,78580,5
2021-05-17,경부선,가산디지털단지,18477,21581,40058,5
2021-05-17,경부선,서울역,5224,1745,6969,5
2021-05-17,9호선,고속터미널,10616,13529,24145,5
2021-05-17,분당선,선릉,13565,20217,33782,5
2021-05-17,공항철도 1호선,홍대입구,7719,7886,15605,5
2021-05-17,공항철도 1호선,서울역,6745,6510,13255,5
2021-05-17,7호선,고속터미널,15202,12661,27863,5
2021-05-17,경의선,홍대입구,1406,1566,2972,5
2021-05-17,경의선,서울역,4179,5214,9393,5
2021-05-17,7호선,가산디지털단지,48045,48599,96644,5
2021-05-17,8호선,잠실(송파구청),12296,14557,26853,5
2021-05-17,4호선,서울역,10527,14298,24825,5
2021-05-18,3호선,고속터미널,40383,40454,80837,5
2021-05-18,경의선,홍대입구,1770,1946,3716,5
2021-05-18,경의선,서울역,4337,5752,10089,5
2021-05-18,공항철도 1호선,서울역,7525,7215,14740,5
2021-05-18,공항철도 1호선,홍대입구,9631,9887,19518,5
2021-05-18,분당선,선릉,14160,21198,35358,5
2021-05-18,경부선,가산디지털단지,19807,22726,42533,5
2021-05-18,경부선,서울역,5618,1972,7590,5
2021-05-18,9호선,고속터미널,12673,16663,29336,5
2021-05-18,8호선,잠실(송파구청),13552,16343,29895,5
2021-05-18,7호선,가산디지털단지,49015,49453,98468,5
2021-05-18,7호선,고속터미널,15906,13781,29687,5
2021-05-18,4호선,사당,26123,22238,48361,5
2021-05-18,4호선,서울역,11096,15994,27090,5
2021-05-18,2호선,구로디지털단지,64234,64459,128693,5
2021-05-18,2호선,신림,65192,63387,128579,5
2021-05-18,2호선,사당,38691,42582,81273,5
2021-05-18,2호선,강남,89897,88316,178213,5
2021-05-18,2호선,선릉,59258,53020,112278,5
2021-05-18,2호선,잠실(송파구청),68456,67587,136043,5
2021-05-18,1호선,서울역,44134,41981,86115,5
2021-05-18,2호선,홍대입구,53131,56604,109735,5
2021-05-19,분당선,선릉,3531,5102,8633,5
2021-05-19,공항철도 1호선,홍대입구,10860,10368,21228,5
2021-05-19,공항철도 1호선,서울역,5714,5249,10963,5
2021-05-19,경의선,홍대입구,1843,2098,3941,5
2021-05-19,경의선,서울역,1224,1265,2489,5
2021-05-19,경부선,가산디지털단지,5437,7174,12611,5
2021-05-19,경부선,서울역,4108,1074,5182,5
2021-05-19,9호선,고속터미널,10858,14394,25252,5
2021-05-19,8호선,잠실(송파구청),11004,12245,23249,5
2021-05-19,7호선,가산디지털단지,13100,12205,25305,5
2021-05-19,7호선,고속터미널,9624,7492,17116,5
2021-05-19,4호선,사당,16738,14882,31620,5
2021-05-19,4호선,서울역,4195,8132,12327,5
2021-05-19,3호선,고속터미널,38233,35633,73866,5
2021-05-19,2호선,홍대입구,55889,57245,113134,5
2021-05-19,2호선,구로디지털단지,28267,27638,55905,5
2021-05-19,2호선,신림,42196,40695,82891,5
2021-05-19,2호선,사당,23952,26692,50644,5
2021-05-19,2호선,강남,40641,39948,80589,5
2021-05-19,2호선,선릉,16262,14475,30737,5
2021-05-19,2호선,잠실(송파구청),52019,49707,101726,5
2021-05-19,1호선,서울역,23655,22224,45879,5
2021-05-20,1호선,서울역,41656,39236,80892,5
2021-05-20,2호선,잠실(송파구청),62157,62059,124216,5
2021-05-20,2호선,선릉,57098,51153,108251,5
2021-05-20,2호선,강남,83257,81001,164258,5
2021-05-20,2호선,사당,34719,38139,72858,5
2021-05-20,2호선,신림,60985,59425,120410,5
2021-05-20,2호선,구로디지털단지,61044,61539,122583,5
2021-05-20,2호선,홍대입구,47967,49063,97030,5
2021-05-20,3호선,고속터미널,36384,34776,71160,5
2021-05-20,4호선,서울역,10499,14881,25380,5
2021-05-20,4호선,사당,23776,20248,44024,5
2021-05-20,경부선,서울역,5124,1639,6763,5
2021-05-20,경부선,가산디지털단지,18346,21230,39576,5
2021-05-20,분당선,선릉,13816,20643,34459,5
2021-05-20,공항철도 1호선,홍대입구,8449,8496,16945,5
2021-05-20,공항철도 1호선,서울역,6785,6227,13012,5
2021-05-20,경의선,서울역,432,97,529,5
2021-05-20,경의선,홍대입구,1497,1749,3246,5
2021-05-20,경의선,서울역,3776,5134,8910,5
2021-05-20,7호선,고속터미널,15160,12570,27730,5
2021-05-20,7호선,가산디지털단지,47769,47613,95382,5
2021-05-20,8호선,잠실(송파구청),12663,14638,27301,5
2021-05-20,9호선,고속터미널,11571,14213,25784,5
2021-05-21,2호선,잠실(송파구청),67840,67357,135197,5
2021-05-21,2호선,선릉,56616,50648,107264,5
2021-05-21,2호선,강남,88365,87196,175561,5
2021-05-21,2호선,사당,40244,40977,81221,5
2021-05-21,분당선,선릉,13849,20569,34418,5
2021-05-21,공항철도 1호선,홍대입구,9794,9858,19652,5
2021-05-21,공항철도 1호선,서울역,8073,7850,15923,5
2021-05-21,경의선,홍대입구,1780,2031,3811,5
2021-05-21,경의선,서울역,4207,5369,9576,5
2021-05-21,경부선,가산디지털단지,18680,21725,40405,5
2021-05-21,경부선,서울역,6549,2293,8842,5
2021-05-21,9호선,고속터미널,12933,17278,30211,5
2021-05-21,8호선,잠실(송파구청),13725,16489,30214,5
2021-05-21,7호선,가산디지털단지,47534,47710,95244,5
2021-05-21,7호선,고속터미널,16785,13994,30779,5
2021-05-21,4호선,사당,23033,21550,44583,5
2021-05-21,4호선,서울역,10759,16944,27703,5
2021-05-21,3호선,고속터미널,42489,44925,87414,5
2021-05-21,2호선,홍대입구,53602,57293,110895,5
2021-05-21,2호선,구로디지털단지,62150,62214,124364,5
2021-05-21,2호선,신림,63905,61634,125539,5
2021-05-21,1호선,서울역,45343,44060,89403,5
2021-05-22,분당선,선릉,5080,7782,12862,5
2021-05-22,공항철도 1호선,홍대입구,12003,11680,23683,5
2021-05-22,공항철도 1호선,서울역,6680,6884,13564,5
2021-05-22,경의선,홍대입구,2011,2353,4364,5
2021-05-22,경의선,서울역,1308,1446,2754,5
2021-05-22,경부선,가산디지털단지,6137,8217,14354,5
2021-05-22,경부선,서울역,5776,1550,7326,5
2021-05-22,9호선,고속터미널,12453,17656,30109,5
2021-05-22,8호선,잠실(송파구청),12045,13838,25883,5
2021-05-22,7호선,가산디지털단지,14899,13774,28673,5
2021-05-22,7호선,고속터미널,13406,10713,24119,5
2021-05-22,4호선,사당,20189,16923,37112,5
2021-05-22,4호선,서울역,4882,11370,16252,5
2021-05-22,3호선,고속터미널,46561,46326,92887,5
2021-05-22,2호선,홍대입구,59823,65000,124823,5
2021-05-22,2호선,구로디지털단지,33083,31922,65005,5
2021-05-22,2호선,신림,48497,46410,94907,5
2021-05-22,2호선,사당,28353,32078,60431,5
2021-05-22,2호선,강남,59531,58745,118276,5
2021-05-22,2호선,선릉,23163,20691,43854,5
2021-05-22,2호선,잠실(송파구청),60196,57466,117662,5
2021-05-22,1호선,서울역,29441,29577,59018,5
2021-05-23,1호선,서울역,25007,21402,46409,5
2021-05-23,2호선,잠실(송파구청),41307,38772,80079,5
2021-05-23,2호선,선릉,11925,10463,22388,5
2021-05-23,2호선,강남,32650,31681,64331,5
2021-05-23,2호선,사당,19393,21717,41110,5
2021-05-23,2호선,신림,34021,33763,67784,5
2021-05-23,2호선,구로디지털단지,21841,21377,43218,5
2021-05-23,2호선,홍대입구,43695,43553,87248,5
2021-05-23,3호선,고속터미널,37673,34530,72203,5
2021-05-23,4호선,서울역,3779,8188,11967,5
2021-05-23,4호선,사당,13480,13041,26521,5
2021-05-23,7호선,고속터미널,12010,7870,19880,5
2021-05-23,7호선,가산디지털단지,10495,9908,20403,5
2021-05-23,8호선,잠실(송파구청),8510,9583,18093,5
2021-05-23,9호선,고속터미널,9951,13008,22959,5
2021-05-23,경부선,서울역,6594,1287,7881,5
2021-05-23,경부선,가산디지털단지,4441,6083,10524,5
2021-05-23,경의선,서울역,1058,907,1965,5
2021-05-23,경의선,홍대입구,1580,1812,3392,5
2021-05-23,공항철도 1호선,서울역,6921,5684,12605,5
2021-05-23,공항철도 1호선,홍대입구,9373,8523,17896,5
2021-05-23,분당선,선릉,2754,3937,6691,5
2021-05-24,공항철도 1호선,홍대입구,8220,8239,16459,5
2021-05-24,공항철도 1호선,서울역,6755,6487,13242,5
2021-05-24,1호선,서울역,41877,39079,80956,5
2021-05-24,2호선,잠실(송파구청),59008,58918,117926,5
2021-05-24,2호선,선릉,56936,51071,108007,5
2021-05-24,2호선,강남,82094,80427,162521,5
2021-05-24,2호선,사당,34523,37921,72444,5
2021-05-24,2호선,신림,61229,59680,120909,5
2021-05-24,2호선,구로디지털단지,62060,62528,124588,5
2021-05-24,2호선,홍대입구,46141,47952,94093,5
2021-05-24,3호선,고속터미널,36258,33961,70219,5
2021-05-24,4호선,서울역,10726,14547,25273,5
2021-05-24,4호선,사당,23331,19878,43209,5
2021-05-24,7호선,고속터미널,15645,12999,28644,5
2021-05-24,7호선,가산디지털단지,49498,49535,99033,5
2021-05-24,8호선,잠실(송파구청),12065,14089,26154,5
2021-05-24,9호선,고속터미널,11298,14159,25457,5
2021-05-24,경부선,서울역,5424,1641,7065,5
2021-05-24,경부선,가산디지털단지,19238,22370,41608,5
2021-05-24,경의선,서울역,4348,5576,9924,5
2021-05-24,경의선,홍대입구,1500,1779,3279,5
2021-05-24,분당선,선릉,13787,20564,34351,5
2021-05-25,1호선,서울역,40757,38088,78845,5
2021-05-25,2호선,잠실(송파구청),61547,61909,123456,5
2021-05-25,2호선,선릉,57539,51529,109068,5
2021-05-25,2호선,강남,82746,81389,164135,5
2021-05-25,2호선,사당,35391,38479,73870,5
2021-05-25,2호선,신림,62810,60734,123544,5
2021-05-25,2호선,구로디지털단지,62135,62541,124676,5
2021-05-25,2호선,홍대입구,45906,47927,93833,5
2021-05-25,3호선,고속터미널,35511,33554,69065,5
2021-05-25,4호선,서울역,10708,14470,25178,5
2021-05-25,4호선,사당,23677,19958,43635,5
2021-05-25,7호선,고속터미널,14430,12825,27255,5
2021-05-25,7호선,가산디지털단지,49026,49784,98810,5
2021-05-25,8호선,잠실(송파구청),12698,14910,27608,5
2021-05-25,9호선,고속터미널,11216,13816,25032,5
2021-05-25,경부선,서울역,4553,1511,6064,5
2021-05-25,경부선,가산디지털단지,18969,22164,41133,5
2021-05-25,경의선,서울역,4275,5332,9607,5
2021-05-25,경의선,홍대입구,1554,1707,3261,5
2021-05-25,공항철도 1호선,서울역,6414,5858,12272,5
2021-05-25,공항철도 1호선,홍대입구,8304,8317,16621,5
2021-05-25,분당선,선릉,13856,20692,34548,5
2021-05-26,1호선,서울역,41601,39055,80656,5
2021-05-26,2호선,잠실(송파구청),64485,64302,128787,5
2021-05-26,2호선,선릉,57607,51557,109164,5
2021-05-26,2호선,강남,82827,81672,164499,5
2021-05-26,2호선,사당,36320,39581,75901,5
2021-05-26,2호선,신림,63030,61431,124461,5
2021-05-26,2호선,구로디지털단지,62478,63149,125627,5
2021-05-26,2호선,홍대입구,48717,50653,99370,5
2021-05-26,3호선,고속터미널,35773,34359,70132,5
2021-05-26,4호선,서울역,10942,14887,25829,5
2021-05-26,4호선,사당,24491,20769,45260,5
2021-05-26,7호선,고속터미널,14900,12885,27785,5
2021-05-26,7호선,가산디지털단지,49109,49238,98347,5
2021-05-26,8호선,잠실(송파구청),12928,15271,28199,5
2021-05-26,9호선,고속터미널,11649,14399,26048,5
2021-05-26,경부선,서울역,4680,1479,6159,5
2021-05-26,경부선,가산디지털단지,19219,22148,41367,5
2021-05-26,경의선,서울역,4348,5586,9934,5
2021-05-26,경의선,홍대입구,1670,1807,3477,5
2021-05-26,공항철도 1호선,서울역,6686,6044,12730,5
2021-05-26,공항철도 1호선,홍대입구,8907,8995,17902,5
2021-05-26,분당선,선릉,13941,20664,34605,5
2021-05-27,1호선,서울역,41013,38410,79423,5
2021-05-27,2호선,잠실(송파구청),61280,61645,122925,5
2021-05-27,2호선,선릉,56436,50665,107101,5
2021-05-27,2호선,강남,81517,80238,161755,5
2021-05-27,2호선,사당,34922,38394,73316,5
2021-05-27,2호선,신림,61572,59397,120969,5
2021-05-27,2호선,구로디지털단지,60966,61109,122075,5
2021-05-27,2호선,홍대입구,46486,48670,95156,5
2021-05-27,3호선,고속터미널,34753,33670,68423,5
2021-05-27,4호선,서울역,10576,14681,25257,5
2021-05-27,4호선,사당,23700,19627,43327,5
2021-05-27,7호선,고속터미널,14434,12426,26860,5
2021-05-27,7호선,가산디지털단지,48226,49203,97429,5
2021-05-27,8호선,잠실(송파구청),12763,15129,27892,5
2021-05-27,9호선,고속터미널,11312,13937,25249,5
2021-05-27,경부선,서울역,4992,1589,6581,5
2021-05-27,경부선,가산디지털단지,18780,21785,40565,5
2021-05-27,경의선,서울역,4126,5143,9269,5
2021-05-27,경의선,홍대입구,1559,1751,3310,5
2021-05-27,공항철도 1호선,서울역,6926,6135,13061,5
2021-05-27,공항철도 1호선,홍대입구,8535,8542,17077,5
2021-05-27,분당선,선릉,13751,20629,34380,5
2021-05-28,분당선,선릉,13458,20382,33840,5
2021-05-28,공항철도 1호선,홍대입구,9703,9759,19462,5
2021-05-28,공항철도 1호선,서울역,8416,8195,16611,5
2021-05-28,경의선,홍대입구,1780,1934,3714,5
2021-05-28,경의선,서울역,4298,5403,9701,5
2021-05-28,경부선,가산디지털단지,18597,21600,40197,5
2021-05-28,경부선,서울역,6677,2323,9000,5
2021-05-28,9호선,고속터미널,12576,16924,29500,5
2021-05-28,8호선,잠실(송파구청),13273,16116,29389,5
2021-05-28,7호선,가산디지털단지,47414,47707,95121,5
2021-05-28,7호선,고속터미널,16484,13930,30414,5
2021-05-28,4호선,사당,24597,20836,45433,5
2021-05-28,4호선,서울역,10689,16963,27652,5
2021-05-28,3호선,고속터미널,40341,43464,83805,5
2021-05-28,2호선,홍대입구,52621,57045,109666,5
2021-05-28,2호선,구로디지털단지,61129,61078,122207,5
2021-05-28,2호선,신림,62782,60452,123234,5
2021-05-28,2호선,사당,36187,39883,76070,5
2021-05-28,2호선,강남,85681,85501,171182,5
2021-05-28,2호선,선릉,55959,49891,105850,5
2021-05-28,2호선,잠실(송파구청),64138,65234,129372,5
2021-05-28,1호선,서울역,45163,44190,89353,5
2021-05-29,2호선,신림,47217,45201,92418,5
2021-05-29,2호선,사당,27615,30668,58283,5
2021-05-29,2호선,강남,57397,57335,114732,5
2021-05-29,2호선,선릉,23361,20634,43995,5
2021-05-29,2호선,잠실(송파구청),56884,54710,111594,5
2021-05-29,1호선,서울역,28044,28464,56508,5
2021-05-29,2호선,구로디지털단지,32501,31706,64207,5
2021-05-29,2호선,홍대입구,57601,61707,119308,5
2021-05-29,3호선,고속터미널,44400,44967,89367,5
2021-05-29,4호선,서울역,4761,10810,15571,5
2021-05-29,4호선,사당,19265,16284,35549,5
2021-05-29,7호선,고속터미널,13148,10588,23736,5
2021-05-29,7호선,가산디지털단지,14424,13241,27665,5
2021-05-29,8호선,잠실(송파구청),11684,13454,25138,5
2021-05-29,9호선,고속터미널,11766,16748,28514,5
2021-05-29,경부선,서울역,5228,1630,6858,5
2021-05-29,경부선,가산디지털단지,6003,7965,13968,5
2021-05-29,경의선,서울역,1218,1391,2609,5
2021-05-29,경의선,홍대입구,1810,2094,3904,5
2021-05-29,공항철도 1호선,서울역,6390,6518,12908,5
2021-05-29,공항철도 1호선,홍대입구,10969,10827,21796,5
2021-05-29,분당선,선릉,5034,7769,12803,5
2021-05-30,분당선,선릉,2703,3983,6686,5
2021-05-30,공항철도 1호선,홍대입구,8892,8269,17161,5
2021-05-30,공항철도 1호선,서울역,6799,5634,12433,5
2021-05-30,경의선,홍대입구,1436,1652,3088,5
2021-05-30,경의선,서울역,969,935,1904,5
2021-05-30,경부선,가산디지털단지,4504,6342,10846,5
2021-05-30,경부선,서울역,6497,1302,7799,5
2021-05-30,9호선,고속터미널,9611,12566,22177,5
2021-05-30,8호선,잠실(송파구청),9258,9880,19138,5
2021-05-30,7호선,가산디지털단지,10671,9749,20420,5
2021-05-30,7호선,고속터미널,11566,7531,19097,5
2021-05-30,4호선,사당,13325,12503,25828,5
2021-05-30,4호선,서울역,3599,8141,11740,5
2021-05-30,3호선,고속터미널,37634,33773,71407,5
2021-05-30,2호선,홍대입구,44553,43056,87609,5
2021-05-30,2호선,구로디지털단지,22173,21592,43765,5
2021-05-30,2호선,신림,35093,34563,69656,5
2021-05-30,2호선,사당,19215,21445,40660,5
2021-05-30,2호선,강남,33132,31630,64762,5
2021-05-30,2호선,선릉,12336,10827,23163,5
2021-05-30,2호선,잠실(송파구청),41905,39050,80955,5
2021-05-30,1호선,서울역,25130,21420,46550,5
2021-05-31,공항철도 1호선,홍대입구,7846,7844,15690,5
2021-05-31,공항철도 1호선,서울역,6568,6084,12652,5
2021-05-31,경의선,홍대입구,1402,1627,3029,5
2021-05-31,경의선,서울역,4287,5389,9676,5
2021-05-31,경부선,가산디지털단지,18848,21594,40442,5
2021-05-31,경부선,서울역,5134,1592,6726,5
2021-05-31,9호선,고속터미널,10952,13380,24332,5
2021-05-31,8호선,잠실(송파구청),12252,14474,26726,5
2021-05-31,7호선,가산디지털단지,48159,48829,96988,5
2021-05-31,7호선,고속터미널,15135,12524,27659,5
2021-05-31,4호선,사당,22537,19061,41598,5
2021-05-31,4호선,서울역,10323,13975,24298,5
2021-05-31,3호선,고속터미널,34585,32400,66985,5
2021-05-31,2호선,홍대입구,43353,45118,88471,5
2021-05-31,2호선,구로디지털단지,60730,61096,121826,5
2021-05-31,2호선,신림,60486,58828,119314,5
2021-05-31,2호선,사당,33101,36236,69337,5
2021-05-31,2호선,강남,77677,76332,154009,5
2021-05-31,2호선,선릉,56192,50455,106647,5
2021-05-31,2호선,잠실(송파구청),59098,59779,118877,5
2021-05-31,1호선,서울역,40264,37649,77913,5
2021-05-31,분당선,선릉,13618,20164,33782,5
2021-06-01,3호선,고속터미널,33986,32532,66518,6
2021-06-01,2호선,강남,79921,78691,158612,6
2021-06-01,2호선,사당,34614,37869,72483,6
2021-06-01,2호선,신림,61491,59987,121478,6
2021-06-01,9호선,고속터미널,11119,13452,24571,6
2021-06-01,2호선,잠실(송파구청),60347,60502,120849,6
2021-06-01,2호선,선릉,57567,51093,108660,6
2021-06-01,2호선,구로디지털단지,61740,62208,123948,6
2021-06-01,4호선,서울역,10660,13912,24572,6
2021-06-01,4호선,사당,23419,19751,43170,6
2021-06-01,7호선,고속터미널,14342,12761,27103,6
2021-06-01,7호선,가산디지털단지,48775,49238,98013,6
2021-06-01,2호선,홍대입구,45255,47425,92680,6
2021-06-01,8호선,잠실(송파구청),12347,14575,26922,6
2021-06-01,경부선,서울역,4296,1414,5710,6
2021-06-01,경부선,가산디지털단지,19033,21987,41020,6
2021-06-01,경의선,서울역,4263,5355,9618,6
2021-06-01,경의선,홍대입구,1514,1702,3216,6
2021-06-01,공항철도 1호선,서울역,6019,5676,11695,6
2021-06-01,공항철도 1호선,홍대입구,7983,7984,15967,6
2021-06-01,분당선,선릉,13642,20744,34386,6
2021-06-01,1호선,서울역,39859,37520,77379,6
2021-06-02,2호선,홍대입구,46782,48734,95516,6
2021-06-02,2호선,구로디지털단지,61899,62292,124191,6
2021-06-02,2호선,신림,61919,60184,122103,6
2021-06-02,2호선,사당,35643,38651,74294,6
2021-06-02,2호선,강남,80014,78603,158617,6
2021-06-02,2호선,선릉,57082,51263,108345,6
2021-06-02,2호선,잠실(송파구청),62118,62269,124387,6
2021-06-02,1호선,서울역,40701,38207,78908,6
2021-06-02,4호선,서울역,10572,14354,24926,6
2021-06-02,4호선,사당,23961,19910,43871,6
2021-06-02,7호선,고속터미널,14281,12484,26765,6
2021-06-02,7호선,가산디지털단지,48695,49028,97723,6
2021-06-02,8호선,잠실(송파구청),12886,15197,28083,6
2021-06-02,9호선,고속터미널,11270,13872,25142,6
2021-06-02,경부선,서울역,4259,1505,5764,6
2021-06-02,경부선,가산디지털단지,18899,21866,40765,6
2021-06-02,경의선,서울역,4155,5340,9495,6
2021-06-02,경의선,홍대입구,1540,1763,3303,6
2021-06-02,공항철도 1호선,서울역,6458,5974,12432,6
2021-06-02,공항철도 1호선,홍대입구,8618,8497,17115,6
2021-06-02,분당선,선릉,13822,20574,34396,6
2021-06-02,3호선,고속터미널,34811,33027,67838,6
2021-06-03,2호선,홍대입구,44548,45665,90213,6
2021-06-03,2호선,구로디지털단지,61227,61130,122357,6
2021-06-03,2호선,신림,59687,58279,117966,6
2021-06-03,2호선,사당,33941,36705,70646,6
2021-06-03,2호선,강남,80656,77871,158527,6
2021-06-03,2호선,선릉,56423,50381,106804,6
2021-06-03,2호선,잠실(송파구청),59354,59732,119086,6
2021-06-03,1호선,서울역,40557,38110,78667,6
2021-06-03,3호선,고속터미널,34748,33407,68155,6
2021-06-03,4호선,서울역,10431,14398,24829,6
2021-06-03,4호선,사당,23270,19377,42647,6
2021-06-03,7호선,고속터미널,14151,12499,26650,6
2021-06-03,7호선,가산디지털단지,49786,48259,98045,6
2021-06-03,8호선,잠실(송파구청),12966,14682,27648,6
2021-06-03,9호선,고속터미널,10548,13277,23825,6
2021-06-03,경부선,서울역,4669,1576,6245,6
2021-06-03,경부선,가산디지털단지,18292,21767,40059,6
2021-06-03,경의선,서울역,4054,5201,9255,6
2021-06-03,경의선,홍대입구,1410,1670,3080,6
2021-06-03,공항철도 1호선,서울역,6624,6081,12705,6
2021-06-03,공항철도 1호선,홍대입구,7668,7847,15515,6
2021-06-03,분당선,선릉,14024,20287,34311,6
2021-06-04,1호선,서울역,46128,44015,90143,6
2021-06-04,2호선,잠실(송파구청),67425,67294,134719,6
2021-06-04,2호선,선릉,56940,51070,108010,6
2021-06-04,2호선,강남,87514,86634,174148,6
2021-06-04,2호선,사당,37851,41807,79658,6
2021-06-04,2호선,신림,64578,62030,126608,6
2021-06-04,2호선,구로디지털단지,63105,62680,125785,6
2021-06-04,2호선,홍대입구,54391,58269,112660,6
2021-06-04,3호선,고속터미널,42830,46166,88996,6
2021-06-04,4호선,서울역,10850,16962,27812,6
2021-06-04,4호선,사당,25774,21466,47240,6
2021-06-04,7호선,고속터미널,16682,14277,30959,6
2021-06-04,7호선,가산디지털단지,48175,48241,96416,6
2021-06-04,8호선,잠실(송파구청),13983,16725,30708,6
2021-06-04,9호선,고속터미널,13335,18230,31565,6
2021-06-04,경부선,서울역,6288,2258,8546,6
2021-06-04,경부선,가산디지털단지,18796,22238,41034,6
2021-06-04,경의선,서울역,4321,5590,9911,6
2021-06-04,경의선,홍대입구,1846,2149,3995,6
2021-06-04,공항철도 1호선,서울역,8338,8065,16403,6
2021-06-04,공항철도 1호선,홍대입구,10157,10209,20366,6
2021-06-04,분당선,선릉,13855,20526,34381,6
2021-06-05,7호선,가산디지털단지,15056,14040,29096,6
2021-06-05,7호선,고속터미널,13105,10753,23858,6
2021-06-05,8호선,잠실(송파구청),11217,13241,24458,6
2021-06-05,1호선,서울역,28250,28352,56602,6
2021-06-05,4호선,사당,19553,16367,35920,6
2021-06-05,4호선,서울역,4873,11058,15931,6
2021-06-05,3호선,고속터미널,44730,45180,89910,6
2021-06-05,2호선,홍대입구,58931,63687,122618,6
2021-06-05,2호선,구로디지털단지,33148,32157,65305,6
2021-06-05,2호선,신림,48665,46427,95092,6
2021-06-05,2호선,사당,28289,31610,59899,6
2021-06-05,2호선,강남,56876,56592,113468,6
2021-06-05,2호선,선릉,23331,20690,44021,6
2021-06-05,2호선,잠실(송파구청),56063,53851,109914,6
2021-06-05,9호선,고속터미널,12398,17344,29742,6
2021-06-05,경부선,서울역,5413,1625,7038,6
2021-06-05,경부선,가산디지털단지,6141,8248,14389,6
2021-06-05,경의선,서울역,1237,1372,2609,6
2021-06-05,경의선,홍대입구,2001,2350,4351,6
2021-06-05,분당선,선릉,5105,7685,12790,6
2021-06-05,공항철도 1호선,서울역,6465,6593,13058,6
2021-06-05,공항철도 1호선,홍대입구,11634,11207,22841,6
2021-06-06,1호선,서울역,23747,20893,44640,6
2021-06-06,2호선,잠실(송파구청),39359,37109,76468,6
2021-06-06,2호선,선릉,11776,10188,21964,6
2021-06-06,2호선,강남,31080,29926,61006,6
2021-06-06,2호선,사당,19377,21625,41002,6
2021-06-06,2호선,신림,34304,33768,68072,6
2021-06-06,2호선,구로디지털단지,21734,21525,43259,6
2021-06-06,2호선,홍대입구,43137,42995,86132,6
2021-06-06,3호선,고속터미널,36585,33197,69782,6
2021-06-06,4호선,서울역,3616,7867,11483,6
2021-06-06,4호선,사당,13340,12465,25805,6
2021-06-06,7호선,고속터미널,11085,7218,18303,6
2021-06-06,7호선,가산디지털단지,10486,9866,20352,6
2021-06-06,8호선,잠실(송파구청),8428,9354,17782,6
2021-06-06,9호선,고속터미널,9763,12687,22450,6
2021-06-06,경부선,서울역,6223,1255,7478,6
2021-06-06,경부선,가산디지털단지,4405,6091,10496,6
2021-06-06,경의선,서울역,985,900,1885,6
2021-06-06,경의선,홍대입구,1472,1718,3190,6
2021-06-06,공항철도 1호선,서울역,6422,5496,11918,6
2021-06-06,공항철도 1호선,홍대입구,9056,8343,17399,6
2021-06-06,분당선,선릉,2649,3889,6538,6
2021-06-07,8호선,잠실(송파구청),12279,14502,26781,6
2021-06-07,2호선,신림,60747,59271,120018,6
2021-06-07,2호선,구로디지털단지,61340,61414,122754,6
2021-06-07,7호선,고속터미널,15658,12997,28655,6
2021-06-07,분당선,선릉,13508,20140,33648,6
2021-06-07,공항철도 1호선,홍대입구,7866,7925,15791,6
2021-06-07,공항철도 1호선,서울역,6754,6181,12935,6
2021-06-07,경의선,홍대입구,1470,1638,3108,6
2021-06-07,경의선,서울역,4312,5291,9603,6
2021-06-07,경부선,가산디지털단지,18838,21651,40489,6
2021-06-07,경부선,서울역,5198,1618,6816,6
2021-06-07,9호선,고속터미널,11062,13726,24788,6
2021-06-07,2호선,홍대입구,44494,46133,90627,6
2021-06-07,7호선,가산디지털단지,48275,48527,96802,6
2021-06-07,1호선,서울역,40235,37625,77860,6
2021-06-07,2호선,잠실(송파구청),59614,59895,119509,6
2021-06-07,2호선,선릉,55574,49735,105309,6
2021-06-07,2호선,강남,78777,77461,156238,6
2021-06-07,2호선,사당,33459,36823,70282,6
2021-06-07,3호선,고속터미널,35064,32926,67990,6
2021-06-07,4호선,서울역,10222,13944,24166,6
2021-06-07,4호선,사당,22968,19390,42358,6
2021-06-08,7호선,고속터미널,14474,12544,27018,6
2021-06-08,7호선,가산디지털단지,48868,49227,98095,6
2021-06-08,8호선,잠실(송파구청),12624,14874,27498,6
2021-06-08,9호선,고속터미널,11127,13702,24829,6
2021-06-08,경부선,서울역,4599,1517,6116,6
2021-06-08,경부선,가산디지털단지,19001,22104,41105,6
2021-06-08,경의선,서울역,4306,5538,9844,6
2021-06-08,경의선,홍대입구,1581,1756,3337,6
2021-06-08,공항철도 1호선,서울역,6516,5983,12499,6
2021-06-08,공항철도 1호선,홍대입구,8120,8036,16156,6
2021-06-08,분당선,선릉,13893,20712,34605,6
2021-06-08,1호선,서울역,40452,38127,78579,6
2021-06-08,2호선,잠실(송파구청),61676,61793,123469,6
2021-06-08,2호선,선릉,57366,51087,108453,6
2021-06-08,2호선,강남,80837,78776,159613,6
2021-06-08,2호선,사당,35198,38092,73290,6
2021-06-08,2호선,신림,61791,60161,121952,6
2021-06-08,2호선,구로디지털단지,61815,61967,123782,6
2021-06-08,2호선,홍대입구,46972,48642,95614,6
2021-06-08,3호선,고속터미널,34952,33347,68299,6
2021-06-08,4호선,서울역,10517,14058,24575,6
2021-06-08,4호선,사당,23507,20011,43518,6
2021-06-09,1호선,서울역,40581,38305,78886,6
2021-06-09,2호선,잠실(송파구청),63022,62908,125930,6
2021-06-09,2호선,선릉,57615,51033,108648,6
2021-06-09,2호선,강남,80926,79202,160128,6
2021-06-09,2호선,사당,35298,38454,73752,6
2021-06-09,2호선,신림,61599,59892,121491,6
2021-06-09,2호선,구로디지털단지,61944,62286,124230,6
2021-06-09,2호선,홍대입구,47468,49421,96889,6
2021-06-09,3호선,고속터미널,35638,33834,69472,6
2021-06-09,4호선,서울역,10481,14345,24826,6
2021-06-09,4호선,사당,24103,20113,44216,6
2021-06-09,7호선,고속터미널,14241,12630,26871,6
2021-06-09,7호선,가산디지털단지,48350,48878,97228,6
2021-06-09,8호선,잠실(송파구청),13107,15126,28233,6
2021-06-09,9호선,고속터미널,11487,14212,25699,6
2021-06-09,경부선,서울역,4627,1509,6136,6
2021-06-09,경부선,가산디지털단지,18945,21764,40709,6
2021-06-09,경의선,서울역,4343,5443,9786,6
2021-06-09,경의선,홍대입구,1623,1769,3392,6
2021-06-09,공항철도 1호선,서울역,6631,6055,12686,6
2021-06-09,공항철도 1호선,홍대입구,8579,8561,17140,6
2021-06-09,분당선,선릉,13723,20387,34110,6
2021-06-10,분당선,선릉,13795,20445,34240,6
2021-06-10,공항철도 1호선,홍대입구,8403,8330,16733,6
2021-06-10,공항철도 1호선,서울역,7076,6297,13373,6
2021-06-10,경의선,홍대입구,1586,1791,3377,6
2021-06-10,경의선,서울역,4285,5436,9721,6
2021-06-10,경부선,가산디지털단지,18531,21656,40187,6
2021-06-10,경부선,서울역,5053,1681,6734,6
2021-06-10,9호선,고속터미널,11451,14377,25828,6
2021-06-10,8호선,잠실(송파구청),13132,15071,28203,6
2021-06-10,7호선,가산디지털단지,48863,48286,97149,6
2021-06-10,7호선,고속터미널,14940,12994,27934,6
2021-06-10,1호선,서울역,41153,39043,80196,6
2021-06-10,2호선,잠실(송파구청),62300,62111,124411,6
2021-06-10,2호선,선릉,57340,51020,108360,6
2021-06-10,2호선,강남,81554,78822,160376,6
2021-06-10,2호선,사당,35189,38132,73321,6
2021-06-10,2호선,신림,62088,60564,122652,6
2021-06-10,2호선,구로디지털단지,62001,61932,123933,6
2021-06-10,2호선,홍대입구,48649,49700,98349,6
2021-06-10,3호선,고속터미널,36493,35075,71568,6
2021-06-10,4호선,서울역,10797,15020,25817,6
2021-06-10,4호선,사당,23756,19742,43498,6
2021-06-11,2호선,구로디지털단지,61083,60364,121447,6
2021-06-11,2호선,홍대입구,51313,55162,106475,6
2021-06-11,분당선,선릉,13364,19794,33158,6
2021-06-11,공항철도 1호선,홍대입구,9398,9476,18874,6
2021-06-11,공항철도 1호선,서울역,8445,8850,17295,6
2021-06-11,경의선,홍대입구,1747,1916,3663,6
2021-06-11,경의선,서울역,4324,5347,9671,6
2021-06-11,경부선,가산디지털단지,18403,21245,39648,6
2021-06-11,경부선,서울역,6498,2223,8721,6
2021-06-11,9호선,고속터미널,12441,17229,29670,6
2021-06-11,8호선,잠실(송파구청),13144,15646,28790,6
2021-06-11,7호선,가산디지털단지,47025,46791,93816,6
2021-06-11,7호선,고속터미널,16330,13597,29927,6
2021-06-11,4호선,사당,24507,20355,44862,6
2021-06-11,4호선,서울역,10182,16349,26531,6
2021-06-11,3호선,고속터미널,41101,44130,85231,6
2021-06-11,1호선,서울역,44815,43301,88116,6
2021-06-11,2호선,잠실(송파구청),64209,64164,128373,6
2021-06-11,2호선,선릉,55501,49482,104983,6
2021-06-11,2호선,강남,83659,83178,166837,6
2021-06-11,2호선,사당,36218,39162,75380,6
2021-06-11,2호선,신림,62512,59742,122254,6
2021-06-12,7호선,고속터미널,12592,10388,22980,6
2021-06-12,7호선,가산디지털단지,14606,13336,27942,6
2021-06-12,8호선,잠실(송파구청),11420,13068,24488,6
2021-06-12,9호선,고속터미널,11848,16851,28699,6
2021-06-12,경부선,서울역,5256,1554,6810,6
2021-06-12,경부선,가산디지털단지,5963,8004,13967,6
2021-06-12,경의선,서울역,1188,1367,2555,6
2021-06-12,경의선,홍대입구,1793,1989,3782,6
2021-06-12,경의선,홍대입구,127,133,260,6
2021-06-12,공항철도 1호선,서울역,6216,6617,12833,6
2021-06-12,공항철도 1호선,홍대입구,11153,10989,22142,6
2021-06-12,분당선,선릉,4868,7346,12214,6
2021-06-12,4호선,사당,18960,16055,35015,6
2021-06-12,4호선,서울역,4855,10442,15297,6
2021-06-12,3호선,고속터미널,44929,45085,90014,6
2021-06-12,2호선,홍대입구,57136,60844,117980,6
2021-06-12,2호선,구로디지털단지,32570,31533,64103,6
2021-06-12,2호선,신림,47447,45141,92588,6
2021-06-12,2호선,사당,27258,29970,57228,6
2021-06-12,2호선,강남,56795,56496,113291,6
2021-06-12,2호선,선릉,22137,19704,41841,6
2021-06-12,2호선,잠실(송파구청),55843,53320,109163,6
2021-06-12,1호선,서울역,27023,27278,54301,6
2021-06-13,1호선,서울역,23497,20550,44047,6
2021-06-13,2호선,잠실(송파구청),40920,38358,79278,6
2021-06-13,2호선,선릉,11788,10272,22060,6
2021-06-13,2호선,강남,31573,30315,61888,6
2021-06-13,2호선,사당,18685,21031,39716,6
2021-06-13,2호선,신림,33721,33124,66845,6
2021-06-13,2호선,구로디지털단지,21218,20769,41987,6
2021-06-13,2호선,홍대입구,40715,40697,81412,6
2021-06-13,3호선,고속터미널,36825,33269,70094,6
2021-06-13,4호선,서울역,3528,7748,11276,6
2021-06-13,4호선,사당,13058,12126,25184,6
2021-06-13,7호선,고속터미널,11050,7268,18318,6
2021-06-13,7호선,가산디지털단지,10386,9671,20057,6
2021-06-13,8호선,잠실(송파구청),8574,9494,18068,6
2021-06-13,9호선,고속터미널,9446,12169,21615,6
2021-06-13,경부선,서울역,6068,1394,7462,6
2021-06-13,경부선,가산디지털단지,4274,6098,10372,6
2021-06-13,경의선,서울역,981,836,1817,6
2021-06-13,경의선,홍대입구,1384,1576,2960,6
2021-06-13,공항철도 1호선,서울역,6638,5356,11994,6
2021-06-13,공항철도 1호선,홍대입구,8359,7878,16237,6
2021-06-13,분당선,선릉,2570,3800,6370,6
2021-06-14,분당선,선릉,13498,20126,33624,6
2021-06-14,공항철도 1호선,홍대입구,8172,8270,16442,6
2021-06-14,공항철도 1호선,서울역,6865,6260,13125,6
2021-06-14,경의선,홍대입구,1527,1643,3170,6
2021-06-14,경의선,서울역,4238,5481,9719,6
2021-06-14,경부선,가산디지털단지,18782,21662,40444,6
2021-06-14,경부선,서울역,5508,1697,7205,6
2021-06-14,9호선,고속터미널,11584,14448,26032,6
2021-06-14,8호선,잠실(송파구청),12239,14316,26555,6
2021-06-14,7호선,가산디지털단지,47928,48255,96183,6
2021-06-14,7호선,고속터미널,15763,13117,28880,6
2021-06-14,4호선,사당,23027,19454,42481,6
2021-06-14,4호선,서울역,10310,14048,24358,6
2021-06-14,3호선,고속터미널,37603,35333,72936,6
2021-06-14,2호선,홍대입구,46796,48247,95043,6
2021-06-14,2호선,구로디지털단지,61142,61444,122586,6
2021-06-14,2호선,신림,60670,59305,119975,6
2021-06-14,2호선,사당,33716,37082,70798,6
2021-06-14,2호선,강남,79342,78241,157583,6
2021-06-14,2호선,선릉,56137,50174,106311,6
2021-06-14,2호선,잠실(송파구청),58190,58250,116440,6
2021-06-14,1호선,서울역,41095,38464,79559,6
2021-06-15,2호선,잠실(송파구청),62256,62058,124314,6
2021-06-15,1호선,서울역,40401,38002,78403,6
2021-06-15,9호선,고속터미널,11159,14199,25358,6
2021-06-15,3호선,고속터미널,35905,34158,70063,6
2021-06-15,8호선,잠실(송파구청),12666,14986,27652,6
2021-06-15,7호선,가산디지털단지,47850,48480,96330,6
2021-06-15,7호선,고속터미널,15041,12989,28030,6
2021-06-15,4호선,서울역,10464,14194,24658,6
2021-06-15,4호선,사당,23354,19619,42973,6
2021-06-15,2호선,선릉,56258,50314,106572,6
2021-06-15,2호선,홍대입구,46827,48661,95488,6
2021-06-15,2호선,구로디지털단지,61573,61967,123540,6
2021-06-15,2호선,신림,61145,59217,120362,6
2021-06-15,2호선,사당,34708,37845,72553,6
2021-06-15,2호선,강남,80554,79142,159696,6
2021-06-15,분당선,선릉,13821,20168,33989,6
2021-06-15,공항철도 1호선,홍대입구,8248,8262,16510,6
2021-06-15,공항철도 1호선,서울역,6620,6032,12652,6
2021-06-15,경의선,홍대입구,1536,1643,3179,6
2021-06-15,경의선,서울역,4162,5116,9278,6
2021-06-15,경부선,가산디지털단지,18673,21690,40363,6
2021-06-15,경부선,서울역,4839,1561,6400,6
2021-06-16,경의선,홍대입구,1664,1854,3518,6
2021-06-16,경의선,서울역,88,174,262,6
2021-06-16,2호선,홍대입구,50560,52616,103176,6
2021-06-16,2호선,구로디지털단지,62316,62403,124719,6
2021-06-16,2호선,신림,62603,60898,123501,6
2021-06-16,2호선,사당,36221,39188,75409,6
2021-06-16,2호선,강남,82746,81027,163773,6
2021-06-16,2호선,선릉,56973,50805,107778,6
2021-06-16,2호선,잠실(송파구청),65722,65561,131283,6
2021-06-16,1호선,서울역,41406,39275,80681,6
2021-06-16,공항철도 1호선,서울역,6846,6217,13063,6
2021-06-16,공항철도 1호선,홍대입구,9014,8868,17882,6
2021-06-16,분당선,선릉,13667,20299,33966,6
2021-06-16,경부선,가산디지털단지,18948,21731,40679,6
2021-06-16,경부선,서울역,4864,1603,6467,6
2021-06-16,7호선,가산디지털단지,48200,48252,96452,6
2021-06-16,7호선,고속터미널,14884,13051,27935,6
2021-06-16,9호선,고속터미널,12161,15118,27279,6
2021-06-16,8호선,잠실(송파구청),13290,15758,29048,6
2021-06-16,4호선,사당,24112,20549,44661,6
2021-06-16,4호선,서울역,10651,14811,25462,6
2021-06-16,3호선,고속터미널,37949,36251,74200,6
2021-06-16,경의선,서울역,4243,5211,9454,6
2021-06-17,공항철도 1호선,홍대입구,8983,9205,18188,6
2021-06-17,공항철도 1호선,서울역,7384,6631,14015,6
2021-06-17,경의선,홍대입구,1594,1835,3429,6
2021-06-17,경의선,서울역,4347,5335,9682,6
2021-06-17,3호선,고속터미널,37685,36706,74391,6
2021-06-17,1호선,서울역,43105,40596,83701,6
2021-06-17,7호선,가산디지털단지,48121,48414,96535,6
2021-06-17,7호선,고속터미널,15402,13281,28683,6
2021-06-17,9호선,고속터미널,11865,15108,26973,6
2021-06-17,경부선,서울역,5004,1677,6681,6
2021-06-17,경부선,가산디지털단지,18807,21880,40687,6
2021-06-17,8호선,잠실(송파구청),13503,15872,29375,6
2021-06-17,4호선,사당,24137,20441,44578,6
2021-06-17,2호선,홍대입구,51936,53713,105649,6
2021-06-17,2호선,구로디지털단지,62423,62653,125076,6
2021-06-17,2호선,신림,62059,60270,122329,6
2021-06-17,2호선,사당,35804,38854,74658,6
2021-06-17,2호선,강남,84211,81964,166175,6
2021-06-17,2호선,선릉,57089,50966,108055,6
2021-06-17,2호선,잠실(송파구청),65445,65089,130534,6
2021-06-17,4호선,서울역,10771,15476,26247,6
2021-06-17,분당선,선릉,13792,20558,34350,6
2021-06-18,7호선,고속터미널,17122,14382,31504,6
2021-06-18,7호선,가산디지털단지,46920,47102,94022,6
2021-06-18,8호선,잠실(송파구청),13670,16467,30137,6
2021-06-18,9호선,고속터미널,13090,17989,31079,6
2021-06-18,경부선,서울역,6980,2439,9419,6
2021-06-18,경부선,가산디지털단지,18474,21335,39809,6
2021-06-18,경의선,서울역,4189,5326,9515,6
2021-06-18,경의선,홍대입구,1820,2008,3828,6
2021-06-18,경의선,서울역,87,87,174,6
2021-06-18,분당선,선릉,13287,19825,33112,6
2021-06-18,공항철도 1호선,홍대입구,10149,10079,20228,6
2021-06-18,공항철도 1호선,서울역,8395,8079,16474,6
2021-06-18,1호선,서울역,45606,44328,89934,6
2021-06-18,2호선,잠실(송파구청),67116,67477,134593,6
2021-06-18,2호선,선릉,55042,49611,104653,6
2021-06-18,2호선,강남,87447,86984,174431,6
2021-06-18,2호선,사당,36880,40409,77289,6
2021-06-18,2호선,신림,63767,60748,124515,6
2021-06-18,2호선,구로디지털단지,61760,61394,123154,6
2021-06-18,2호선,홍대입구,54991,59448,114439,6
2021-06-18,3호선,고속터미널,43335,47122,90457,6
2021-06-18,4호선,서울역,10617,17508,28125,6
2021-06-18,4호선,사당,25091,20782,45873,6
2021-06-19,3호선,고속터미널,47769,48093,95862,6
2021-06-19,2호선,홍대입구,60826,66128,126954,6
2021-06-19,2호선,구로디지털단지,33556,32737,66293,6
2021-06-19,2호선,신림,49051,46302,95353,6
2021-06-19,2호선,사당,28726,31747,60473,6
2021-06-19,2호선,강남,60951,60877,121828,6
2021-06-19,2호선,선릉,23123,20470,43593,6
2021-06-19,2호선,잠실(송파구청),60164,58033,118197,6
2021-06-19,1호선,서울역,29249,29408,58657,6
2021-06-19,7호선,고속터미널,13765,11310,25075,6
2021-06-19,7호선,가산디지털단지,14823,13611,28434,6
2021-06-19,8호선,잠실(송파구청),11789,13912,25701,6
2021-06-19,9호선,고속터미널,12524,17807,30331,6
2021-06-19,경부선,서울역,5673,1661,7334,6
2021-06-19,경부선,가산디지털단지,6177,8224,14401,6
2021-06-19,4호선,사당,19598,16830,36428,6
2021-06-19,4호선,서울역,5190,11784,16974,6
2021-06-19,분당선,선릉,5000,7784,12784,6
2021-06-19,공항철도 1호선,홍대입구,12042,11766,23808,6
2021-06-19,공항철도 1호선,서울역,6862,6963,13825,6
2021-06-19,경의선,서울역,1247,1428,2675,6
2021-06-19,경의선,홍대입구,2074,2261,4335,6
2021-06-20,1호선,서울역,25575,22481,48056,6
2021-06-20,2호선,잠실(송파구청),43987,41299,85286,6
2021-06-20,2호선,선릉,11993,10424,22417,6
2021-06-20,2호선,강남,34348,33419,67767,6
2021-06-20,2호선,사당,19308,21589,40897,6
2021-06-20,2호선,신림,34705,34630,69335,6
2021-06-20,2호선,구로디지털단지,22269,21813,44082,6
2021-06-20,2호선,홍대입구,44599,44549,89148,6
2021-06-20,분당선,선릉,2621,3853,6474,6
2021-06-20,공항철도 1호선,홍대입구,9327,8519,17846,6
2021-06-20,공항철도 1호선,서울역,6932,5819,12751,6
2021-06-20,경의선,홍대입구,1421,1603,3024,6
2021-06-20,경의선,서울역,1036,924,1960,6
2021-06-20,경부선,가산디지털단지,4459,6301,10760,6
2021-06-20,경부선,서울역,6605,1380,7985,6
2021-06-20,9호선,고속터미널,10234,12890,23124,6
2021-06-20,8호선,잠실(송파구청),9096,10330,19426,6
2021-06-20,7호선,가산디지털단지,10394,9698,20092,6
2021-06-20,7호선,고속터미널,12087,7587,19674,6
2021-06-20,4호선,사당,13369,12700,26069,6
2021-06-20,4호선,서울역,3648,8548,12196,6
2021-06-20,3호선,고속터미널,39515,35509,75024,6
2021-06-21,공항철도 1호선,서울역,7324,6762,14086,6
2021-06-21,공항철도 1호선,홍대입구,9185,9184,18369,6
2021-06-21,분당선,선릉,13720,20225,33945,6
2021-06-21,7호선,고속터미널,16405,13352,29757,6
2021-06-21,7호선,가산디지털단지,48841,49321,98162,6
2021-06-21,8호선,잠실(송파구청),13210,15556,28766,6
2021-06-21,9호선,고속터미널,11939,15021,26960,6
2021-06-21,경부선,서울역,6148,1857,8005,6
2021-06-21,경부선,가산디지털단지,19044,22101,41145,6
2021-06-21,경의선,서울역,4437,5558,9995,6
2021-06-21,경의선,홍대입구,1631,1716,3347,6
2021-06-21,1호선,서울역,42934,40646,83580,6
2021-06-21,2호선,잠실(송파구청),65663,66107,131770,6
2021-06-21,2호선,선릉,56946,50942,107888,6
2021-06-21,2호선,강남,84837,83553,168390,6
2021-06-21,2호선,사당,34524,38072,72596,6
2021-06-21,2호선,신림,61663,60322,121985,6
2021-06-21,2호선,구로디지털단지,62470,62816,125286,6
2021-06-21,2호선,홍대입구,51366,53269,104635,6
2021-06-21,3호선,고속터미널,35522,32772,68294,6
2021-06-21,4호선,서울역,10727,15145,25872,6
2021-06-21,4호선,사당,23640,20010,43650,6
2021-06-22,1호선,서울역,42754,40373,83127,6
2021-06-22,2호선,잠실(송파구청),67538,67257,134795,6
2021-06-22,2호선,선릉,58414,51997,110411,6
2021-06-22,2호선,강남,87422,85968,173390,6
2021-06-22,2호선,사당,36329,39301,75630,6
2021-06-22,2호선,신림,62583,60951,123534,6
2021-06-22,2호선,구로디지털단지,63128,63576,126704,6
2021-06-22,2호선,홍대입구,51840,53550,105390,6
2021-06-22,3호선,고속터미널,39902,37886,77788,6
2021-06-22,4호선,서울역,10765,15391,26156,6
2021-06-22,4호선,사당,24554,20373,44927,6
2021-06-22,7호선,고속터미널,15753,13571,29324,6
2021-06-22,7호선,가산디지털단지,49388,49477,98865,6
2021-06-22,8호선,잠실(송파구청),13431,15722,29153,6
2021-06-22,9호선,고속터미널,12267,15753,28020,6
2021-06-22,경부선,서울역,5054,1633,6687,6
2021-06-22,경부선,가산디지털단지,19141,22301,41442,6
2021-06-22,경의선,서울역,4263,5434,9697,6
2021-06-22,경의선,홍대입구,1697,1847,3544,6
2021-06-22,공항철도 1호선,서울역,7175,6517,13692,6
2021-06-22,공항철도 1호선,홍대입구,9607,9513,19120,6
2021-06-22,분당선,선릉,14269,21103,35372,6
2021-06-23,1호선,서울역,43450,41207,84657,6
2021-06-23,2호선,잠실(송파구청),66513,66453,132966,6
2021-06-23,2호선,선릉,57719,51354,109073,6
2021-06-23,2호선,강남,86761,84705,171466,6
2021-06-23,2호선,사당,36205,39415,75620,6
2021-06-23,2호선,신림,62595,60965,123560,6
2021-06-23,2호선,구로디지털단지,62921,63033,125954,6
2021-06-23,2호선,홍대입구,51992,54007,105999,6
2021-06-23,3호선,고속터미널,38865,37280,76145,6
2021-06-23,4호선,서울역,10906,15635,26541,6
2021-06-23,4호선,사당,24490,20442,44932,6
2021-06-23,7호선,고속터미널,15423,13225,28648,6
2021-06-23,7호선,가산디지털단지,49254,49110,98364,6
2021-06-23,8호선,잠실(송파구청),13577,16045,29622,6
2021-06-23,9호선,고속터미널,12244,15617,27861,6
2021-06-23,경부선,서울역,5445,1739,7184,6
2021-06-23,경부선,가산디지털단지,18949,21967,40916,6
2021-06-23,경의선,서울역,4348,5503,9851,6
2021-06-23,경의선,홍대입구,1672,1969,3641,6
2021-06-23,공항철도 1호선,서울역,7372,6711,14083,6
2021-06-23,공항철도 1호선,홍대입구,9709,9414,19123,6
2021-06-23,분당선,선릉,13976,20682,34658,6
2021-06-24,1호선,서울역,44583,42039,86622,6
2021-06-24,2호선,잠실(송파구청),68956,69097,138053,6
2021-06-24,2호선,선릉,58869,52642,111511,6
2021-06-24,2호선,강남,88200,86373,174573,6
2021-06-24,2호선,사당,37233,40493,77726,6
2021-06-24,2호선,신림,63135,61022,124157,6
2021-06-24,2호선,구로디지털단지,63126,63216,126342,6
2021-06-24,2호선,홍대입구,54874,57053,111927,6
2021-06-24,3호선,고속터미널,40004,39016,79020,6
2021-06-24,4호선,서울역,11063,16341,27404,6
2021-06-24,4호선,사당,24415,20500,44915,6
2021-06-24,7호선,고속터미널,15525,13487,29012,6
2021-06-24,7호선,가산디지털단지,48934,49399,98333,6
2021-06-24,8호선,잠실(송파구청),13924,16208,30132,6
2021-06-24,9호선,고속터미널,12693,16391,29084,6
2021-06-24,경부선,서울역,5732,1783,7515,6
2021-06-24,경부선,가산디지털단지,19423,22295,41718,6
2021-06-24,경의선,서울역,4393,5472,9865,6
2021-06-24,경의선,홍대입구,1782,1947,3729,6
2021-06-24,공항철도 1호선,서울역,7629,6933,14562,6
2021-06-24,공항철도 1호선,홍대입구,10150,10100,20250,6
2021-06-24,분당선,선릉,14125,20836,34961,6
2021-06-25,분당선,선릉,14041,20906,34947,6
2021-06-25,공항철도 1호선,홍대입구,11134,11012,22146,6
2021-06-25,공항철도 1호선,서울역,9003,8827,17830,6
2021-06-25,경의선,홍대입구,1909,2202,4111,6
2021-06-25,경의선,서울역,4463,5552,10015,6
2021-06-25,경부선,가산디지털단지,18894,21955,40849,6
2021-06-25,경부선,서울역,7824,2506,10330,6
2021-06-25,9호선,고속터미널,14278,20120,34398,6
2021-06-25,8호선,잠실(송파구청),14509,17299,31808,6
2021-06-25,7호선,가산디지털단지,48796,48260,97056,6
2021-06-25,7호선,고속터미널,17720,14858,32578,6
2021-06-25,4호선,사당,26351,22030,48381,6
2021-06-25,4호선,서울역,10917,18494,29411,6
2021-06-25,3호선,고속터미널,47465,50630,98095,6
2021-06-25,2호선,홍대입구,58505,62872,121377,6
2021-06-25,2호선,구로디지털단지,64108,63585,127693,6
2021-06-25,2호선,신림,65372,62561,127933,6
2021-06-25,2호선,사당,38435,41945,80380,6
2021-06-25,2호선,강남,92833,92200,185033,6
2021-06-25,2호선,선릉,58125,51991,110116,6
2021-06-25,2호선,잠실(송파구청),72661,72620,145281,6
2021-06-25,1호선,서울역,48414,47564,95978,6
2021-06-26,2호선,잠실(송파구청),59144,57223,116367,6
2021-06-26,2호선,선릉,22663,20034,42697,6
2021-06-26,2호선,강남,59659,59498,119157,6
2021-06-26,2호선,사당,27529,30253,57782,6
2021-06-26,2호선,신림,48005,45297,93302,6
2021-06-26,2호선,구로디지털단지,32893,32024,64917,6
2021-06-26,2호선,홍대입구,58916,63384,122300,6
2021-06-26,3호선,고속터미널,45937,47364,93301,6
2021-06-26,4호선,서울역,4874,11733,16607,6
2021-06-26,4호선,사당,19110,16367,35477,6
2021-06-26,7호선,고속터미널,13555,10671,24226,6
2021-06-26,7호선,가산디지털단지,14605,13536,28141,6
2021-06-26,8호선,잠실(송파구청),11884,13869,25753,6
2021-06-26,9호선,고속터미널,12575,17809,30384,6
2021-06-26,경부선,서울역,5973,1752,7725,6
2021-06-26,경부선,가산디지털단지,5991,8025,14016,6
2021-06-26,경의선,서울역,1238,1372,2610,6
2021-06-26,경의선,홍대입구,1857,2125,3982,6
2021-06-26,공항철도 1호선,서울역,6664,7033,13697,6
2021-06-26,공항철도 1호선,홍대입구,11610,11511,23121,6
2021-06-26,분당선,선릉,4940,7474,12414,6
2021-06-26,1호선,서울역,29396,29838,59234,6
2021-06-27,2호선,선릉,11828,10233,22061,6
2021-06-27,2호선,잠실(송파구청),45419,42382,87801,6
2021-06-27,1호선,서울역,26146,22815,48961,6
2021-06-27,2호선,강남,35402,33909,69311,6
2021-06-27,2호선,사당,19582,21961,41543,6
2021-06-27,2호선,신림,35086,34885,69971,6
2021-06-27,2호선,구로디지털단지,22161,22028,44189,6
2021-06-27,2호선,홍대입구,45607,45149,90756,6
2021-06-27,3호선,고속터미널,41173,36249,77422,6
2021-06-27,분당선,선릉,2607,3852,6459,6
2021-06-27,공항철도 1호선,홍대입구,9238,8906,18144,6
2021-06-27,공항철도 1호선,서울역,7202,6095,13297,6
2021-06-27,경의선,홍대입구,1399,1632,3031,6
2021-06-27,경의선,서울역,1026,933,1959,6
2021-06-27,경부선,가산디지털단지,4387,6143,10530,6
2021-06-27,경부선,서울역,7092,1489,8581,6
2021-06-27,4호선,서울역,3751,8847,12598,6
2021-06-27,4호선,사당,14001,12866,26867,6
2021-06-27,7호선,고속터미널,12496,7632,20128,6
2021-06-27,7호선,가산디지털단지,10606,9775,20381,6
2021-06-27,8호선,잠실(송파구청),9728,10657,20385,6
2021-06-27,9호선,고속터미널,10102,13476,23578,6
2021-06-28,분당선,선릉,13678,20426,34104,6
2021-06-28,공항철도 1호선,홍대입구,8713,8763,17476,6
2021-06-28,공항철도 1호선,서울역,7575,6857,14432,6
2021-06-28,경의선,홍대입구,1510,1672,3182,6
2021-06-28,경의선,서울역,4273,5314,9587,6
2021-06-28,경부선,가산디지털단지,19070,22058,41128,6
2021-06-28,경부선,서울역,6256,1819,8075,6
2021-06-28,9호선,고속터미널,11769,15246,27015,6
2021-06-28,8호선,잠실(송파구청),12918,15146,28064,6
2021-06-28,7호선,가산디지털단지,48667,49104,97771,6
2021-06-28,7호선,고속터미널,16656,13225,29881,6
2021-06-28,4호선,사당,23114,19377,42491,6
2021-06-28,4호선,서울역,10731,15242,25973,6
2021-06-28,3호선,고속터미널,39010,36316,75326,6
2021-06-28,2호선,홍대입구,48490,50265,98755,6
2021-06-28,2호선,구로디지털단지,61689,62140,123829,6
2021-06-28,2호선,신림,61089,59682,120771,6
2021-06-28,2호선,사당,33999,37023,71022,6
2021-06-28,2호선,강남,84631,83254,167885,6
2021-06-28,2호선,선릉,56746,50640,107386,6
2021-06-28,2호선,잠실(송파구청),63391,63978,127369,6
2021-06-28,1호선,서울역,42683,39732,82415,6
2021-06-29,분당선,선릉,14154,20811,34965,6
2021-06-29,공항철도 1호선,홍대입구,9037,8942,17979,6
2021-06-29,공항철도 1호선,서울역,7106,6208,13314,6
2021-06-29,경의선,홍대입구,1583,1687,3270,6
2021-06-29,경의선,서울역,4331,5332,9663,6
2021-06-29,경부선,가산디지털단지,19190,22105,41295,6
2021-06-29,경부선,서울역,5202,1660,6862,6
2021-06-29,9호선,고속터미널,12047,15219,27266,6
2021-06-29,8호선,잠실(송파구청),13582,16402,29984,6
2021-06-29,7호선,가산디지털단지,49154,49535,98689,6
2021-06-29,7호선,고속터미널,15607,13476,29083,6
2021-06-29,4호선,사당,24047,20315,44362,6
2021-06-29,4호선,서울역,10786,15088,25874,6
2021-06-29,3호선,고속터미널,39020,36832,75852,6
2021-06-29,2호선,홍대입구,50202,52098,102300,6
2021-06-29,2호선,구로디지털단지,62712,63178,125890,6
2021-06-29,2호선,신림,62235,60401,122636,6
2021-06-29,2호선,사당,36078,39465,75543,6
2021-06-29,1호선,서울역,42523,39921,82444,6
2021-06-29,2호선,강남,86658,85033,171691,6
2021-06-29,2호선,선릉,58262,52094,110356,6
2021-06-29,2호선,잠실(송파구청),66497,66710,133207,6
2021-06-30,경부선,서울역,5350,1708,7058,6
2021-06-30,9호선,고속터미널,11910,15302,27212,6
2021-06-30,8호선,잠실(송파구청),13680,16166,29846,6
2021-06-30,7호선,가산디지털단지,49040,49456,98496,6
2021-06-30,7호선,고속터미널,15390,13395,28785,6
2021-06-30,4호선,사당,24260,20190,44450,6
2021-06-30,4호선,서울역,10799,15313,26112,6
2021-06-30,3호선,고속터미널,38472,36390,74862,6
2021-06-30,경부선,가산디지털단지,19117,22263,41380,6
2021-06-30,경의선,서울역,4304,5392,9696,6
2021-06-30,경의선,홍대입구,1553,1776,3329,6
2021-06-30,공항철도 1호선,서울역,7003,6181,13184,6
2021-06-30,공항철도 1호선,홍대입구,9107,9104,18211,6
2021-06-30,분당선,선릉,13798,20432,34230,6
2021-06-30,2호선,홍대입구,48576,50030,98606,6
2021-06-30,2호선,구로디지털단지,62320,62507,124827,6
2021-06-30,2호선,신림,62100,60675,122775,6
2021-06-30,2호선,사당,35732,38620,74352,6
2021-06-30,2호선,강남,83653,82524,166177,6
2021-06-30,2호선,선릉,57804,51606,109410,6
2021-06-30,2호선,잠실(송파구청),66409,66646,133055,6
2021-06-30,1호선,서울역,42545,39641,82186,6
2021-07-01,분당선,선릉,13907,20839,34746,7
2021-07-01,공항철도 1호선,홍대입구,8971,8962,17933,7
2021-07-01,공항철도 1호선,서울역,7162,6468,13630,7
2021-07-01,경의선,홍대입구,1619,1761,3380,7
2021-07-01,경의선,서울역,4317,5497,9814,7
2021-07-01,경부선,가산디지털단지,18893,21802,40695,7
2021-07-01,경부선,서울역,5219,1690,6909,7
2021-07-01,1호선,서울역,41854,40070,81924,7
2021-07-01,2호선,잠실(송파구청),67407,67368,134775,7
2021-07-01,2호선,선릉,58364,51940,110304,7
2021-07-01,2호선,강남,85943,84421,170364,7
2021-07-01,2호선,사당,36364,39672,76036,7
2021-07-01,2호선,신림,62954,60938,123892,7
2021-07-01,2호선,구로디지털단지,62712,63054,125766,7
2021-07-01,2호선,홍대입구,48220,49524,97744,7
2021-07-01,3호선,고속터미널,38822,37592,76414,7
2021-07-01,9호선,고속터미널,12026,15626,27652,7
2021-07-01,8호선,잠실(송파구청),13389,15821,29210,7
2021-07-01,7호선,가산디지털단지,48540,49132,97672,7
2021-07-01,7호선,고속터미널,14909,13108,28017,7
2021-07-01,4호선,사당,24277,20449,44726,7
2021-07-01,4호선,서울역,11073,15418,26491,7
2021-07-02,7호선,가산디지털단지,48310,48176,96486,7
2021-07-02,분당선,선릉,14013,21008,35021,7
2021-07-02,공항철도 1호선,홍대입구,9647,9802,19449,7
2021-07-02,공항철도 1호선,서울역,8528,8456,16984,7
2021-07-02,경의선,홍대입구,1638,1822,3460,7
2021-07-02,경의선,서울역,4146,5634,9780,7
2021-07-02,경부선,가산디지털단지,19062,21947,41009,7
2021-07-02,경부선,서울역,6997,2420,9417,7
2021-07-02,9호선,고속터미널,13694,18927,32621,7
2021-07-02,8호선,잠실(송파구청),14371,17109,31480,7
2021-07-02,7호선,고속터미널,17104,14532,31636,7
2021-07-02,4호선,사당,26133,21832,47965,7
2021-07-02,4호선,서울역,11042,17427,28469,7
2021-07-02,3호선,고속터미널,44699,47924,92623,7
2021-07-02,2호선,홍대입구,50963,54062,105025,7
2021-07-02,2호선,구로디지털단지,63028,62580,125608,7
2021-07-02,2호선,신림,64569,62527,127096,7
2021-07-02,2호선,사당,38295,41660,79955,7
2021-07-02,2호선,강남,91383,90085,181468,7
2021-07-02,2호선,선릉,58820,51735,110555,7
2021-07-02,2호선,잠실(송파구청),71257,71444,142701,7
2021-07-02,1호선,서울역,45748,45778,91526,7
2021-07-03,분당선,선릉,4943,7773,12716,7
2021-07-03,경부선,가산디지털단지,5386,7407,12793,7
2021-07-03,경부선,서울역,5229,1477,6706,7
2021-07-03,9호선,고속터미널,10833,15908,26741,7
2021-07-03,8호선,잠실(송파구청),12519,13681,26200,7
2021-07-03,7호선,가산디지털단지,13406,12116,25522,7
2021-07-03,7호선,고속터미널,13134,10206,23340,7
2021-07-03,4호선,사당,18344,15313,33657,7
2021-07-03,4호선,서울역,4692,10254,14946,7
2021-07-03,3호선,고속터미널,44159,45040,89199,7
2021-07-03,2호선,홍대입구,45187,45330,90517,7
2021-07-03,2호선,구로디지털단지,30190,30140,60330,7
2021-07-03,2호선,신림,44788,43185,87973,7
2021-07-03,2호선,사당,25634,28121,53755,7
2021-07-03,2호선,강남,55661,54163,109824,7
2021-07-03,2호선,선릉,22319,19997,42316,7
2021-07-03,2호선,잠실(송파구청),55559,52978,108537,7
2021-07-03,1호선,서울역,26929,27300,54229,7
2021-07-03,공항철도 1호선,홍대입구,8291,8404,16695,7
2021-07-03,공항철도 1호선,서울역,6113,6343,12456,7
2021-07-03,경의선,홍대입구,1248,1556,2804,7
2021-07-03,경의선,서울역,1007,787,1794,7
2021-07-04,2호선,구로디지털단지,19456,19449,38905,7
2021-07-04,2호선,홍대입구,30461,30337,60798,7
2021-07-04,3호선,고속터미널,34209,31554,65763,7
2021-07-04,4호선,서울역,3249,7140,10389,7
2021-07-04,4호선,사당,11353,10791,22144,7
2021-07-04,7호선,고속터미널,10650,6713,17363,7
2021-07-04,7호선,가산디지털단지,8626,8029,16655,7
2021-07-04,8호선,잠실(송파구청),8222,9343,17565,7
2021-07-04,9호선,고속터미널,8578,11127,19705,7
2021-07-04,경부선,서울역,6213,1339,7552,7
2021-07-04,경부선,가산디지털단지,3824,5283,9107,7
2021-07-04,경의선,서울역,890,749,1639,7
2021-07-04,경의선,홍대입구,1126,1153,2279,7
2021-07-04,공항철도 1호선,서울역,6227,5207,11434,7
2021-07-04,공항철도 1호선,홍대입구,6370,6097,12467,7
2021-07-04,분당선,선릉,2394,3501,5895,7
2021-07-04,1호선,서울역,22868,19664,42532,7
2021-07-04,2호선,잠실(송파구청),37241,35203,72444,7
2021-07-04,2호선,선릉,10624,9251,19875,7
2021-07-04,2호선,강남,30583,29829,60412,7
2021-07-04,2호선,사당,16832,18447,35279,7
2021-07-04,2호선,신림,31258,30908,62166,7
2021-07-05,1호선,서울역,41969,39653,81622,7
2021-07-05,분당선,선릉,13997,20898,34895,7
2021-07-05,공항철도 1호선,홍대입구,8347,8307,16654,7
2021-07-05,공항철도 1호선,서울역,6974,6308,13282,7
2021-07-05,경의선,홍대입구,1466,1603,3069,7
2021-07-05,경의선,서울역,4385,5475,9860,7
2021-07-05,경부선,가산디지털단지,19375,22282,41657,7
2021-07-05,경부선,서울역,5554,1693,7247,7
2021-07-05,9호선,고속터미널,11753,14797,26550,7
2021-07-05,8호선,잠실(송파구청),12947,15331,28278,7
2021-07-05,7호선,가산디지털단지,49110,49621,98731,7
2021-07-05,7호선,고속터미널,15935,13156,29091,7
2021-07-05,4호선,사당,23347,19843,43190,7
2021-07-05,4호선,서울역,10533,14826,25359,7
2021-07-05,3호선,고속터미널,37556,34920,72476,7
2021-07-05,2호선,홍대입구,45433,46805,92238,7
2021-07-05,2호선,구로디지털단지,62571,62958,125529,7
2021-07-05,2호선,신림,62287,60735,123022,7
2021-07-05,2호선,사당,34571,37944,72515,7
2021-07-05,2호선,강남,88680,87803,176483,7
2021-07-05,2호선,선릉,57754,51574,109328,7
2021-07-05,2호선,잠실(송파구청),63871,64673,128544,7
2021-07-06,경의선,홍대입구,1503,1566,3069,7
2021-07-06,경의선,서울역,4299,5447,9746,7
2021-07-06,경부선,가산디지털단지,19260,22209,41469,7
2021-07-06,경부선,서울역,4860,1591,6451,7
2021-07-06,9호선,고속터미널,11740,14697,26437,7
2021-07-06,8호선,잠실(송파구청),13305,15852,29157,7
2021-07-06,7호선,가산디지털단지,49504,49840,99344,7
2021-07-06,7호선,고속터미널,14977,13134,28111,7
2021-07-06,4호선,사당,24224,20411,44635,7
2021-07-06,4호선,서울역,11013,14780,25793,7
2021-07-06,1호선,서울역,41637,39262,80899,7
2021-07-06,2호선,잠실(송파구청),66533,66944,133477,7
2021-07-06,2호선,선릉,59405,52928,112333,7
2021-07-06,2호선,강남,91372,89661,181033,7
2021-07-06,2호선,사당,36155,39487,75642,7
2021-07-06,2호선,신림,63372,61686,125058,7
2021-07-06,2호선,구로디지털단지,63063,63698,126761,7
2021-07-06,2호선,홍대입구,48048,49222,97270,7
2021-07-06,3호선,고속터미널,37468,35675,73143,7
2021-07-06,공항철도 1호선,서울역,6821,6014,12835,7
2021-07-06,공항철도 1호선,홍대입구,8354,8278,16632,7
2021-07-06,분당선,선릉,14295,21320,35615,7
2021-07-07,1호선,서울역,40137,38071,78208,7
2021-07-07,2호선,잠실(송파구청),61408,62370,123778,7
2021-07-07,2호선,선릉,56834,50294,107128,7
2021-07-07,2호선,강남,85687,83443,169130,7
2021-07-07,2호선,사당,34838,37493,72331,7
2021-07-07,2호선,신림,61521,59934,121455,7
2021-07-07,2호선,구로디지털단지,61227,61736,122963,7
2021-07-07,2호선,홍대입구,44824,45656,90480,7
2021-07-07,3호선,고속터미널,34444,32935,67379,7
2021-07-07,4호선,서울역,10675,14678,25353,7
2021-07-07,4호선,사당,23296,19501,42797,7
2021-07-07,7호선,고속터미널,14107,12444,26551,7
2021-07-07,7호선,가산디지털단지,48550,48517,97067,7
2021-07-07,8호선,잠실(송파구청),12983,15218,28201,7
2021-07-07,9호선,고속터미널,11104,13988,25092,7
2021-07-07,경부선,서울역,4815,1591,6406,7
2021-07-07,경부선,가산디지털단지,18697,21655,40352,7
2021-07-07,경의선,서울역,4189,5264,9453,7
2021-07-07,경의선,홍대입구,1389,1612,3001,7
2021-07-07,공항철도 1호선,서울역,6672,6184,12856,7
2021-07-07,공항철도 1호선,홍대입구,7846,7931,15777,7
2021-07-07,분당선,선릉,13932,20384,34316,7
2021-07-08,7호선,고속터미널,13797,12405,26202,7
2021-07-08,7호선,가산디지털단지,47220,47356,94576,7
2021-07-08,8호선,잠실(송파구청),12256,14275,26531,7
2021-07-08,4호선,사당,22532,18663,41195,7
2021-07-08,4호선,서울역,10338,14204,24542,7
2021-07-08,9호선,고속터미널,10580,13319,23899,7
2021-07-08,경부선,서울역,4605,1590,6195,7
2021-07-08,경부선,가산디지털단지,18322,21371,39693,7
2021-07-08,경의선,서울역,4102,5287,9389,7
2021-07-08,경의선,홍대입구,1390,1466,2856,7
2021-07-08,공항철도 1호선,서울역,6494,6065,12559,7
2021-07-08,공항철도 1호선,홍대입구,7497,7599,15096,7
2021-07-08,분당선,선릉,13652,19526,33178,7
2021-07-08,3호선,고속터미널,33128,32104,65232,7
2021-07-08,2호선,홍대입구,41791,42914,84705,7
2021-07-08,2호선,구로디지털단지,59887,60139,120026,7
2021-07-08,2호선,신림,60007,57980,117987,7
2021-07-08,2호선,사당,33648,36343,69991,7
2021-07-08,2호선,강남,80809,79558,160367,7
2021-07-08,2호선,선릉,55064,49306,104370,7
2021-07-08,2호선,잠실(송파구청),58281,58676,116957,7
2021-07-08,1호선,서울역,39057,37277,76334,7
2021-07-09,1호선,서울역,41401,40852,82253,7
2021-07-09,2호선,잠실(송파구청),59368,59211,118579,7
2021-07-09,2호선,선릉,53621,47826,101447,7
2021-07-09,2호선,강남,81527,80012,161539,7
2021-07-09,2호선,사당,33875,36206,70081,7
2021-07-09,2호선,신림,60940,58139,119079,7
2021-07-09,2호선,구로디지털단지,58725,58949,117674,7
2021-07-09,2호선,홍대입구,42987,44676,87663,7
2021-07-09,3호선,고속터미널,36064,39608,75672,7
2021-07-09,4호선,서울역,10062,15321,25383,7
2021-07-09,4호선,사당,23275,19105,42380,7
2021-07-09,7호선,고속터미널,14878,12961,27839,7
2021-07-09,7호선,가산디지털단지,45317,45010,90327,7
2021-07-09,8호선,잠실(송파구청),12393,14586,26979,7
2021-07-09,9호선,고속터미널,11330,15526,26856,7
2021-07-09,경부선,서울역,5797,2177,7974,7
2021-07-09,경부선,가산디지털단지,17666,20698,38364,7
2021-07-09,경의선,서울역,4222,5226,9448,7
2021-07-09,경의선,홍대입구,1364,1471,2835,7
2021-07-09,공항철도 1호선,서울역,7561,7434,14995,7
2021-07-09,공항철도 1호선,홍대입구,7897,8046,15943,7
2021-07-09,분당선,선릉,13106,18920,32026,7
2021-07-10,경의선,서울역,937,1096,2033,7
2021-07-10,경의선,홍대입구,1280,1355,2635,7
2021-07-10,분당선,선릉,4264,6386,10650,7
2021-07-10,공항철도 1호선,홍대입구,7263,6693,13956,7
2021-07-10,공항철도 1호선,서울역,4816,5217,10033,7
2021-07-10,1호선,서울역,20637,22061,42698,7
2021-07-10,2호선,잠실(송파구청),42242,40518,82760,7
2021-07-10,2호선,선릉,19349,17014,36363,7
2021-07-10,2호선,강남,45658,44727,90385,7
2021-07-10,2호선,사당,21481,23301,44782,7
2021-07-10,2호선,신림,41139,39165,80304,7
2021-07-10,2호선,구로디지털단지,27616,27289,54905,7
2021-07-10,2호선,홍대입구,36362,37574,73936,7
2021-07-10,3호선,고속터미널,31672,34146,65818,7
2021-07-10,4호선,서울역,4074,8169,12243,7
2021-07-10,4호선,사당,14439,12295,26734,7
2021-07-10,7호선,고속터미널,9448,8011,17459,7
2021-07-10,7호선,가산디지털단지,12122,11109,23231,7
2021-07-10,8호선,잠실(송파구청),9214,10797,20011,7
2021-07-10,9호선,고속터미널,8547,12117,20664,7
2021-07-10,경부선,서울역,3864,1354,5218,7
2021-07-10,경부선,가산디지털단지,5196,6635,11831,7
2021-07-11,2호선,신림,28441,28777,57218,7
2021-07-11,2호선,구로디지털단지,17776,17502,35278,7
2021-07-11,2호선,홍대입구,26005,25978,51983,7
2021-07-11,3호선,고속터미널,26981,24466,51447,7
2021-07-11,4호선,서울역,2851,5825,8676,7
2021-07-11,4호선,사당,10060,9443,19503,7
2021-07-11,7호선,고속터미널,8712,5454,14166,7
2021-07-11,7호선,가산디지털단지,8102,7555,15657,7
2021-07-11,8호선,잠실(송파구청),6574,7209,13783,7
2021-07-11,9호선,고속터미널,7002,8439,15441,7
2021-07-11,경부선,서울역,5154,1045,6199,7
2021-07-11,경부선,가산디지털단지,3536,4795,8331,7
2021-07-11,경의선,서울역,785,715,1500,7
2021-07-11,경의선,홍대입구,967,1094,2061,7
2021-07-11,공항철도 1호선,서울역,5281,4179,9460,7
2021-07-11,공항철도 1호선,홍대입구,5258,5048,10306,7
2021-07-11,분당선,선릉,2189,3173,5362,7
2021-07-11,2호선,사당,14354,16067,30421,7
2021-07-11,2호선,잠실(송파구청),30082,28364,58446,7
2021-07-11,2호선,선릉,9741,8410,18151,7
2021-07-11,2호선,강남,24776,23822,48598,7
2021-07-11,1호선,서울역,18432,15850,34282,7
2021-07-12,1호선,서울역,34388,32807,67195,7
2021-07-12,2호선,잠실(송파구청),48390,48763,97153,7
2021-07-12,2호선,선릉,49831,44152,93983,7
2021-07-12,2호선,강남,71463,69671,141134,7
2021-07-12,2호선,사당,28975,31385,60360,7
2021-07-12,2호선,신림,54856,53632,108488,7
2021-07-12,2호선,구로디지털단지,54207,54726,108933,7
2021-07-12,2호선,홍대입구,36924,37512,74436,7
2021-07-12,3호선,고속터미널,30293,28700,58993,7
2021-07-12,4호선,서울역,8922,11622,20544,7
2021-07-12,4호선,사당,19477,16383,35860,7
2021-07-12,7호선,고속터미널,13476,11140,24616,7
2021-07-12,7호선,가산디지털단지,44535,44402,88937,7
2021-07-12,8호선,잠실(송파구청),10506,12061,22567,7
2021-07-12,9호선,고속터미널,9535,11857,21392,7
2021-07-12,경부선,서울역,4457,1464,5921,7
2021-07-12,경부선,가산디지털단지,16436,19545,35981,7
2021-07-12,경의선,서울역,3850,4651,8501,7
2021-07-12,경의선,홍대입구,1180,1341,2521,7
2021-07-12,공항철도 1호선,서울역,5980,5390,11370,7
2021-07-12,공항철도 1호선,홍대입구,6853,6801,13654,7
2021-07-12,분당선,선릉,12181,17643,29824,7
2021-07-13,경의선,홍대입구,1220,1353,2573,7
2021-07-13,경의선,서울역,3675,4449,8124,7
2021-07-13,경부선,가산디지털단지,16241,19107,35348,7
2021-07-13,경부선,서울역,3637,1319,4956,7
2021-07-13,9호선,고속터미널,9141,11391,20532,7
2021-07-13,8호선,잠실(송파구청),10869,12783,23652,7
2021-07-13,7호선,가산디지털단지,43321,43206,86527,7
2021-07-13,7호선,고속터미널,12607,11028,23635,7
2021-07-13,4호선,사당,19533,16352,35885,7
2021-07-13,4호선,서울역,8717,11119,19836,7
2021-07-13,3호선,고속터미널,29156,27860,57016,7
2021-07-13,2호선,홍대입구,36615,37360,73975,7
2021-07-13,2호선,구로디지털단지,53706,54193,107899,7
2021-07-13,2호선,신림,55173,53679,108852,7
2021-07-13,2호선,사당,29330,31599,60929,7
2021-07-13,2호선,강남,70495,68959,139454,7
2021-07-13,2호선,선릉,49118,43713,92831,7
2021-07-13,2호선,잠실(송파구청),51509,51505,103014,7
2021-07-13,1호선,서울역,32702,31105,63807,7
2021-07-13,분당선,선릉,12108,17458,29566,7
2021-07-13,공항철도 1호선,홍대입구,6580,6717,13297,7
2021-07-13,공항철도 1호선,서울역,5388,4929,10317,7
2021-07-14,분당선,선릉,11944,17100,29044,7
2021-07-14,공항철도 1호선,홍대입구,6778,6778,13556,7
2021-07-14,공항철도 1호선,서울역,5484,5116,10600,7
2021-07-14,경의선,홍대입구,1211,1306,2517,7
2021-07-14,경의선,서울역,3674,4433,8107,7
2021-07-14,경부선,가산디지털단지,15824,18699,34523,7
2021-07-14,경부선,서울역,3745,1387,5132,7
2021-07-14,9호선,고속터미널,9234,11583,20817,7
2021-07-14,4호선,사당,19482,16232,35714,7
2021-07-14,4호선,서울역,8586,11254,19840,7
2021-07-14,3호선,고속터미널,28438,27485,55923,7
2021-07-14,2호선,잠실(송파구청),51742,51799,103541,7
2021-07-14,2호선,홍대입구,37630,38431,76061,7
2021-07-14,2호선,구로디지털단지,52759,53312,106071,7
2021-07-14,2호선,신림,54831,53237,108068,7
2021-07-14,2호선,사당,28894,30988,59882,7
2021-07-14,2호선,강남,70045,68238,138283,7
2021-07-14,2호선,선릉,48750,43349,92099,7
2021-07-14,1호선,서울역,32840,31277,64117,7
2021-07-14,8호선,잠실(송파구청),11156,12905,24061,7
2021-07-14,7호선,가산디지털단지,42742,42652,85394,7
2021-07-14,7호선,고속터미널,12142,10858,23000,7
2021-07-15,7호선,고속터미널,11944,10617,22561,7
2021-07-15,2호선,선릉,48280,43137,91417,7
2021-07-15,2호선,강남,68355,66644,134999,7
2021-07-15,2호선,사당,28854,31023,59877,7
2021-07-15,2호선,신림,54157,52712,106869,7
2021-07-15,2호선,구로디지털단지,52135,53093,105228,7
2021-07-15,2호선,홍대입구,37533,38176,75709,7
2021-07-15,3호선,고속터미널,28374,27939,56313,7
2021-07-15,4호선,서울역,8526,11090,19616,7
2021-07-15,4호선,사당,19342,16038,35380,7
2021-07-15,1호선,서울역,32732,31265,63997,7
2021-07-15,분당선,선릉,11903,17051,28954,7
2021-07-15,공항철도 1호선,홍대입구,6786,6898,13684,7
2021-07-15,공항철도 1호선,서울역,5577,5328,10905,7
2021-07-15,경의선,홍대입구,1245,1368,2613,7
2021-07-15,경의선,서울역,3697,4489,8186,7
2021-07-15,경부선,가산디지털단지,15791,18705,34496,7
2021-07-15,경부선,서울역,3507,1433,4940,7
2021-07-15,9호선,고속터미널,9193,11496,20689,7
2021-07-15,8호선,잠실(송파구청),10558,11924,22482,7
2021-07-15,7호선,가산디지털단지,42442,42267,84709,7
2021-07-15,2호선,잠실(송파구청),49148,49212,98360,7
2021-07-16,9호선,고속터미널,10040,13918,23958,7
2021-07-16,8호선,잠실(송파구청),11797,13540,25337,7
2021-07-16,7호선,가산디지털단지,41881,41102,82983,7
2021-07-16,7호선,고속터미널,13285,11828,25113,7
2021-07-16,4호선,사당,20227,16530,36757,7
2021-07-16,4호선,서울역,8465,12717,21182,7
2021-07-16,3호선,고속터미널,32442,35795,68237,7
2021-07-16,2호선,홍대입구,39128,40197,79325,7
2021-07-16,2호선,구로디지털단지,52112,52303,104415,7
2021-07-16,2호선,신림,55427,53360,108787,7
2021-07-16,2호선,사당,29597,31301,60898,7
2021-07-16,2호선,강남,70539,68551,139090,7
2021-07-16,2호선,선릉,47600,42493,90093,7
2021-07-16,2호선,잠실(송파구청),53091,53289,106380,7
2021-07-16,1호선,서울역,34673,34979,69652,7
2021-07-16,분당선,선릉,11897,16917,28814,7
2021-07-16,공항철도 1호선,홍대입구,7204,7204,14408,7
2021-07-16,공항철도 1호선,서울역,6494,6565,13059,7
2021-07-16,경의선,홍대입구,1296,1446,2742,7
2021-07-16,경의선,서울역,3706,4429,8135,7
2021-07-16,경부선,가산디지털단지,15345,18164,33509,7
2021-07-16,경부선,서울역,4754,1947,6701,7
2021-07-17,7호선,가산디지털단지,11473,10498,21971,7
2021-07-17,4호선,서울역,3575,6851,10426,7
2021-07-17,3호선,고속터미널,28704,30498,59202,7
2021-07-17,2호선,홍대입구,33792,34612,68404,7
2021-07-17,2호선,구로디지털단지,25261,24906,50167,7
2021-07-17,2호선,신림,37639,36329,73968,7
2021-07-17,2호선,사당,19765,21074,40839,7
2021-07-17,2호선,강남,41697,40497,82194,7
2021-07-17,2호선,선릉,17217,15260,32477,7
2021-07-17,2호선,잠실(송파구청),39211,37600,76811,7
2021-07-17,4호선,사당,13443,11495,24938,7
2021-07-17,공항철도 1호선,홍대입구,6670,6278,12948,7
2021-07-17,1호선,서울역,18534,19380,37914,7
2021-07-17,7호선,고속터미널,8080,6782,14862,7
2021-07-17,분당선,선릉,3807,5544,9351,7
2021-07-17,공항철도 1호선,서울역,4492,4841,9333,7
2021-07-17,경의선,홍대입구,1129,1221,2350,7
2021-07-17,경의선,서울역,839,911,1750,7
2021-07-17,경부선,가산디지털단지,4538,6171,10709,7
2021-07-17,경부선,서울역,3148,1169,4317,7
2021-07-17,9호선,고속터미널,7913,11061,18974,7
2021-07-17,8호선,잠실(송파구청),8532,9723,18255,7
2021-07-18,2호선,신림,26402,26360,52762,7
2021-07-18,2호선,구로디지털단지,16500,16620,33120,7
2021-07-18,2호선,홍대입구,25835,25553,51388,7
2021-07-18,분당선,선릉,2036,3009,5045,7
2021-07-18,공항철도 1호선,홍대입구,5385,5329,10714,7
2021-07-18,공항철도 1호선,서울역,4972,3666,8638,7
2021-07-18,경의선,홍대입구,916,1020,1936,7
2021-07-18,경의선,서울역,688,649,1337,7
2021-07-18,경부선,가산디지털단지,3334,4579,7913,7
2021-07-18,9호선,고속터미널,6860,7785,14645,7
2021-07-18,8호선,잠실(송파구청),6877,7416,14293,7
2021-07-18,7호선,가산디지털단지,7837,7366,15203,7
2021-07-18,7호선,고속터미널,8110,4876,12986,7
2021-07-18,경부선,서울역,4340,872,5212,7
2021-07-18,4호선,사당,9403,8959,18362,7
2021-07-18,4호선,서울역,2705,5082,7787,7
2021-07-18,3호선,고속터미널,25789,22121,47910,7
2021-07-18,2호선,사당,13292,14803,28095,7
2021-07-18,2호선,강남,22663,21855,44518,7
2021-07-18,2호선,선릉,9219,8014,17233,7
2021-07-18,2호선,잠실(송파구청),28528,27156,55684,7
2021-07-18,1호선,서울역,17507,14388,31895,7
2021-07-19,7호선,고속터미널,13257,10857,24114,7
2021-07-19,7호선,가산디지털단지,44219,43103,87322,7
2021-07-19,8호선,잠실(송파구청),10844,12397,23241,7
2021-07-19,9호선,고속터미널,9494,11485,20979,7
2021-07-19,경부선,서울역,4335,1405,5740,7
2021-07-19,경부선,가산디지털단지,15981,18835,34816,7
2021-07-19,경의선,서울역,3575,4374,7949,7
2021-07-19,경의선,홍대입구,1271,1326,2597,7
2021-07-19,공항철도 1호선,서울역,5644,5129,10773,7
2021-07-19,공항철도 1호선,홍대입구,6342,6542,12884,7
2021-07-19,1호선,서울역,33065,31137,64202,7
2021-07-19,2호선,잠실(송파구청),49753,50102,99855,7
2021-07-19,2호선,선릉,48774,43301,92075,7
2021-07-19,2호선,강남,69988,68273,138261,7
2021-07-19,2호선,사당,28222,31000,59222,7
2021-07-19,2호선,신림,54034,52895,106929,7
2021-07-19,2호선,구로디지털단지,52754,53455,106209,7
2021-07-19,2호선,홍대입구,35746,36748,72494,7
2021-07-19,3호선,고속터미널,29797,27610,57407,7
2021-07-19,분당선,선릉,11859,17266,29125,7
2021-07-19,4호선,사당,19352,15908,35260,7
2021-07-19,4호선,서울역,8663,11106,19769,7
2021-07-20,1호선,서울역,33072,31123,64195,7
2021-07-20,2호선,잠실(송파구청),52219,51741,103960,7
2021-07-20,2호선,선릉,49508,44303,93811,7
2021-07-20,2호선,강남,71706,69823,141529,7
2021-07-20,2호선,사당,29154,31442,60596,7
2021-07-20,2호선,신림,54622,53553,108175,7
2021-07-20,2호선,구로디지털단지,52699,53624,106323,7
2021-07-20,2호선,홍대입구,37872,38401,76273,7
2021-07-20,3호선,고속터미널,29811,28396,58207,7
2021-07-20,4호선,서울역,8873,11401,20274,7
2021-07-20,4호선,사당,19601,16141,35742,7
2021-07-20,7호선,고속터미널,12732,11233,23965,7
2021-07-20,7호선,가산디지털단지,43557,43084,86641,7
2021-07-20,8호선,잠실(송파구청),11190,12764,23954,7
2021-07-20,9호선,고속터미널,9480,11844,21324,7
2021-07-20,경부선,서울역,3828,1333,5161,7
2021-07-20,경부선,가산디지털단지,15996,18834,34830,7
2021-07-20,경의선,서울역,3622,4370,7992,7
2021-07-20,경의선,홍대입구,1261,1402,2663,7
2021-07-20,공항철도 1호선,서울역,5427,5053,10480,7
2021-07-20,공항철도 1호선,홍대입구,6742,6788,13530,7
2021-07-20,분당선,선릉,12063,17319,29382,7
2021-07-21,2호선,선릉,48950,43303,92253,7
2021-07-21,2호선,잠실(송파구청),52574,52628,105202,7
2021-07-21,분당선,선릉,11793,16921,28714,7
2021-07-21,공항철도 1호선,홍대입구,6941,6946,13887,7
2021-07-21,공항철도 1호선,서울역,5366,4917,10283,7
2021-07-21,경의선,서울역,3531,4251,7782,7
2021-07-21,경의선,홍대입구,1250,1334,2584,7
2021-07-21,8호선,잠실(송파구청),11484,13091,24575,7
2021-07-21,7호선,가산디지털단지,42839,42549,85388,7
2021-07-21,7호선,고속터미널,12262,10898,23160,7
2021-07-21,1호선,서울역,32581,30731,63312,7
2021-07-21,4호선,사당,19644,16039,35683,7
2021-07-21,4호선,서울역,8671,11333,20004,7
2021-07-21,3호선,고속터미널,29697,28630,58327,7
2021-07-21,9호선,고속터미널,9635,11937,21572,7
2021-07-21,경부선,서울역,3784,1341,5125,7
2021-07-21,경부선,가산디지털단지,15761,18499,34260,7
2021-07-21,2호선,홍대입구,37779,38715,76494,7
2021-07-21,2호선,구로디지털단지,52521,52951,105472,7
2021-07-21,2호선,신림,54489,53068,107557,7
2021-07-21,2호선,사당,28799,30954,59753,7
2021-07-21,2호선,강남,70033,68004,138037,7
2021-07-22,분당선,선릉,11631,16985,28616,7
2021-07-22,공항철도 1호선,홍대입구,6958,6883,13841,7
2021-07-22,공항철도 1호선,서울역,5583,5256,10839,7
2021-07-22,경의선,홍대입구,1276,1441,2717,7
2021-07-22,경의선,서울역,3516,4209,7725,7
2021-07-22,경부선,가산디지털단지,15340,18233,33573,7
2021-07-22,경부선,서울역,3785,1400,5185,7
2021-07-22,9호선,고속터미널,9546,12152,21698,7
2021-07-22,8호선,잠실(송파구청),11285,12957,24242,7
2021-07-22,7호선,가산디지털단지,42281,42025,84306,7
2021-07-22,7호선,고속터미널,12285,10873,23158,7
2021-07-22,4호선,사당,19336,15976,35312,7
2021-07-22,4호선,서울역,8482,11203,19685,7
2021-07-22,3호선,고속터미널,29877,29371,59248,7
2021-07-22,2호선,홍대입구,37888,38939,76827,7
2021-07-22,2호선,구로디지털단지,51629,52566,104195,7
2021-07-22,2호선,신림,54207,52615,106822,7
2021-07-22,2호선,사당,28622,30718,59340,7
2021-07-22,2호선,강남,69895,68061,137956,7
2021-07-22,2호선,선릉,48518,43024,91542,7
2021-07-22,2호선,잠실(송파구청),52364,52113,104477,7
2021-07-22,1호선,서울역,32408,31138,63546,7
2021-07-23,2호선,강남,72900,70245,143145,7
2021-07-23,2호선,사당,29484,31661,61145,7
2021-07-23,2호선,신림,55572,53708,109280,7
2021-07-23,2호선,구로디지털단지,52261,51989,104250,7
2021-07-23,2호선,선릉,48542,42711,91253,7
2021-07-23,2호선,잠실(송파구청),54910,55065,109975,7
2021-07-23,1호선,서울역,34533,34962,69495,7
2021-07-23,2호선,홍대입구,39739,40840,80579,7
2021-07-23,3호선,고속터미널,33502,36769,70271,7
2021-07-23,4호선,서울역,8505,12633,21138,7
2021-07-23,4호선,사당,20435,16600,37035,7
2021-07-23,9호선,고속터미널,10413,13986,24399,7
2021-07-23,경부선,서울역,4840,1875,6715,7
2021-07-23,경부선,가산디지털단지,15434,18120,33554,7
2021-07-23,경의선,서울역,3535,4274,7809,7
2021-07-23,경의선,홍대입구,1372,1453,2825,7
2021-07-23,공항철도 1호선,서울역,6473,6399,12872,7
2021-07-23,공항철도 1호선,홍대입구,7375,7453,14828,7
2021-07-23,분당선,선릉,11884,16925,28809,7
2021-07-23,7호선,고속터미널,13298,11663,24961,7
2021-07-23,7호선,가산디지털단지,42077,41031,83108,7
2021-07-23,8호선,잠실(송파구청),12038,13784,25822,7
2021-07-24,공항철도 1호선,서울역,4270,4651,8921,7
2021-07-24,공항철도 1호선,홍대입구,6766,6454,13220,7
2021-07-24,1호선,서울역,18055,18400,36455,7
2021-07-24,2호선,잠실(송파구청),39735,38475,78210,7
2021-07-24,2호선,선릉,17225,15176,32401,7
2021-07-24,2호선,강남,42937,41636,84573,7
2021-07-24,2호선,사당,19558,21213,40771,7
2021-07-24,2호선,신림,38330,36632,74962,7
2021-07-24,2호선,구로디지털단지,25287,24704,49991,7
2021-07-24,2호선,홍대입구,34196,35340,69536,7
2021-07-24,3호선,고속터미널,30227,31777,62004,7
2021-07-24,4호선,서울역,3682,7030,10712,7
2021-07-24,4호선,사당,13406,11269,24675,7
2021-07-24,분당선,선릉,3716,5425,9141,7
2021-07-24,7호선,고속터미널,8460,6889,15349,7
2021-07-24,7호선,가산디지털단지,11583,10553,22136,7
2021-07-24,8호선,잠실(송파구청),8715,9743,18458,7
2021-07-24,9호선,고속터미널,8036,11262,19298,7
2021-07-24,경부선,서울역,3172,1025,4197,7
2021-07-24,경부선,가산디지털단지,4572,6226,10798,7
2021-07-24,경의선,서울역,773,980,1753,7
2021-07-24,경의선,홍대입구,1106,1225,2331,7
2021-07-25,1호선,서울역,16271,13807,30078,7
2021-07-25,2호선,잠실(송파구청),29102,27573,56675,7
2021-07-25,2호선,선릉,8750,7575,16325,7
2021-07-25,2호선,강남,23092,21811,44903,7
2021-07-25,2호선,사당,13011,14481,27492,7
2021-07-25,2호선,신림,26504,26509,53013,7
2021-07-25,2호선,구로디지털단지,15981,15940,31921,7
2021-07-25,2호선,홍대입구,25789,25701,51490,7
2021-07-25,3호선,고속터미널,26540,23297,49837,7
2021-07-25,4호선,서울역,2715,4980,7695,7
2021-07-25,4호선,사당,9315,8780,18095,7
2021-07-25,7호선,고속터미널,8207,4936,13143,7
2021-07-25,7호선,가산디지털단지,7706,7066,14772,7
2021-07-25,8호선,잠실(송파구청),6861,7445,14306,7
2021-07-25,9호선,고속터미널,6645,8078,14723,7
2021-07-25,경부선,서울역,4262,931,5193,7
2021-07-25,경부선,가산디지털단지,3074,4482,7556,7
2021-07-25,경의선,서울역,675,571,1246,7
2021-07-25,경의선,홍대입구,864,1039,1903,7
2021-07-25,공항철도 1호선,서울역,4924,3703,8627,7
2021-07-25,공항철도 1호선,홍대입구,5193,5113,10306,7
2021-07-25,분당선,선릉,1888,2899,4787,7
2021-07-26,분당선,선릉,11850,17394,29244,7
2021-07-26,공항철도 1호선,홍대입구,6845,6951,13796,7
2021-07-26,공항철도 1호선,서울역,5818,5162,10980,7
2021-07-26,경의선,홍대입구,1246,1391,2637,7
2021-07-26,경의선,서울역,3596,4309,7905,7
2021-07-26,경부선,가산디지털단지,15723,18753,34476,7
2021-07-26,경부선,서울역,4223,1360,5583,7
2021-07-26,9호선,고속터미널,9307,11414,20721,7
2021-07-26,8호선,잠실(송파구청),11253,12784,24037,7
2021-07-26,7호선,가산디지털단지,42944,42720,85664,7
2021-07-26,7호선,고속터미널,13151,10787,23938,7
2021-07-26,4호선,사당,19314,15935,35249,7
2021-07-26,4호선,서울역,8857,11448,20305,7
2021-07-26,3호선,고속터미널,28595,26189,54784,7
2021-07-26,2호선,홍대입구,37565,38480,76045,7
2021-07-26,2호선,구로디지털단지,52194,53126,105320,7
2021-07-26,2호선,신림,53938,52984,106922,7
2021-07-26,2호선,사당,28341,30682,59023,7
2021-07-26,2호선,강남,70861,69012,139873,7
2021-07-26,2호선,선릉,49110,43565,92675,7
2021-07-26,2호선,잠실(송파구청),51436,51652,103088,7
2021-07-26,1호선,서울역,33236,31444,64680,7
2021-07-27,분당선,선릉,11895,17134,29029,7
2021-07-27,공항철도 1호선,홍대입구,6772,6981,13753,7
2021-07-27,공항철도 1호선,서울역,5531,5117,10648,7
2021-07-27,경의선,홍대입구,1250,1381,2631,7
2021-07-27,경의선,서울역,3467,4224,7691,7
2021-07-27,경부선,가산디지털단지,15568,18345,33913,7
2021-07-27,경부선,서울역,3769,1308,5077,7
2021-07-27,9호선,고속터미널,9407,11839,21246,7
2021-07-27,8호선,잠실(송파구청),11319,12964,24283,7
2021-07-27,7호선,가산디지털단지,43022,42469,85491,7
2021-07-27,7호선,고속터미널,12452,10773,23225,7
2021-07-27,4호선,사당,19455,15946,35401,7
2021-07-27,4호선,서울역,8883,11467,20350,7
2021-07-27,3호선,고속터미널,31528,29863,61391,7
2021-07-27,2호선,잠실(송파구청),52791,53021,105812,7
2021-07-27,2호선,선릉,49013,43648,92661,7
2021-07-27,2호선,강남,70733,69415,140148,7
2021-07-27,2호선,사당,28802,30838,59640,7
2021-07-27,2호선,신림,54042,52724,106766,7
2021-07-27,2호선,구로디지털단지,51876,52555,104431,7
2021-07-27,2호선,홍대입구,38268,39075,77343,7
2021-07-27,1호선,서울역,32732,30717,63449,7
2021-07-28,1호선,서울역,32768,31314,64082,7
2021-07-28,2호선,잠실(송파구청),53477,53524,107001,7
2021-07-28,2호선,선릉,48223,42880,91103,7
2021-07-28,2호선,강남,70081,67862,137943,7
2021-07-28,2호선,사당,28511,30770,59281,7
2021-07-28,2호선,신림,53642,52384,106026,7
2021-07-28,2호선,구로디지털단지,51719,52052,103771,7
2021-07-28,2호선,홍대입구,39091,39957,79048,7
2021-07-28,3호선,고속터미널,30628,29987,60615,7
2021-07-28,4호선,서울역,8829,11608,20437,7
2021-07-28,4호선,사당,19352,15955,35307,7
2021-07-28,7호선,고속터미널,12364,10650,23014,7
2021-07-28,7호선,가산디지털단지,42098,41694,83792,7
2021-07-28,8호선,잠실(송파구청),11569,13167,24736,7
2021-07-28,9호선,고속터미널,9633,12237,21870,7
2021-07-28,경부선,서울역,3702,1389,5091,7
2021-07-28,경부선,가산디지털단지,15351,18036,33387,7
2021-07-28,경의선,서울역,3484,4186,7670,7
2021-07-28,경의선,홍대입구,1251,1336,2587,7
2021-07-28,공항철도 1호선,서울역,5631,5221,10852,7
2021-07-28,공항철도 1호선,홍대입구,6977,7082,14059,7
2021-07-28,분당선,선릉,11608,16814,28422,7
2021-07-29,1호선,서울역,32523,31593,64116,7
2021-07-29,2호선,잠실(송파구청),53210,53446,106656,7
2021-07-29,2호선,선릉,48045,42775,90820,7
2021-07-29,2호선,강남,69094,67229,136323,7
2021-07-29,2호선,사당,28560,30593,59153,7
2021-07-29,2호선,신림,53590,52238,105828,7
2021-07-29,2호선,구로디지털단지,51319,51674,102993,7
2021-07-29,2호선,홍대입구,39064,40115,79179,7
2021-07-29,3호선,고속터미널,30668,30464,61132,7
2021-07-29,4호선,서울역,8681,12053,20734,7
2021-07-29,4호선,사당,19413,15745,35158,7
2021-07-29,7호선,고속터미널,12204,10761,22965,7
2021-07-29,7호선,가산디지털단지,41512,40963,82475,7
2021-07-29,8호선,잠실(송파구청),11578,13154,24732,7
2021-07-29,9호선,고속터미널,9468,12097,21565,7
2021-07-29,경부선,서울역,3845,1436,5281,7
2021-07-29,경부선,가산디지털단지,15182,18036,33218,7
2021-07-29,경의선,서울역,3416,4233,7649,7
2021-07-29,경의선,홍대입구,1272,1483,2755,7
2021-07-29,공항철도 1호선,서울역,5780,5684,11464,7
2021-07-29,공항철도 1호선,홍대입구,7286,7210,14496,7
2021-07-29,분당선,선릉,11526,16661,28187,7
2021-07-30,분당선,선릉,11389,16401,27790,7
2021-07-30,공항철도 1호선,홍대입구,7664,7626,15290,7
2021-07-30,공항철도 1호선,서울역,6847,6771,13618,7
2021-07-30,경의선,홍대입구,1438,1529,2967,7
2021-07-30,경의선,서울역,3525,4428,7953,7
2021-07-30,경부선,가산디지털단지,14999,17833,32832,7
2021-07-30,경부선,서울역,4761,1876,6637,7
2021-07-30,9호선,고속터미널,10386,14545,24931,7
2021-07-30,8호선,잠실(송파구청),12138,13868,26006,7
2021-07-30,7호선,가산디지털단지,40792,39871,80663,7
2021-07-30,7호선,고속터미널,13300,11146,24446,7
2021-07-30,4호선,사당,20446,16378,36824,7
2021-07-30,4호선,서울역,8760,13328,22088,7
2021-07-30,3호선,고속터미널,34587,39314,73901,7
2021-07-30,2호선,홍대입구,42220,43521,85741,7
2021-07-30,2호선,구로디지털단지,51228,51190,102418,7
2021-07-30,2호선,신림,54846,52543,107389,7
2021-07-30,2호선,사당,29284,31425,60709,7
2021-07-30,2호선,강남,71590,69719,141309,7
2021-07-30,2호선,선릉,47160,41851,89011,7
2021-07-30,2호선,잠실(송파구청),55736,55824,111560,7
2021-07-30,1호선,서울역,35317,36047,71364,7
2021-07-31,2호선,홍대입구,36540,37316,73856,7
2021-07-31,2호선,구로디지털단지,24995,24528,49523,7
2021-07-31,2호선,신림,37748,35749,73497,7
2021-07-31,2호선,사당,19268,21010,40278,7
2021-07-31,경의선,서울역,856,916,1772,7
2021-07-31,경부선,가산디지털단지,4431,5929,10360,7
2021-07-31,경부선,서울역,3294,1161,4455,7
2021-07-31,9호선,고속터미널,8054,11373,19427,7
2021-07-31,8호선,잠실(송파구청),8905,10141,19046,7
2021-07-31,7호선,가산디지털단지,11187,10215,21402,7
2021-07-31,7호선,고속터미널,8538,7107,15645,7
2021-07-31,분당선,선릉,3718,5308,9026,7
2021-07-31,공항철도 1호선,홍대입구,7347,6874,14221,7
2021-07-31,공항철도 1호선,서울역,4660,5106,9766,7
2021-07-31,2호선,강남,41805,40653,82458,7
2021-07-31,2호선,선릉,16978,14866,31844,7
2021-07-31,2호선,잠실(송파구청),40874,39139,80013,7
2021-07-31,1호선,서울역,19227,20630,39857,7
2021-07-31,경의선,홍대입구,1165,1274,2439,7
2021-07-31,4호선,사당,13318,11339,24657,7
2021-07-31,4호선,서울역,3642,7363,11005,7
2021-07-31,3호선,고속터미널,30643,33184,63827,7
2021-08-01,분당선,선릉,1929,2710,4639,8
2021-08-01,공항철도 1호선,홍대입구,5472,5283,10755,8
2021-08-01,공항철도 1호선,서울역,5088,4192,9280,8
2021-08-01,경의선,홍대입구,953,1139,2092,8
2021-08-01,경의선,서울역,701,636,1337,8
2021-08-01,경부선,가산디지털단지,3164,4650,7814,8
2021-08-01,경부선,서울역,4556,1013,5569,8
2021-08-01,9호선,고속터미널,6436,7929,14365,8
2021-08-01,8호선,잠실(송파구청),7213,7592,14805,8
2021-08-01,7호선,가산디지털단지,7587,6916,14503,8
2021-08-01,7호선,고속터미널,8568,5002,13570,8
2021-08-01,4호선,사당,9424,8501,17925,8
2021-08-01,4호선,서울역,2594,5476,8070,8
2021-08-01,3호선,고속터미널,27221,23843,51064,8
2021-08-01,2호선,홍대입구,27687,27235,54922,8
2021-08-01,2호선,구로디지털단지,16018,16141,32159,8
2021-08-01,2호선,신림,25620,25776,51396,8
2021-08-01,2호선,사당,12913,13979,26892,8
2021-08-01,2호선,강남,22794,21657,44451,8
2021-08-01,2호선,선릉,8611,7569,16180,8
2021-08-01,2호선,잠실(송파구청),29791,28084,57875,8
2021-08-01,1호선,서울역,17896,15468,33364,8
2021-08-02,분당선,선릉,10989,16199,27188,8
2021-08-02,공항철도 1호선,홍대입구,7179,7227,14406,8
2021-08-02,공항철도 1호선,서울역,5940,5261,11201,8
2021-08-02,경의선,홍대입구,34,59,93,8
2021-08-02,경의선,홍대입구,1254,1448,2702,8
2021-08-02,경의선,서울역,3426,4120,7546,8
2021-08-02,경부선,가산디지털단지,14675,17477,32152,8
2021-08-02,경부선,서울역,4617,1393,6010,8
2021-08-02,9호선,고속터미널,9452,11580,21032,8
2021-08-02,8호선,잠실(송파구청),11150,12772,23922,8
2021-08-02,7호선,가산디지털단지,38828,38542,77370,8
2021-08-02,7호선,고속터미널,13820,10906,24726,8
2021-08-02,4호선,사당,18554,15420,33974,8
2021-08-02,4호선,서울역,8593,11505,20098,8
2021-08-02,3호선,고속터미널,30803,28461,59264,8
2021-08-02,2호선,홍대입구,39030,39519,78549,8
2021-08-02,2호선,구로디지털단지,49371,50207,99578,8
2021-08-02,2호선,신림,51573,50148,101721,8
2021-08-02,2호선,사당,27253,29983,57236,8
2021-08-02,2호선,강남,70147,68166,138313,8
2021-08-02,2호선,선릉,45995,40913,86908,8
2021-08-02,2호선,잠실(송파구청),51592,51611,103203,8
2021-08-02,1호선,서울역,33689,30803,64492,8
2021-08-03,1호선,서울역,33138,30410,63548,8
2021-08-03,2호선,잠실(송파구청),53157,53003,106160,8
2021-08-03,2호선,선릉,46871,41354,88225,8
2021-08-03,2호선,강남,70995,68779,139774,8
2021-08-03,2호선,사당,28304,30768,59072,8
2021-08-03,2호선,신림,52248,51184,103432,8
2021-08-03,2호선,구로디지털단지,50029,50639,100668,8
2021-08-03,2호선,홍대입구,39311,40031,79342,8
2021-08-03,3호선,고속터미널,30682,28868,59550,8
2021-08-03,4호선,서울역,8591,11415,20006,8
2021-08-03,4호선,사당,19201,15816,35017,8
2021-08-03,7호선,고속터미널,13211,11009,24220,8
2021-08-03,7호선,가산디지털단지,38876,38299,77175,8
2021-08-03,8호선,잠실(송파구청),11370,13034,24404,8
2021-08-03,9호선,고속터미널,9556,11748,21304,8
2021-08-03,경부선,서울역,4111,1243,5354,8
2021-08-03,경부선,가산디지털단지,14368,17209,31577,8
2021-08-03,경의선,서울역,3464,4094,7558,8
2021-08-03,경의선,홍대입구,1387,1519,2906,8
2021-08-03,공항철도 1호선,서울역,5843,4995,10838,8
2021-08-03,공항철도 1호선,홍대입구,7255,7189,14444,8
2021-08-03,분당선,선릉,11041,16263,27304,8
2021-08-04,2호선,잠실(송파구청),54898,54434,109332,8
2021-08-04,공항철도 1호선,서울역,5735,5090,10825,8
2021-08-04,공항철도 1호선,홍대입구,7421,7308,14729,8
2021-08-04,분당선,선릉,11006,16208,27214,8
2021-08-04,1호선,서울역,32699,30765,63464,8
2021-08-04,2호선,선릉,47067,41581,88648,8
2021-08-04,2호선,강남,70275,68322,138597,8
2021-08-04,2호선,사당,28645,31225,59870,8
2021-08-04,2호선,신림,52760,51382,104142,8
2021-08-04,2호선,구로디지털단지,50673,51135,101808,8
2021-08-04,2호선,홍대입구,40154,41112,81266,8
2021-08-04,3호선,고속터미널,30888,29405,60293,8
2021-08-04,4호선,서울역,8678,11645,20323,8
2021-08-04,4호선,사당,19693,15960,35653,8
2021-08-04,7호선,고속터미널,12618,10728,23346,8
2021-08-04,7호선,가산디지털단지,38669,38197,76866,8
2021-08-04,8호선,잠실(송파구청),11544,13331,24875,8
2021-08-04,9호선,고속터미널,9564,12313,21877,8
2021-08-04,경부선,서울역,4133,1318,5451,8
2021-08-04,경부선,가산디지털단지,14393,17040,31433,8
2021-08-04,경의선,서울역,3487,4135,7622,8
2021-08-04,경의선,홍대입구,1283,1541,2824,8
2021-08-05,1호선,서울역,33127,31822,64949,8
2021-08-05,2호선,잠실(송파구청),54257,53821,108078,8
2021-08-05,2호선,선릉,47840,42539,90379,8
2021-08-05,2호선,강남,70718,68542,139260,8
2021-08-05,2호선,사당,28869,31080,59949,8
2021-08-05,2호선,신림,53711,52109,105820,8
2021-08-05,2호선,구로디지털단지,51256,51572,102828,8
2021-08-05,2호선,홍대입구,41466,42538,84004,8
2021-08-05,3호선,고속터미널,31416,30858,62274,8
2021-08-05,4호선,서울역,8753,11736,20489,8
2021-08-05,4호선,사당,19833,16411,36244,8
2021-08-05,7호선,고속터미널,12707,10904,23611,8
2021-08-05,7호선,가산디지털단지,40157,39639,79796,8
2021-08-05,8호선,잠실(송파구청),11470,13038,24508,8
2021-08-05,9호선,고속터미널,9594,12370,21964,8
2021-08-05,경부선,서울역,3859,1346,5205,8
2021-08-05,경부선,가산디지털단지,14826,17652,32478,8
2021-08-05,경의선,서울역,3513,4332,7845,8
2021-08-05,경의선,홍대입구,1433,1570,3003,8
2021-08-05,공항철도 1호선,서울역,5860,5547,11407,8
2021-08-05,공항철도 1호선,홍대입구,7692,7622,15314,8
2021-08-05,분당선,선릉,11246,16466,27712,8
2021-08-06,2호선,강남,72165,69679,141844,8
2021-08-06,2호선,선릉,46806,41510,88316,8
2021-08-06,2호선,잠실(송파구청),55880,55544,111424,8
2021-08-06,1호선,서울역,34834,34595,69429,8
2021-08-06,분당선,선릉,11056,16134,27190,8
2021-08-06,공항철도 1호선,홍대입구,7981,8049,16030,8
2021-08-06,공항철도 1호선,서울역,6842,6449,13291,8
2021-08-06,경의선,홍대입구,1440,1588,3028,8
2021-08-06,경의선,서울역,3580,4386,7966,8
2021-08-06,경부선,가산디지털단지,14824,17278,32102,8
2021-08-06,경부선,서울역,4896,1753,6649,8
2021-08-06,9호선,고속터미널,10454,14214,24668,8
2021-08-06,8호선,잠실(송파구청),12022,13771,25793,8
2021-08-06,7호선,가산디지털단지,39367,38877,78244,8
2021-08-06,7호선,고속터미널,13770,11946,25716,8
2021-08-06,4호선,사당,20148,16538,36686,8
2021-08-06,4호선,서울역,8630,12919,21549,8
2021-08-06,3호선,고속터미널,34809,37184,71993,8
2021-08-06,2호선,홍대입구,42783,43596,86379,8
2021-08-06,2호선,구로디지털단지,51215,51437,102652,8
2021-08-06,2호선,신림,54895,52930,107825,8
2021-08-06,2호선,사당,29283,31611,60894,8
2021-08-07,1호선,서울역,19372,20054,39426,8
2021-08-07,2호선,잠실(송파구청),42549,41255,83804,8
2021-08-07,2호선,선릉,17593,15500,33093,8
2021-08-07,2호선,강남,44891,43388,88279,8
2021-08-07,2호선,사당,20493,22147,42640,8
2021-08-07,2호선,신림,39029,37540,76569,8
2021-08-07,2호선,구로디지털단지,26272,25628,51900,8
2021-08-07,2호선,홍대입구,40407,41434,81841,8
2021-08-07,3호선,고속터미널,31873,32775,64648,8
2021-08-07,4호선,서울역,3785,7284,11069,8
2021-08-07,4호선,사당,13908,12223,26131,8
2021-08-07,7호선,고속터미널,9029,7239,16268,8
2021-08-07,7호선,가산디지털단지,11122,10234,21356,8
2021-08-07,8호선,잠실(송파구청),9244,10339,19583,8
2021-08-07,9호선,고속터미널,8480,11790,20270,8
2021-08-07,경부선,서울역,3398,1152,4550,8
2021-08-07,경부선,가산디지털단지,4585,6201,10786,8
2021-08-07,경의선,서울역,868,975,1843,8
2021-08-07,경의선,홍대입구,1383,1507,2890,8
2021-08-07,공항철도 1호선,서울역,4771,4764,9535,8
2021-08-07,공항철도 1호선,홍대입구,8021,7811,15832,8
2021-08-07,분당선,선릉,3883,5502,9385,8
2021-08-08,분당선,선릉,2026,2987,5013,8
2021-08-08,1호선,서울역,18041,15212,33253,8
2021-08-08,2호선,잠실(송파구청),31090,29039,60129,8
2021-08-08,2호선,선릉,9172,7947,17119,8
2021-08-08,2호선,강남,24489,23435,47924,8
2021-08-08,2호선,사당,13870,15200,29070,8
2021-08-08,2호선,신림,27117,27173,54290,8
2021-08-08,2호선,구로디지털단지,16575,16606,33181,8
2021-08-08,2호선,홍대입구,30789,30715,61504,8
2021-08-08,3호선,고속터미널,27806,24426,52232,8
2021-08-08,4호선,서울역,2771,5368,8139,8
2021-08-08,4호선,사당,9985,9450,19435,8
2021-08-08,7호선,고속터미널,8634,5283,13917,8
2021-08-08,7호선,가산디지털단지,7359,6891,14250,8
2021-08-08,8호선,잠실(송파구청),6770,7605,14375,8
2021-08-08,9호선,고속터미널,6840,8420,15260,8
2021-08-08,경부선,서울역,4447,1051,5498,8
2021-08-08,경부선,가산디지털단지,3282,4619,7901,8
2021-08-08,경의선,서울역,756,688,1444,8
2021-08-08,경의선,홍대입구,1124,1228,2352,8
2021-08-08,공항철도 1호선,서울역,5234,4036,9270,8
2021-08-08,공항철도 1호선,홍대입구,6204,6203,12407,8
2021-08-09,분당선,선릉,12017,17512,29529,8
2021-08-09,공항철도 1호선,홍대입구,7494,7489,14983,8
2021-08-09,공항철도 1호선,서울역,6049,5509,11558,8
2021-08-09,경의선,홍대입구,1384,1508,2892,8
2021-08-09,경의선,서울역,3644,4433,8077,8
2021-08-09,경부선,가산디지털단지,16195,18986,35181,8
2021-08-09,경부선,서울역,4653,1388,6041,8
2021-08-09,9호선,고속터미널,10008,12356,22364,8
2021-08-09,8호선,잠실(송파구청),11385,13130,24515,8
2021-08-09,7호선,가산디지털단지,43288,42929,86217,8
2021-08-09,7호선,고속터미널,13704,11205,24909,8
2021-08-09,4호선,사당,20071,16481,36552,8
2021-08-09,4호선,서울역,9181,11882,21063,8
2021-08-09,3호선,고속터미널,32881,30753,63634,8
2021-08-09,2호선,홍대입구,40581,41533,82114,8
2021-08-09,2호선,구로디지털단지,53149,53860,107009,8
2021-08-09,2호선,신림,54957,53864,108821,8
2021-08-09,2호선,사당,29191,32286,61477,8
2021-08-09,2호선,강남,73489,71365,144854,8
2021-08-09,2호선,선릉,50018,44547,94565,8
2021-08-09,2호선,잠실(송파구청),54423,54131,108554,8
2021-08-09,1호선,서울역,34351,32137,66488,8
2021-08-10,분당선,선릉,11933,17638,29571,8
2021-08-10,공항철도 1호선,홍대입구,7606,7734,15340,8
2021-08-10,공항철도 1호선,서울역,5847,5318,11165,8
2021-08-10,경의선,홍대입구,1409,1477,2886,8
2021-08-10,경의선,서울역,3805,4585,8390,8
2021-08-10,경부선,가산디지털단지,16246,18951,35197,8
2021-08-10,경부선,서울역,4206,1321,5527,8
2021-08-10,9호선,고속터미널,10035,12391,22426,8
2021-08-10,8호선,잠실(송파구청),11586,13251,24837,8
2021-08-10,7호선,가산디지털단지,43366,42929,86295,8
2021-08-10,7호선,고속터미널,13464,11467,24931,8
2021-08-10,4호선,사당,20449,17036,37485,8
2021-08-10,4호선,서울역,9238,12148,21386,8
2021-08-10,3호선,고속터미널,31730,30380,62110,8
2021-08-10,2호선,홍대입구,41446,42331,83777,8
2021-08-10,2호선,구로디지털단지,53635,54060,107695,8
2021-08-10,2호선,신림,55915,54664,110579,8
2021-08-10,2호선,사당,30817,33175,63992,8
2021-08-10,2호선,강남,74307,72076,146383,8
2021-08-10,2호선,선릉,50718,44863,95581,8
2021-08-10,2호선,잠실(송파구청),55259,55258,110517,8
2021-08-10,1호선,서울역,33688,32091,65779,8
2021-08-11,1호선,서울역,33257,31727,64984,8
2021-08-11,2호선,잠실(송파구청),56451,56057,112508,8
2021-08-11,2호선,선릉,50342,44680,95022,8
2021-08-11,2호선,강남,72779,70599,143378,8
2021-08-11,2호선,사당,30328,32687,63015,8
2021-08-11,2호선,신림,55403,54074,109477,8
2021-08-11,2호선,구로디지털단지,52869,53264,106133,8
2021-08-11,2호선,홍대입구,42273,42973,85246,8
2021-08-11,3호선,고속터미널,31949,30918,62867,8
2021-08-11,4호선,서울역,9138,12129,21267,8
2021-08-11,4호선,사당,20363,16725,37088,8
2021-08-11,7호선,고속터미널,12775,11123,23898,8
2021-08-11,7호선,가산디지털단지,42515,42316,84831,8
2021-08-11,8호선,잠실(송파구청),11725,13512,25237,8
2021-08-11,9호선,고속터미널,10062,12609,22671,8
2021-08-11,경부선,서울역,4110,1495,5605,8
2021-08-11,경부선,가산디지털단지,15902,18623,34525,8
2021-08-11,경의선,서울역,3597,4255,7852,8
2021-08-11,경의선,홍대입구,1474,1536,3010,8
2021-08-11,공항철도 1호선,서울역,5843,5296,11139,8
2021-08-11,공항철도 1호선,홍대입구,7713,7777,15490,8
2021-08-11,분당선,선릉,11896,17389,29285,8
2021-08-12,1호선,서울역,33479,32642,66121,8
2021-08-12,분당선,선릉,12051,17259,29310,8
2021-08-12,공항철도 1호선,홍대입구,7880,7786,15666,8
2021-08-12,공항철도 1호선,서울역,6008,5730,11738,8
2021-08-12,경의선,홍대입구,1423,1662,3085,8
2021-08-12,경의선,서울역,3603,4380,7983,8
2021-08-12,경부선,가산디지털단지,15519,18505,34024,8
2021-08-12,경부선,서울역,4126,1523,5649,8
2021-08-12,9호선,고속터미널,9976,12863,22839,8
2021-08-12,8호선,잠실(송파구청),11784,13363,25147,8
2021-08-12,7호선,가산디지털단지,42426,41614,84040,8
2021-08-12,7호선,고속터미널,12906,11198,24104,8
2021-08-12,4호선,사당,20452,16575,37027,8
2021-08-12,4호선,서울역,8915,12222,21137,8
2021-08-12,3호선,고속터미널,32623,31954,64577,8
2021-08-12,2호선,홍대입구,42526,43460,85986,8
2021-08-12,2호선,구로디지털단지,52661,52780,105441,8
2021-08-12,2호선,신림,55027,53686,108713,8
2021-08-12,2호선,사당,30056,32441,62497,8
2021-08-12,2호선,강남,72672,70075,142747,8
2021-08-12,2호선,선릉,49676,44374,94050,8
2021-08-12,2호선,잠실(송파구청),55595,54937,110532,8
2021-08-13,1호선,서울역,35691,37301,72992,8
2021-08-13,2호선,잠실(송파구청),56330,55755,112085,8
2021-08-13,2호선,선릉,48258,43071,91329,8
2021-08-13,2호선,강남,73098,71055,144153,8
2021-08-13,2호선,사당,30795,33085,63880,8
2021-08-13,2호선,신림,56026,53745,109771,8
2021-08-13,2호선,구로디지털단지,51625,51405,103030,8
2021-08-13,2호선,홍대입구,44890,46471,91361,8
2021-08-13,3호선,고속터미널,35533,40695,76228,8
2021-08-13,4호선,서울역,8781,14200,22981,8
2021-08-13,4호선,사당,20855,17154,38009,8
2021-08-13,7호선,고속터미널,13757,12229,25986,8
2021-08-13,7호선,가산디지털단지,40508,39923,80431,8
2021-08-13,8호선,잠실(송파구청),11954,13719,25673,8
2021-08-13,9호선,고속터미널,11023,15333,26356,8
2021-08-13,경부선,서울역,5261,2029,7290,8
2021-08-13,경부선,가산디지털단지,15360,17984,33344,8
2021-08-13,경의선,서울역,3550,4573,8123,8
2021-08-13,경의선,홍대입구,1527,1640,3167,8
2021-08-13,공항철도 1호선,서울역,7072,7255,14327,8
2021-08-13,공항철도 1호선,홍대입구,8630,8473,17103,8
2021-08-13,분당선,선릉,11520,16735,28255,8
2021-08-14,분당선,선릉,3836,5638,9474,8
2021-08-14,공항철도 1호선,홍대입구,8343,7729,16072,8
2021-08-14,공항철도 1호선,서울역,5107,5785,10892,8
2021-08-14,경의선,서울역,6,18,24,8
2021-08-14,경의선,홍대입구,1525,1604,3129,8
2021-08-14,경의선,서울역,952,1038,1990,8
2021-08-14,경부선,가산디지털단지,4839,6194,11033,8
2021-08-14,경부선,서울역,3535,1418,4953,8
2021-08-14,9호선,고속터미널,8713,13093,21806,8
2021-08-14,8호선,잠실(송파구청),8915,10248,19163,8
2021-08-14,7호선,가산디지털단지,11382,10408,21790,8
2021-08-14,7호선,고속터미널,9525,7988,17513,8
2021-08-14,4호선,사당,14427,12368,26795,8
2021-08-14,4호선,서울역,4213,8882,13095,8
2021-08-14,3호선,고속터미널,32320,35864,68184,8
2021-08-14,2호선,홍대입구,40723,42244,82967,8
2021-08-14,2호선,구로디지털단지,26562,25727,52289,8
2021-08-14,2호선,신림,39928,37671,77599,8
2021-08-14,2호선,사당,21009,22939,43948,8
2021-08-14,2호선,강남,44818,43969,88787,8
2021-08-14,2호선,선릉,17698,15643,33341,8
2021-08-14,2호선,잠실(송파구청),43446,41597,85043,8
2021-08-14,1호선,서울역,21222,23912,45134,8
2021-08-15,분당선,선릉,2070,3081,5151,8
2021-08-15,공항철도 1호선,홍대입구,6947,6826,13773,8
2021-08-15,공항철도 1호선,서울역,4885,4244,9129,8
2021-08-15,경의선,홍대입구,1221,1445,2666,8
2021-08-15,경의선,서울역,796,776,1572,8
2021-08-15,경부선,가산디지털단지,3601,4875,8476,8
2021-08-15,경부선,서울역,3882,816,4698,8
2021-08-15,9호선,고속터미널,7023,8946,15969,8
2021-08-15,8호선,잠실(송파구청),7448,8617,16065,8
2021-08-15,7호선,가산디지털단지,8067,7307,15374,8
2021-08-15,7호선,고속터미널,8374,5572,13946,8
2021-08-15,4호선,사당,10750,9781,20531,8
2021-08-15,4호선,서울역,3125,6071,9196,8
2021-08-15,3호선,고속터미널,26967,25089,52056,8
2021-08-15,2호선,홍대입구,33907,34520,68427,8
2021-08-15,2호선,구로디지털단지,18045,17441,35486,8
2021-08-15,2호선,신림,29527,29143,58670,8
2021-08-15,2호선,사당,15285,16564,31849,8
2021-08-15,2호선,강남,25274,24398,49672,8
2021-08-15,2호선,선릉,9603,8411,18014,8
2021-08-15,2호선,잠실(송파구청),34759,33065,67824,8
2021-08-15,1호선,서울역,18677,16682,35359,8
2021-08-16,1호선,서울역,25243,20057,45300,8
2021-08-16,2호선,잠실(송파구청),37925,35734,73659,8
2021-08-16,2호선,선릉,17369,15768,33137,8
2021-08-16,2호선,강남,39229,38550,77779,8
2021-08-16,2호선,사당,18422,20610,39032,8
2021-08-16,2호선,신림,36035,36215,72250,8
2021-08-16,2호선,구로디지털단지,24877,25364,50241,8
2021-08-16,2호선,홍대입구,35188,35579,70767,8
2021-08-16,3호선,고속터미널,34720,28883,63603,8
2021-08-16,4호선,서울역,3751,6798,10549,8
2021-08-16,4호선,사당,12975,11567,24542,8
2021-08-16,7호선,고속터미널,13444,8527,21971,8
2021-08-16,7호선,가산디지털단지,11694,11410,23104,8
2021-08-16,8호선,잠실(송파구청),8257,9154,17411,8
2021-08-16,9호선,고속터미널,8956,10336,19292,8
2021-08-16,경부선,서울역,5946,1114,7060,8
2021-08-16,경부선,가산디지털단지,4866,6739,11605,8
2021-08-16,경의선,서울역,1294,1981,3275,8
2021-08-16,경의선,홍대입구,1077,1234,2311,8
2021-08-16,공항철도 1호선,서울역,6018,4491,10509,8
2021-08-16,공항철도 1호선,홍대입구,6916,6592,13508,8
2021-08-16,분당선,선릉,3655,5460,9115,8
2021-08-17,1호선,서울역,35636,33095,68731,8
2021-08-17,2호선,잠실(송파구청),55185,54953,110138,8
2021-08-17,2호선,선릉,50945,45388,96333,8
2021-08-17,2호선,강남,73578,70997,144575,8
2021-08-17,2호선,사당,29997,32531,62528,8
2021-08-17,2호선,신림,55246,55063,110309,8
2021-08-17,2호선,구로디지털단지,53667,54559,108226,8
2021-08-17,2호선,홍대입구,41857,42025,83882,8
2021-08-17,3호선,고속터미널,32845,29935,62780,8
2021-08-17,4호선,서울역,9169,11991,21160,8
2021-08-17,4호선,사당,20701,17048,37749,8
2021-08-17,7호선,고속터미널,14075,11425,25500,8
2021-08-17,7호선,가산디지털단지,44216,42657,86873,8
2021-08-17,8호선,잠실(송파구청),11667,13155,24822,8
2021-08-17,9호선,고속터미널,10001,12268,22269,8
2021-08-17,경부선,서울역,5056,1479,6535,8
2021-08-17,경부선,가산디지털단지,15782,19016,34798,8
2021-08-17,경의선,서울역,3654,4556,8210,8
2021-08-17,경의선,홍대입구,1272,1437,2709,8
2021-08-17,경의선,서울역,153,58,211,8
2021-08-17,공항철도 1호선,서울역,6202,5616,11818,8
2021-08-17,공항철도 1호선,홍대입구,7289,7436,14725,8
2021-08-17,분당선,선릉,12236,17777,30013,8
2021-08-18,분당선,선릉,11967,17753,29720,8
2021-08-18,공항철도 1호선,홍대입구,7751,7782,15533,8
2021-08-18,공항철도 1호선,서울역,5872,5413,11285,8
2021-08-18,경의선,홍대입구,1453,1566,3019,8
2021-08-18,경의선,서울역,3619,4339,7958,8
2021-08-18,경부선,가산디지털단지,16202,18828,35030,8
2021-08-18,경부선,서울역,4136,1377,5513,8
2021-08-18,9호선,고속터미널,9944,12209,22153,8
2021-08-18,8호선,잠실(송파구청),11622,13402,25024,8
2021-08-18,7호선,가산디지털단지,42699,42926,85625,8
2021-08-18,7호선,고속터미널,13162,11313,24475,8
2021-08-18,4호선,사당,20358,16772,37130,8
2021-08-18,4호선,서울역,9099,12216,21315,8
2021-08-18,3호선,고속터미널,31462,30044,61506,8
2021-08-18,2호선,홍대입구,41659,42899,84558,8
2021-08-18,2호선,구로디지털단지,53122,54032,107154,8
2021-08-18,2호선,신림,56002,54007,110009,8
2021-08-18,2호선,사당,30092,32581,62673,8
2021-08-18,2호선,강남,72304,70649,142953,8
2021-08-18,2호선,선릉,50155,44379,94534,8
2021-08-18,2호선,잠실(송파구청),55980,55534,111514,8
2021-08-18,1호선,서울역,34561,32551,67112,8
2021-08-19,2호선,잠실(송파구청),56599,56624,113223,8
2021-08-19,2호선,선릉,51034,45648,96682,8
2021-08-19,2호선,강남,73185,71173,144358,8
2021-08-19,2호선,사당,31198,33452,64650,8
2021-08-19,2호선,신림,56743,55045,111788,8
2021-08-19,2호선,구로디지털단지,54081,54606,108687,8
2021-08-19,2호선,홍대입구,43382,44779,88161,8
2021-08-19,3호선,고속터미널,32186,30981,63167,8
2021-08-19,4호선,서울역,9192,12511,21703,8
2021-08-19,4호선,사당,21028,17092,38120,8
2021-08-19,7호선,고속터미널,13253,11678,24931,8
2021-08-19,7호선,가산디지털단지,42783,42699,85482,8
2021-08-19,8호선,잠실(송파구청),11825,13552,25377,8
2021-08-19,9호선,고속터미널,10110,12898,23008,8
2021-08-19,경부선,서울역,4315,1473,5788,8
2021-08-19,경부선,가산디지털단지,16215,19089,35304,8
2021-08-19,경의선,서울역,3874,4625,8499,8
2021-08-19,경의선,홍대입구,1469,1532,3001,8
2021-08-19,공항철도 1호선,서울역,6230,5700,11930,8
2021-08-19,공항철도 1호선,홍대입구,7911,7893,15804,8
2021-08-19,분당선,선릉,12166,17721,29887,8
2021-08-19,1호선,서울역,35407,33888,69295,8
2021-08-20,1호선,서울역,37993,37072,75065,8
2021-08-20,2호선,잠실(송파구청),58044,58080,116124,8
2021-08-20,2호선,선릉,50237,44496,94733,8
2021-08-20,2호선,강남,75259,73070,148329,8
2021-08-20,2호선,사당,31711,34098,65809,8
2021-08-20,2호선,신림,58040,56441,114481,8
2021-08-20,2호선,구로디지털단지,54140,54399,108539,8
2021-08-20,2호선,홍대입구,44788,46527,91315,8
2021-08-20,3호선,고속터미널,35775,37568,73343,8
2021-08-20,4호선,서울역,9138,13481,22619,8
2021-08-20,4호선,사당,21852,17595,39447,8
2021-08-20,7호선,고속터미널,14691,12382,27073,8
2021-08-20,7호선,가산디지털단지,42575,41769,84344,8
2021-08-20,8호선,잠실(송파구청),12082,14117,26199,8
2021-08-20,9호선,고속터미널,10899,14594,25493,8
2021-08-20,경부선,서울역,5472,1943,7415,8
2021-08-20,경부선,가산디지털단지,16236,18915,35151,8
2021-08-20,경의선,서울역,3928,4750,8678,8
2021-08-20,경의선,홍대입구,1493,1659,3152,8
2021-08-20,공항철도 1호선,서울역,7025,6729,13754,8
2021-08-20,공항철도 1호선,홍대입구,8396,8373,16769,8
2021-08-20,분당선,선릉,12172,17807,29979,8
2021-08-21,분당선,선릉,3897,5787,9684,8
2021-08-21,공항철도 1호선,홍대입구,7282,7182,14464,8
2021-08-21,공항철도 1호선,서울역,5324,6777,12101,8
2021-08-21,경의선,홍대입구,1230,1401,2631,8
2021-08-21,경의선,서울역,872,957,1829,8
2021-08-21,경부선,가산디지털단지,4351,6011,10362,8
2021-08-21,경부선,서울역,4000,1252,5252,8
2021-08-21,9호선,고속터미널,7899,11395,19294,8
2021-08-21,8호선,잠실(송파구청),8895,10278,19173,8
2021-08-21,7호선,가산디지털단지,10373,9467,19840,8
2021-08-21,7호선,고속터미널,9261,7424,16685,8
2021-08-21,4호선,사당,13661,11549,25210,8
2021-08-21,4호선,서울역,3704,7816,11520,8
2021-08-21,3호선,고속터미널,31775,32615,64390,8
2021-08-21,2호선,홍대입구,37771,38827,76598,8
2021-08-21,2호선,구로디지털단지,24684,24622,49306,8
2021-08-21,2호선,신림,37745,36401,74146,8
2021-08-21,2호선,사당,20043,21585,41628,8
2021-08-21,2호선,강남,43842,42706,86548,8
2021-08-21,2호선,선릉,17394,15585,32979,8
2021-08-21,2호선,잠실(송파구청),41760,40312,82072,8
2021-08-21,1호선,서울역,20301,20642,40943,8
2021-08-22,1호선,서울역,18499,17153,35652,8
2021-08-22,2호선,잠실(송파구청),33749,31636,65385,8
2021-08-22,2호선,선릉,10010,8682,18692,8
2021-08-22,2호선,강남,27292,26207,53499,8
2021-08-22,2호선,사당,15900,17362,33262,8
2021-08-22,2호선,신림,29569,29569,59138,8
2021-08-22,2호선,구로디지털단지,18618,18333,36951,8
2021-08-22,2호선,홍대입구,34805,35011,69816,8
2021-08-22,3호선,고속터미널,28956,26322,55278,8
2021-08-22,4호선,서울역,3038,6023,9061,8
2021-08-22,4호선,사당,11140,10506,21646,8
2021-08-22,7호선,고속터미널,8885,5707,14592,8
2021-08-22,7호선,가산디지털단지,7947,7490,15437,8
2021-08-22,8호선,잠실(송파구청),7327,7962,15289,8
2021-08-22,9호선,고속터미널,7377,9367,16744,8
2021-08-22,경부선,서울역,4419,1003,5422,8
2021-08-22,경부선,가산디지털단지,3733,5131,8864,8
2021-08-22,경의선,서울역,757,733,1490,8
2021-08-22,경의선,홍대입구,1244,1428,2672,8
2021-08-22,경의선,서울역,47,34,81,8
2021-08-22,공항철도 1호선,서울역,5275,4484,9759,8
2021-08-22,공항철도 1호선,홍대입구,7268,6704,13972,8
2021-08-22,분당선,선릉,2322,3208,5530,8
2021-08-23,2호선,잠실(송파구청),51164,50395,101559,8
2021-08-23,2호선,선릉,51286,45468,96754,8
2021-08-23,2호선,강남,72246,70021,142267,8
2021-08-23,2호선,사당,29546,32024,61570,8
2021-08-23,2호선,신림,55013,54335,109348,8
2021-08-23,2호선,구로디지털단지,53818,54153,107971,8
2021-08-23,2호선,홍대입구,39677,40039,79716,8
2021-08-23,3호선,고속터미널,28859,26211,55070,8
2021-08-23,4호선,서울역,9014,12251,21265,8
2021-08-23,4호선,사당,20130,16602,36732,8
2021-08-23,7호선,고속터미널,13624,11129,24753,8
2021-08-23,7호선,가산디지털단지,44862,43440,88302,8
2021-08-23,8호선,잠실(송파구청),11224,12610,23834,8
2021-08-23,9호선,고속터미널,9244,11606,20850,8
2021-08-23,경부선,서울역,4793,1568,6361,8
2021-08-23,경부선,가산디지털단지,16641,19659,36300,8
2021-08-23,경의선,서울역,3724,4563,8287,8
2021-08-23,경의선,홍대입구,1199,1423,2622,8
2021-08-23,공항철도 1호선,서울역,6160,5612,11772,8
2021-08-23,공항철도 1호선,홍대입구,6968,7169,14137,8
2021-08-23,분당선,선릉,12378,18193,30571,8
2021-08-23,1호선,서울역,35759,33672,69431,8
2021-08-24,분당선,선릉,12290,17797,30087,8
2021-08-24,공항철도 1호선,홍대입구,7026,7238,14264,8
2021-08-24,공항철도 1호선,서울역,6047,6308,12355,8
2021-08-24,경의선,홍대입구,1309,1388,2697,8
2021-08-24,경의선,서울역,3747,4481,8228,8
2021-08-24,경부선,가산디지털단지,16422,19169,35591,8
2021-08-24,경부선,서울역,4330,1482,5812,8
2021-08-24,9호선,고속터미널,9625,12015,21640,8
2021-08-24,8호선,잠실(송파구청),11416,12985,24401,8
2021-08-24,7호선,가산디지털단지,43580,43211,86791,8
2021-08-24,7호선,고속터미널,12612,10998,23610,8
2021-08-24,4호선,사당,20154,16714,36868,8
2021-08-24,4호선,서울역,9120,12193,21313,8
2021-08-24,3호선,고속터미널,31008,29132,60140,8
2021-08-24,2호선,홍대입구,40396,40967,81363,8
2021-08-24,2호선,구로디지털단지,53538,53949,107487,8
2021-08-24,2호선,신림,55466,54430,109896,8
2021-08-24,2호선,사당,30047,32226,62273,8
2021-08-24,2호선,강남,72315,70486,142801,8
2021-08-24,2호선,선릉,50336,44666,95002,8
2021-08-24,2호선,잠실(송파구청),53841,53454,107295,8
2021-08-24,1호선,서울역,34723,32829,67552,8
2021-08-25,분당선,선릉,12457,18109,30566,8
2021-08-25,공항철도 1호선,홍대입구,8119,8264,16383,8
2021-08-25,공항철도 1호선,서울역,6336,5646,11982,8
2021-08-25,경의선,서울역,27,21,48,8
2021-08-25,경의선,홍대입구,1489,1644,3133,8
2021-08-25,경의선,서울역,3830,4618,8448,8
2021-08-25,경부선,가산디지털단지,16636,19501,36137,8
2021-08-25,경부선,서울역,4409,1456,5865,8
2021-08-25,9호선,고속터미널,10276,12842,23118,8
2021-08-25,8호선,잠실(송파구청),11616,13596,25212,8
2021-08-25,7호선,가산디지털단지,43410,43585,86995,8
2021-08-25,7호선,고속터미널,13083,11413,24496,8
2021-08-25,4호선,사당,21131,17513,38644,8
2021-08-25,4호선,서울역,9473,12921,22394,8
2021-08-25,3호선,고속터미널,32227,30559,62786,8
2021-08-25,2호선,홍대입구,44864,44848,89712,8
2021-08-25,2호선,구로디지털단지,54995,55770,110765,8
2021-08-25,2호선,신림,57921,56124,114045,8
2021-08-25,2호선,사당,31417,33849,65266,8
2021-08-25,2호선,강남,73704,71554,145258,8
2021-08-25,2호선,선릉,51625,45987,97612,8
2021-08-25,2호선,잠실(송파구청),57035,56733,113768,8
2021-08-25,1호선,서울역,36350,34559,70909,8
2021-08-26,1호선,서울역,36063,34777,70840,8
2021-08-26,2호선,잠실(송파구청),56627,56814,113441,8
2021-08-26,2호선,선릉,51144,45622,96766,8
2021-08-26,2호선,강남,73283,71008,144291,8
2021-08-26,2호선,사당,32255,34051,66306,8
2021-08-26,2호선,신림,57649,56340,113989,8
2021-08-26,2호선,구로디지털단지,54787,55207,109994,8
2021-08-26,2호선,홍대입구,44622,44840,89462,8
2021-08-26,3호선,고속터미널,32649,31584,64233,8
2021-08-26,4호선,서울역,9217,12936,22153,8
2021-08-26,4호선,사당,20549,17644,38193,8
2021-08-26,7호선,고속터미널,13188,11691,24879,8
2021-08-26,7호선,가산디지털단지,43505,43051,86556,8
2021-08-26,8호선,잠실(송파구청),11757,13591,25348,8
2021-08-26,9호선,고속터미널,10232,13068,23300,8
2021-08-26,경부선,서울역,4436,1494,5930,8
2021-08-26,경부선,가산디지털단지,16421,19376,35797,8
2021-08-26,경의선,서울역,3929,4730,8659,8
2021-08-26,경의선,홍대입구,1343,1561,2904,8
2021-08-26,경의선,홍대입구,113,30,143,8
2021-08-26,공항철도 1호선,서울역,6426,5910,12336,8
2021-08-26,공항철도 1호선,홍대입구,8140,8261,16401,8
2021-08-26,분당선,선릉,12414,18027,30441,8
2021-08-27,7호선,고속터미널,14601,12369,26970,8
2021-08-27,7호선,가산디지털단지,42062,41506,83568,8
2021-08-27,8호선,잠실(송파구청),12150,14150,26300,8
2021-08-27,1호선,서울역,38526,37384,75910,8
2021-08-27,9호선,고속터미널,11029,15010,26039,8
2021-08-27,경부선,서울역,5629,2018,7647,8
2021-08-27,경부선,가산디지털단지,16179,18901,35080,8
2021-08-27,경의선,서울역,3836,4603,8439,8
2021-08-27,경의선,홍대입구,1479,1643,3122,8
2021-08-27,공항철도 1호선,서울역,7306,6894,14200,8
2021-08-27,공항철도 1호선,홍대입구,8443,8424,16867,8
2021-08-27,분당선,선릉,12213,17879,30092,8
2021-08-27,3호선,고속터미널,36185,38470,74655,8
2021-08-27,2호선,홍대입구,44185,46241,90426,8
2021-08-27,4호선,서울역,9212,13780,22992,8
2021-08-27,2호선,잠실(송파구청),57040,56862,113902,8
2021-08-27,4호선,사당,21552,17522,39074,8
2021-08-27,2호선,선릉,50041,44512,94553,8
2021-08-27,2호선,강남,74489,73205,147694,8
2021-08-27,2호선,사당,31583,34184,65767,8
2021-08-27,2호선,신림,58201,56207,114408,8
2021-08-27,2호선,구로디지털단지,53910,54058,107968,8
2021-08-28,1호선,서울역,22988,23724,46712,8
2021-08-28,2호선,잠실(송파구청),48746,46341,95087,8
2021-08-28,2호선,선릉,20001,17467,37468,8
2021-08-28,2호선,강남,50235,48830,99065,8
2021-08-28,2호선,사당,23649,25927,49576,8
2021-08-28,2호선,신림,43150,41124,84274,8
2021-08-28,2호선,구로디지털단지,28689,28416,57105,8
2021-08-28,2호선,홍대입구,47006,49767,96773,8
2021-08-28,3호선,고속터미널,36560,36664,73224,8
2021-08-28,4호선,서울역,4344,8702,13046,8
2021-08-28,4호선,사당,16224,13853,30077,8
2021-08-28,7호선,고속터미널,10361,8492,18853,8
2021-08-28,7호선,가산디지털단지,12163,11156,23319,8
2021-08-28,8호선,잠실(송파구청),9918,11217,21135,8
2021-08-28,9호선,고속터미널,10106,13948,24054,8
2021-08-28,경부선,서울역,4295,1309,5604,8
2021-08-28,경부선,가산디지털단지,5370,7016,12386,8
2021-08-28,경의선,서울역,1076,1140,2216,8
2021-08-28,경의선,홍대입구,1583,1860,3443,8
2021-08-28,공항철도 1호선,서울역,5601,5798,11399,8
2021-08-28,공항철도 1호선,홍대입구,9726,9311,19037,8
2021-08-28,분당선,선릉,4470,6579,11049,8
2021-08-29,1호선,서울역,20334,18287,38621,8
2021-08-29,2호선,잠실(송파구청),36540,34443,70983,8
2021-08-29,2호선,선릉,10682,9115,19797,8
2021-08-29,2호선,강남,28246,26873,55119,8
2021-08-29,2호선,사당,16542,18275,34817,8
2021-08-29,2호선,신림,30737,30405,61142,8
2021-08-29,2호선,구로디지털단지,19159,18985,38144,8
2021-08-29,2호선,홍대입구,36420,36953,73373,8
2021-08-29,3호선,고속터미널,30776,27585,58361,8
2021-08-29,4호선,서울역,3187,6311,9498,8
2021-08-29,4호선,사당,11757,10778,22535,8
2021-08-29,7호선,고속터미널,9446,6036,15482,8
2021-08-29,7호선,가산디지털단지,8472,7786,16258,8
2021-08-29,8호선,잠실(송파구청),7700,8446,16146,8
2021-08-29,9호선,고속터미널,8146,9939,18085,8
2021-08-29,경부선,서울역,5113,1131,6244,8
2021-08-29,경부선,가산디지털단지,3720,5300,9020,8
2021-08-29,경의선,서울역,954,812,1766,8
2021-08-29,경의선,홍대입구,1317,1477,2794,8
2021-08-29,공항철도 1호선,서울역,5725,5032,10757,8
2021-08-29,공항철도 1호선,홍대입구,7960,7389,15349,8
2021-08-29,분당선,선릉,2374,3489,5863,8
2021-08-30,1호선,서울역,36789,34629,71418,8
2021-08-30,2호선,잠실(송파구청),55537,55519,111056,8
2021-08-30,2호선,선릉,51748,46159,97907,8
2021-08-30,2호선,강남,71466,69879,141345,8
2021-08-30,2호선,사당,31163,33580,64743,8
2021-08-30,2호선,신림,56916,56216,113132,8
2021-08-30,2호선,구로디지털단지,55547,56350,111897,8
2021-08-30,2호선,홍대입구,42456,43406,85862,8
2021-08-30,3호선,고속터미널,33532,30707,64239,8
2021-08-30,4호선,서울역,9398,12515,21913,8
2021-08-30,4호선,사당,20874,17339,38213,8
2021-08-30,7호선,고속터미널,14196,11649,25845,8
2021-08-30,7호선,가산디지털단지,44076,43979,88055,8
2021-08-30,8호선,잠실(송파구청),11518,13248,24766,8
2021-08-30,9호선,고속터미널,10350,12682,23032,8
2021-08-30,경부선,서울역,4971,1571,6542,8
2021-08-30,경부선,가산디지털단지,16878,19846,36724,8
2021-08-30,경의선,서울역,3937,4793,8730,8
2021-08-30,경의선,홍대입구,1420,1529,2949,8
2021-08-30,공항철도 1호선,서울역,6466,5908,12374,8
2021-08-30,공항철도 1호선,홍대입구,7731,7810,15541,8
2021-08-30,분당선,선릉,12429,18277,30706,8
2021-08-31,2호선,잠실(송파구청),54107,53302,107409,8
2021-08-31,2호선,선릉,50953,45109,96062,8
2021-08-31,2호선,강남,71127,68437,139564,8
2021-08-31,2호선,사당,30299,31987,62286,8
2021-08-31,2호선,신림,55435,54928,110363,8
2021-08-31,2호선,구로디지털단지,53717,54788,108505,8
2021-08-31,2호선,홍대입구,40883,41033,81916,8
2021-08-31,3호선,고속터미널,32719,30233,62952,8
2021-08-31,4호선,서울역,9354,12188,21542,8
2021-08-31,4호선,사당,20267,17013,37280,8
2021-08-31,7호선,고속터미널,13007,11178,24185,8
2021-08-31,7호선,가산디지털단지,44479,42841,87320,8
2021-08-31,8호선,잠실(송파구청),12015,13358,25373,8
2021-08-31,9호선,고속터미널,9387,12164,21551,8
2021-08-31,경부선,서울역,4393,1447,5840,8
2021-08-31,경부선,가산디지털단지,15853,19316,35169,8
2021-08-31,경의선,서울역,3744,4633,8377,8
2021-08-31,경의선,홍대입구,1155,1416,2571,8
2021-08-31,공항철도 1호선,서울역,5942,5505,11447,8
2021-08-31,공항철도 1호선,홍대입구,6935,7227,14162,8
2021-08-31,분당선,선릉,12711,18149,30860,8
2021-08-31,1호선,서울역,35669,33406,69075,8
2021-09-01,4호선,사당,21027,17484,38511,9
2021-09-01,7호선,고속터미널,12698,11379,24077,9
2021-09-01,1호선,서울역,35230,33318,68548,9
2021-09-01,2호선,잠실(송파구청),55348,55223,110571,9
2021-09-01,2호선,선릉,51605,46283,97888,9
2021-09-01,2호선,강남,72741,70677,143418,9
2021-09-01,2호선,사당,31707,33677,65384,9
2021-09-01,2호선,신림,57414,55826,113240,9
2021-09-01,2호선,구로디지털단지,55520,55746,111266,9
2021-09-01,2호선,홍대입구,42040,43241,85281,9
2021-09-01,3호선,고속터미널,30976,29569,60545,9
2021-09-01,7호선,가산디지털단지,43995,43983,87978,9
2021-09-01,8호선,잠실(송파구청),11569,13464,25033,9
2021-09-01,9호선,고속터미널,9951,12158,22109,9
2021-09-01,경부선,서울역,3769,1385,5154,9
2021-09-01,경부선,가산디지털단지,16706,19899,36605,9
2021-09-01,경의선,서울역,3837,4599,8436,9
2021-09-01,경의선,홍대입구,1395,1510,2905,9
2021-09-01,공항철도 1호선,서울역,5763,5263,11026,9
2021-09-01,공항철도 1호선,홍대입구,7566,7592,15158,9
2021-09-01,분당선,선릉,12410,18118,30528,9
2021-09-01,4호선,서울역,9538,12204,21742,9
2021-09-02,분당선,선릉,12550,18350,30900,9
2021-09-02,공항철도 1호선,홍대입구,7843,7873,15716,9
2021-09-02,공항철도 1호선,서울역,6075,5683,11758,9
2021-09-02,경의선,홍대입구,1522,1664,3186,9
2021-09-02,경의선,서울역,4012,4942,8954,9
2021-09-02,경부선,가산디지털단지,17143,20003,37146,9
2021-09-02,경부선,서울역,4046,1444,5490,9
2021-09-02,9호선,고속터미널,10254,12493,22747,9
2021-09-02,8호선,잠실(송파구청),11464,13381,24845,9
2021-09-02,7호선,가산디지털단지,44184,44245,88429,9
2021-09-02,7호선,고속터미널,13013,11731,24744,9
2021-09-02,4호선,사당,21630,17854,39484,9
2021-09-02,4호선,서울역,9519,12588,22107,9
2021-09-02,3호선,고속터미널,32029,31134,63163,9
2021-09-02,2호선,홍대입구,42535,44201,86736,9
2021-09-02,2호선,구로디지털단지,55484,56162,111646,9
2021-09-02,2호선,신림,57809,56284,114093,9
2021-09-02,2호선,사당,31994,34312,66306,9
2021-09-02,2호선,강남,72762,70497,143259,9
2021-09-02,2호선,선릉,51795,46236,98031,9
2021-09-02,2호선,잠실(송파구청),54944,55152,110096,9
2021-09-02,1호선,서울역,36080,34436,70516,9
2021-09-03,분당선,선릉,12567,18292,30859,9
2021-09-03,공항철도 1호선,홍대입구,8813,8783,17596,9
2021-09-03,공항철도 1호선,서울역,7631,7186,14817,9
2021-09-03,경의선,홍대입구,1646,1764,3410,9
2021-09-03,경의선,서울역,4052,4991,9043,9
2021-09-03,경부선,가산디지털단지,17175,19894,37069,9
2021-09-03,경부선,서울역,5655,2045,7700,9
2021-09-03,9호선,고속터미널,11986,15763,27749,9
2021-09-03,8호선,잠실(송파구청),12664,14725,27389,9
2021-09-03,7호선,가산디지털단지,43958,43455,87413,9
2021-09-03,7호선,고속터미널,14607,12745,27352,9
2021-09-03,4호선,사당,22678,19045,41723,9
2021-09-03,4호선,서울역,9691,14425,24116,9
2021-09-03,3호선,고속터미널,38467,40819,79286,9
2021-09-03,2호선,홍대입구,47559,50450,98009,9
2021-09-03,2호선,구로디지털단지,55777,55781,111558,9
2021-09-03,2호선,신림,59917,58134,118051,9
2021-09-03,2호선,사당,33558,35707,69265,9
2021-09-03,2호선,강남,77548,75772,153320,9
2021-09-03,2호선,선릉,51927,46137,98064,9
2021-09-03,2호선,잠실(송파구청),61427,61104,122531,9
2021-09-03,1호선,서울역,39881,39610,79491,9
2021-09-04,2호선,잠실(송파구청),52188,50031,102219,9
2021-09-04,2호선,선릉,20584,18324,38908,9
2021-09-04,2호선,강남,51612,50735,102347,9
2021-09-04,2호선,사당,25457,27481,52938,9
2021-09-04,2호선,신림,44750,42655,87405,9
2021-09-04,2호선,구로디지털단지,29807,29450,59257,9
2021-09-04,2호선,홍대입구,50402,54030,104432,9
2021-09-04,3호선,고속터미널,39199,40051,79250,9
2021-09-04,4호선,서울역,4560,9299,13859,9
2021-09-04,4호선,사당,17041,15051,32092,9
2021-09-04,7호선,고속터미널,11039,8907,19946,9
2021-09-04,7호선,가산디지털단지,12778,11694,24472,9
2021-09-04,8호선,잠실(송파구청),10569,12167,22736,9
2021-09-04,9호선,고속터미널,10817,14872,25689,9
2021-09-04,경부선,서울역,4462,1352,5814,9
2021-09-04,경부선,가산디지털단지,5467,7350,12817,9
2021-09-04,경의선,서울역,1132,1200,2332,9
2021-09-04,경의선,홍대입구,1729,1987,3716,9
2021-09-04,공항철도 1호선,서울역,5679,5980,11659,9
2021-09-04,공항철도 1호선,홍대입구,10325,9986,20311,9
2021-09-04,분당선,선릉,4630,6853,11483,9
2021-09-04,1호선,서울역,24158,24874,49032,9
2021-09-05,분당선,선릉,2547,3707,6254,9
2021-09-05,공항철도 1호선,홍대입구,8125,7648,15773,9
2021-09-05,공항철도 1호선,서울역,6019,5072,11091,9
2021-09-05,경의선,홍대입구,1455,1630,3085,9
2021-09-05,경의선,서울역,906,846,1752,9
2021-09-05,경부선,가산디지털단지,4059,5833,9892,9
2021-09-05,경부선,서울역,5463,1129,6592,9
2021-09-05,9호선,고속터미널,8871,11073,19944,9
2021-09-05,8호선,잠실(송파구청),8075,8850,16925,9
2021-09-05,7호선,가산디지털단지,9036,8322,17358,9
2021-09-05,7호선,고속터미널,10081,6399,16480,9
2021-09-05,4호선,사당,12412,11555,23967,9
2021-09-05,4호선,서울역,3454,6808,10262,9
2021-09-05,3호선,고속터미널,32470,29426,61896,9
2021-09-05,2호선,홍대입구,38652,39131,77783,9
2021-09-05,2호선,구로디지털단지,20112,19672,39784,9
2021-09-05,2호선,신림,32188,31808,63996,9
2021-09-05,2호선,사당,17491,19717,37208,9
2021-09-05,2호선,강남,29479,28115,57594,9
2021-09-05,2호선,잠실(송파구청),37612,35338,72950,9
2021-09-05,1호선,서울역,21599,19127,40726,9
2021-09-05,2호선,선릉,11148,9675,20823,9
2021-09-06,2호선,홍대입구,41634,41758,83392,9
2021-09-06,2호선,구로디지털단지,56170,56619,112789,9
2021-09-06,2호선,신림,57563,56760,114323,9
2021-09-06,2호선,사당,31372,33827,65199,9
2021-09-06,2호선,강남,74814,71675,146489,9
2021-09-06,2호선,선릉,53185,47067,100252,9
2021-09-06,분당선,선릉,12779,18783,31562,9
2021-09-06,2호선,잠실(송파구청),55435,54840,110275,9
2021-09-06,1호선,서울역,36653,34918,71571,9
2021-09-06,4호선,서울역,9500,12395,21895,9
2021-09-06,4호선,사당,21459,17878,39337,9
2021-09-06,7호선,고속터미널,14104,11858,25962,9
2021-09-06,7호선,가산디지털단지,46356,44948,91304,9
2021-09-06,8호선,잠실(송파구청),11968,13695,25663,9
2021-09-06,9호선,고속터미널,10051,12444,22495,9
2021-09-06,경부선,서울역,4678,1586,6264,9
2021-09-06,경부선,가산디지털단지,17349,20523,37872,9
2021-09-06,경의선,서울역,3934,4906,8840,9
2021-09-06,경의선,홍대입구,1301,1414,2715,9
2021-09-06,공항철도 1호선,서울역,6133,5709,11842,9
2021-09-06,공항철도 1호선,홍대입구,7164,7300,14464,9
2021-09-06,3호선,고속터미널,33011,30617,63628,9
2021-09-07,1호선,서울역,34751,32913,67664,9
2021-09-07,2호선,잠실(송파구청),52013,52687,104700,9
2021-09-07,2호선,선릉,51522,45680,97202,9
2021-09-07,2호선,강남,71507,69675,141182,9
2021-09-07,2호선,사당,30708,32698,63406,9
2021-09-07,2호선,신림,56043,54917,110960,9
2021-09-07,2호선,구로디지털단지,54581,55244,109825,9
2021-09-07,2호선,홍대입구,38787,39694,78481,9
2021-09-07,3호선,고속터미널,30678,29274,59952,9
2021-09-07,4호선,서울역,9123,11971,21094,9
2021-09-07,4호선,사당,20523,16881,37404,9
2021-09-07,7호선,고속터미널,13061,11336,24397,9
2021-09-07,7호선,가산디지털단지,44840,44304,89144,9
2021-09-07,8호선,잠실(송파구청),11343,13000,24343,9
2021-09-07,9호선,고속터미널,9358,11644,21002,9
2021-09-07,경부선,서울역,3930,1435,5365,9
2021-09-07,경부선,가산디지털단지,16821,19978,36799,9
2021-09-07,경의선,서울역,3726,4472,8198,9
2021-09-07,경의선,홍대입구,1254,1337,2591,9
2021-09-07,공항철도 1호선,서울역,5544,5158,10702,9
2021-09-07,공항철도 1호선,홍대입구,6708,6820,13528,9
2021-09-07,분당선,선릉,12475,18396,30871,9
2021-09-08,공항철도 1호선,서울역,6202,5632,11834,9
2021-09-08,공항철도 1호선,홍대입구,8104,7994,16098,9
2021-09-08,1호선,서울역,36687,35175,71862,9
2021-09-08,2호선,잠실(송파구청),57968,57591,115559,9
2021-09-08,2호선,선릉,53146,47446,100592,9
2021-09-08,2호선,강남,74669,72850,147519,9
2021-09-08,2호선,사당,33088,35162,68250,9
2021-09-08,2호선,신림,59029,57132,116161,9
2021-09-08,2호선,구로디지털단지,56835,57697,114532,9
2021-09-08,2호선,홍대입구,43866,45693,89559,9
2021-09-08,3호선,고속터미널,33510,31774,65284,9
2021-09-08,4호선,서울역,9757,13137,22894,9
2021-09-08,4호선,사당,22295,18620,40915,9
2021-09-08,7호선,고속터미널,13496,12091,25587,9
2021-09-08,7호선,가산디지털단지,45434,45425,90859,9
2021-09-08,8호선,잠실(송파구청),12003,14097,26100,9
2021-09-08,9호선,고속터미널,10623,13272,23895,9
2021-09-08,경부선,서울역,4115,1410,5525,9
2021-09-08,경부선,가산디지털단지,17527,20577,38104,9
2021-09-08,경의선,서울역,3999,4954,8953,9
2021-09-08,분당선,선릉,12684,18914,31598,9
2021-09-08,경의선,홍대입구,1519,1616,3135,9
2021-09-09,8호선,잠실(송파구청),11963,13802,25765,9
2021-09-09,공항철도 1호선,홍대입구,8131,8188,16319,9
2021-09-09,4호선,사당,22021,18507,40528,9
2021-09-09,4호선,서울역,9524,12944,22468,9
2021-09-09,분당선,선릉,12590,18498,31088,9
2021-09-09,공항철도 1호선,서울역,6383,6042,12425,9
2021-09-09,3호선,고속터미널,34002,32814,66816,9
2021-09-09,1호선,서울역,37359,36232,73591,9
2021-09-09,2호선,잠실(송파구청),57152,57192,114344,9
2021-09-09,2호선,선릉,52398,46824,99222,9
2021-09-09,2호선,강남,73770,71978,145748,9
2021-09-09,2호선,사당,32959,35657,68616,9
2021-09-09,2호선,신림,58618,57114,115732,9
2021-09-09,2호선,구로디지털단지,56363,56735,113098,9
2021-09-09,2호선,홍대입구,44280,45788,90068,9
2021-09-09,7호선,고속터미널,13490,11993,25483,9
2021-09-09,7호선,가산디지털단지,44170,44220,88390,9
2021-09-09,9호선,고속터미널,10822,13366,24188,9
2021-09-09,경부선,서울역,4498,1576,6074,9
2021-09-09,경부선,가산디지털단지,17218,20327,37545,9
2021-09-09,경의선,서울역,4075,4981,9056,9
2021-09-09,경의선,홍대입구,1482,1629,3111,9
2021-09-10,4호선,서울역,9634,14311,23945,9
2021-09-10,4호선,사당,22910,19599,42509,9
2021-09-10,경의선,홍대입구,1624,1752,3376,9
2021-09-10,경의선,서울역,4097,5135,9232,9
2021-09-10,분당선,선릉,12656,18451,31107,9
2021-09-10,공항철도 1호선,홍대입구,8862,8978,17840,9
2021-09-10,공항철도 1호선,서울역,7875,7223,15098,9
2021-09-10,경부선,가산디지털단지,16858,19803,36661,9
2021-09-10,경부선,서울역,5866,2078,7944,9
2021-09-10,9호선,고속터미널,11967,15987,27954,9
2021-09-10,8호선,잠실(송파구청),12915,14972,27887,9
2021-09-10,7호선,가산디지털단지,43098,42785,85883,9
2021-09-10,7호선,고속터미널,15148,13015,28163,9
2021-09-10,3호선,고속터미널,39460,40941,80401,9
2021-09-10,1호선,서울역,40550,39461,80011,9
2021-09-10,2호선,잠실(송파구청),61479,61685,123164,9
2021-09-10,2호선,선릉,52118,46378,98496,9
2021-09-10,2호선,강남,77659,76065,153724,9
2021-09-10,2호선,사당,34794,37280,72074,9
2021-09-10,2호선,신림,60289,58388,118677,9
2021-09-10,2호선,구로디지털단지,56242,56304,112546,9
2021-09-10,2호선,홍대입구,49094,51831,100925,9
2021-09-11,1호선,서울역,25272,25929,51201,9
2021-09-11,2호선,잠실(송파구청),53510,50813,104323,9
2021-09-11,2호선,선릉,21205,18605,39810,9
2021-09-11,2호선,강남,53623,52947,106570,9
2021-09-11,2호선,사당,25642,28320,53962,9
2021-09-11,2호선,신림,45823,43817,89640,9
2021-09-11,2호선,구로디지털단지,30838,30349,61187,9
2021-09-11,2호선,홍대입구,54257,57135,111392,9
2021-09-11,3호선,고속터미널,41028,41325,82353,9
2021-09-11,4호선,서울역,4600,9748,14348,9
2021-09-11,4호선,사당,17904,15451,33355,9
2021-09-11,7호선,고속터미널,11630,9411,21041,9
2021-09-11,7호선,가산디지털단지,13597,12278,25875,9
2021-09-11,8호선,잠실(송파구청),10767,12558,23325,9
2021-09-11,9호선,고속터미널,11008,15555,26563,9
2021-09-11,경부선,서울역,4812,1524,6336,9
2021-09-11,경부선,가산디지털단지,5587,7611,13198,9
2021-09-11,경의선,서울역,1218,1338,2556,9
2021-09-11,경의선,홍대입구,1912,2026,3938,9
2021-09-11,공항철도 1호선,서울역,6064,6278,12342,9
2021-09-11,공항철도 1호선,홍대입구,10774,10365,21139,9
2021-09-11,분당선,선릉,4712,7039,11751,9
2021-09-12,분당선,선릉,2525,3685,6210,9
2021-09-12,공항철도 1호선,홍대입구,9124,8380,17504,9
2021-09-12,공항철도 1호선,서울역,6063,5209,11272,9
2021-09-12,경의선,홍대입구,1638,1708,3346,9
2021-09-12,경의선,서울역,992,933,1925,9
2021-09-12,경부선,가산디지털단지,4166,5859,10025,9
2021-09-12,1호선,서울역,21327,19405,40732,9
2021-09-12,2호선,잠실(송파구청),39566,37352,76918,9
2021-09-12,2호선,선릉,11223,9705,20928,9
2021-09-12,2호선,강남,30940,29417,60357,9
2021-09-12,2호선,사당,18290,20318,38608,9
2021-09-12,2호선,신림,33416,32597,66013,9
2021-09-12,2호선,구로디지털단지,20963,20453,41416,9
2021-09-12,2호선,홍대입구,43492,44064,87556,9
2021-09-12,3호선,고속터미널,34659,31506,66165,9
2021-09-12,4호선,서울역,3477,7161,10638,9
2021-09-12,4호선,사당,12870,12018,24888,9
2021-09-12,경부선,서울역,5590,1142,6732,9
2021-09-12,9호선,고속터미널,9142,11769,20911,9
2021-09-12,7호선,고속터미널,10189,6815,17004,9
2021-09-12,7호선,가산디지털단지,9691,8961,18652,9
2021-09-12,8호선,잠실(송파구청),8328,9233,17561,9
2021-09-13,4호선,사당,21633,18296,39929,9
2021-09-13,4호선,서울역,9717,12985,22702,9
2021-09-13,3호선,고속터미널,34309,32843,67152,9
2021-09-13,2호선,홍대입구,42622,43928,86550,9
2021-09-13,2호선,구로디지털단지,56829,57474,114303,9
2021-09-13,2호선,신림,58508,57170,115678,9
2021-09-13,2호선,사당,32117,34737,66854,9
2021-09-13,2호선,강남,74731,72795,147526,9
2021-09-13,2호선,선릉,52913,47172,100085,9
2021-09-13,2호선,잠실(송파구청),56562,56554,113116,9
2021-09-13,1호선,서울역,37348,35958,73306,9
2021-09-13,분당선,선릉,12694,18820,31514,9
2021-09-13,공항철도 1호선,홍대입구,7867,7808,15675,9
2021-09-13,공항철도 1호선,서울역,6442,6052,12494,9
2021-09-13,경의선,홍대입구,1435,1590,3025,9
2021-09-13,경의선,서울역,3978,5032,9010,9
2021-09-13,경부선,가산디지털단지,17560,20606,38166,9
2021-09-13,경부선,서울역,4932,1600,6532,9
2021-09-13,9호선,고속터미널,10879,13354,24233,9
2021-09-13,8호선,잠실(송파구청),12013,14003,26016,9
2021-09-13,7호선,가산디지털단지,45253,45179,90432,9
2021-09-13,7호선,고속터미널,14548,12238,26786,9
2021-09-14,2호선,잠실(송파구청),58319,58012,116331,9
2021-09-14,2호선,선릉,53142,47403,100545,9
2021-09-14,2호선,강남,75896,74127,150023,9
2021-09-14,2호선,사당,32937,35733,68670,9
2021-09-14,2호선,신림,59194,57797,116991,9
2021-09-14,2호선,구로디지털단지,57042,57600,114642,9
2021-09-14,2호선,홍대입구,43514,45179,88693,9
2021-09-14,3호선,고속터미널,34503,33127,67630,9
2021-09-14,4호선,서울역,9800,13010,22810,9
2021-09-14,4호선,사당,22135,18547,40682,9
2021-09-14,7호선,고속터미널,14174,12452,26626,9
2021-09-14,7호선,가산디지털단지,45151,45181,90332,9
2021-09-14,8호선,잠실(송파구청),12025,14134,26159,9
2021-09-14,분당선,선릉,13025,18893,31918,9
2021-09-14,공항철도 1호선,홍대입구,7815,7877,15692,9
2021-09-14,공항철도 1호선,서울역,6256,5815,12071,9
2021-09-14,경의선,홍대입구,1521,1590,3111,9
2021-09-14,경의선,서울역,3988,4947,8935,9
2021-09-14,9호선,고속터미널,10949,13520,24469,9
2021-09-14,경부선,서울역,4404,1471,5875,9
2021-09-14,경부선,가산디지털단지,17267,20441,37708,9
2021-09-14,1호선,서울역,37022,35539,72561,9
2021-09-15,4호선,사당,22655,19052,41707,9
2021-09-15,9호선,고속터미널,11112,14185,25297,9
2021-09-15,경부선,서울역,4580,1598,6178,9
2021-09-15,2호선,잠실(송파구청),60711,60132,120843,9
2021-09-15,2호선,선릉,54519,48536,103055,9
2021-09-15,2호선,강남,76853,74906,151759,9
2021-09-15,2호선,사당,34046,36575,70621,9
2021-09-15,2호선,신림,60351,58720,119071,9
2021-09-15,2호선,구로디지털단지,57981,58456,116437,9
2021-09-15,2호선,홍대입구,45766,47324,93090,9
2021-09-15,3호선,고속터미널,36146,35066,71212,9
2021-09-15,경부선,가산디지털단지,17544,20551,38095,9
2021-09-15,분당선,선릉,13370,19507,32877,9
2021-09-15,공항철도 1호선,홍대입구,8190,8353,16543,9
2021-09-15,공항철도 1호선,서울역,6457,6052,12509,9
2021-09-15,경의선,서울역,383,96,479,9
2021-09-15,경의선,홍대입구,1541,1612,3153,9
2021-09-15,경의선,서울역,3746,5118,8864,9
2021-09-15,7호선,고속터미널,13995,12430,26425,9
2021-09-15,7호선,가산디지털단지,45452,45447,90899,9
2021-09-15,8호선,잠실(송파구청),12258,14598,26856,9
2021-09-15,4호선,서울역,10192,14219,24411,9
2021-09-15,1호선,서울역,38546,37683,76229,9
2021-09-16,분당선,선릉,13004,19113,32117,9
2021-09-16,공항철도 1호선,홍대입구,8522,8377,16899,9
2021-09-16,공항철도 1호선,서울역,7067,7478,14545,9
2021-09-16,1호선,서울역,39445,42773,82218,9
2021-09-16,2호선,잠실(송파구청),59968,59963,119931,9
2021-09-16,2호선,선릉,53839,48229,102068,9
2021-09-16,2호선,강남,77160,74991,152151,9
2021-09-16,2호선,사당,34153,36521,70674,9
2021-09-16,2호선,신림,60229,57921,118150,9
2021-09-16,2호선,구로디지털단지,57401,57453,114854,9
2021-09-16,2호선,홍대입구,45984,47439,93423,9
2021-09-16,3호선,고속터미널,36849,39409,76258,9
2021-09-16,4호선,서울역,9869,15667,25536,9
2021-09-16,4호선,사당,23188,18939,42127,9
2021-09-16,7호선,고속터미널,13847,13103,26950,9
2021-09-16,7호선,가산디지털단지,45083,44920,90003,9
2021-09-16,8호선,잠실(송파구청),12439,14705,27144,9
2021-09-16,9호선,고속터미널,11631,15611,27242,9
2021-09-16,경부선,서울역,4796,2249,7045,9
2021-09-16,경부선,가산디지털단지,17392,20464,37856,9
2021-09-16,경의선,서울역,4121,5245,9366,9
2021-09-16,경의선,홍대입구,1634,1698,3332,9
2021-09-17,1호선,서울역,37848,39480,77328,9
2021-09-17,2호선,잠실(송파구청),62067,62173,124240,9
2021-09-17,2호선,선릉,50411,44712,95123,9
2021-09-17,2호선,강남,78377,77124,155501,9
2021-09-17,2호선,사당,33682,35916,69598,9
2021-09-17,2호선,신림,61672,57602,119274,9
2021-09-17,2호선,구로디지털단지,56235,55150,111385,9
2021-09-17,2호선,홍대입구,50592,53496,104088,9
2021-09-17,3호선,고속터미널,44048,63248,107296,9
2021-09-17,4호선,서울역,9686,14523,24209,9
2021-09-17,4호선,사당,22727,18993,41720,9
2021-09-17,7호선,고속터미널,15471,16340,31811,9
2021-09-17,7호선,가산디지털단지,42825,41503,84328,9
2021-09-17,8호선,잠실(송파구청),13161,15440,28601,9
2021-09-17,9호선,고속터미널,13305,23906,37211,9
2021-09-17,경부선,서울역,4340,2038,6378,9
2021-09-17,경부선,가산디지털단지,16542,19435,35977,9
2021-09-17,경의선,서울역,3756,4974,8730,9
2021-09-17,경의선,홍대입구,1712,1895,3607,9
2021-09-17,공항철도 1호선,서울역,7114,6712,13826,9
2021-09-17,공항철도 1호선,홍대입구,9539,9281,18820,9
2021-09-17,분당선,선릉,12198,17840,30038,9
2021-09-18,3호선,고속터미널,38223,59558,97781,9
2021-09-18,4호선,서울역,4433,9478,13911,9
2021-09-18,4호선,사당,15798,13360,29158,9
2021-09-18,7호선,고속터미널,9293,11644,20937,9
2021-09-18,7호선,가산디지털단지,12187,10664,22851,9
2021-09-18,8호선,잠실(송파구청),9820,11305,21125,9
2021-09-18,9호선,고속터미널,10214,22050,32264,9
2021-09-18,경부선,서울역,3007,1425,4432,9
2021-09-18,경부선,가산디지털단지,5307,6756,12063,9
2021-09-18,경의선,서울역,1010,1139,2149,9
2021-09-18,경의선,홍대입구,1645,1843,3488,9
2021-09-18,2호선,사당,22266,24456,46722,9
2021-09-18,공항철도 1호선,서울역,5098,5724,10822,9
2021-09-18,공항철도 1호선,홍대입구,9567,9000,18567,9
2021-09-18,분당선,선릉,3914,5558,9472,9
2021-09-18,2호선,신림,42384,36815,79199,9
2021-09-18,2호선,구로디지털단지,27380,25558,52938,9
2021-09-18,2호선,강남,45511,45410,90921,9
2021-09-18,2호선,선릉,17334,15210,32544,9
2021-09-18,2호선,잠실(송파구청),47144,45719,92863,9
2021-09-18,1호선,서울역,22200,26522,48722,9
2021-09-18,2호선,홍대입구,47689,49695,97384,9
2021-09-19,1호선,서울역,18148,22193,40341,9
2021-09-19,2호선,구로디지털단지,18813,17292,36105,9
2021-09-19,2호선,신림,30333,25872,56205,9
2021-09-19,2호선,사당,15244,16593,31837,9
2021-09-19,2호선,강남,25909,25349,51258,9
2021-09-19,2호선,선릉,8962,7604,16566,9
2021-09-19,2호선,잠실(송파구청),36356,35074,71430,9
2021-09-19,분당선,선릉,1973,2729,4702,9
2021-09-19,공항철도 1호선,홍대입구,7537,6568,14105,9
2021-09-19,공항철도 1호선,서울역,4045,5157,9202,9
2021-09-19,경의선,홍대입구,1279,1379,2658,9
2021-09-19,경의선,서울역,771,891,1662,9
2021-09-19,경부선,가산디지털단지,3972,5262,9234,9
2021-09-19,경부선,서울역,2686,1151,3837,9
2021-09-19,9호선,고속터미널,7338,15878,23216,9
2021-09-19,8호선,잠실(송파구청),7383,8502,15885,9
2021-09-19,7호선,가산디지털단지,9521,8011,17532,9
2021-09-19,7호선,고속터미널,7106,8420,15526,9
2021-09-19,4호선,사당,11517,9748,21265,9
2021-09-19,4호선,서울역,3255,7553,10808,9
2021-09-19,3호선,고속터미널,28281,43841,72122,9
2021-09-19,2호선,홍대입구,35828,36299,72127,9
2021-09-20,1호선,서울역,17590,18993,36583,9
2021-09-20,2호선,잠실(송파구청),29998,29059,59057,9
2021-09-20,2호선,선릉,6696,5541,12237,9
2021-09-20,2호선,강남,19681,18871,38552,9
2021-09-20,2호선,사당,11584,13006,24590,9
2021-09-20,2호선,신림,24313,21111,45424,9
2021-09-20,2호선,구로디지털단지,15399,14330,29729,9
2021-09-20,2호선,홍대입구,27825,27860,55685,9
2021-09-20,3호선,고속터미널,19711,26662,46373,9
2021-09-20,4호선,서울역,2919,6568,9487,9
2021-09-20,4호선,사당,8793,7713,16506,9
2021-09-20,7호선,고속터미널,7411,6107,13518,9
2021-09-20,7호선,가산디지털단지,8072,6928,15000,9
2021-09-20,8호선,잠실(송파구청),6103,6965,13068,9
2021-09-20,9호선,고속터미널,5754,10493,16247,9
2021-09-20,경부선,서울역,2871,954,3825,9
2021-09-20,경부선,가산디지털단지,3514,4742,8256,9
2021-09-20,경의선,서울역,848,726,1574,9
2021-09-20,경의선,홍대입구,876,995,1871,9
2021-09-20,공항철도 1호선,서울역,3898,4372,8270,9
2021-09-20,공항철도 1호선,홍대입구,5836,5210,11046,9
2021-09-20,분당선,선릉,1524,2104,3628,9
2021-09-21,4호선,사당,7010,6406,13416,9
2021-09-21,4호선,서울역,2411,4882,7293,9
2021-09-21,3호선,고속터미널,30999,14324,45323,9
2021-09-21,2호선,홍대입구,19594,21896,41490,9
2021-09-21,2호선,구로디지털단지,12023,13166,25189,9
2021-09-21,2호선,신림,19126,22420,41546,9
2021-09-21,2호선,사당,9202,9952,19154,9
2021-09-21,2호선,강남,12740,12716,25456,9
2021-09-21,2호선,선릉,4504,4112,8616,9
2021-09-21,2호선,잠실(송파구청),23455,21379,44834,9
2021-09-21,1호선,서울역,16684,14420,31104,9
2021-09-21,7호선,고속터미널,14623,3875,18498,9
2021-09-21,공항철도 1호선,서울역,4695,3616,8311,9
2021-09-21,공항철도 1호선,홍대입구,3850,4031,7881,9
2021-09-21,분당선,선릉,1013,1614,2627,9
2021-09-21,7호선,가산디지털단지,5806,5505,11311,9
2021-09-21,8호선,잠실(송파구청),4713,5547,10260,9
2021-09-21,9호선,고속터미널,8356,5312,13668,9
2021-09-21,경부선,서울역,3713,749,4462,9
2021-09-21,경부선,가산디지털단지,2937,4623,7560,9
2021-09-21,경의선,서울역,706,625,1331,9
2021-09-21,경의선,홍대입구,569,754,1323,9
2021-09-22,경부선,서울역,5342,972,6314,9
2021-09-22,8호선,잠실(송파구청),8277,9280,17557,9
2021-09-22,4호선,사당,10933,10591,21524,9
2021-09-22,4호선,서울역,3016,5882,8898,9
2021-09-22,경의선,서울역,874,824,1698,9
2021-09-22,경의선,홍대입구,1179,1472,2651,9
2021-09-22,경부선,가산디지털단지,3844,5848,9692,9
2021-09-22,공항철도 1호선,홍대입구,7077,7451,14528,9
2021-09-22,공항철도 1호선,서울역,5498,4503,10001,9
2021-09-22,분당선,선릉,2014,3145,5159,9
2021-09-22,7호선,고속터미널,22658,6231,28889,9
2021-09-22,7호선,가산디지털단지,8926,8942,17868,9
2021-09-22,3호선,고속터미널,56892,28199,85091,9
2021-09-22,2호선,홍대입구,33815,36309,70124,9
2021-09-22,2호선,구로디지털단지,17584,18868,36452,9
2021-09-22,2호선,신림,26421,31030,57451,9
2021-09-22,2호선,사당,15112,17403,32515,9
2021-09-22,2호선,강남,25105,24684,49789,9
2021-09-22,2호선,선릉,8768,8239,17007,9
2021-09-22,2호선,잠실(송파구청),38010,35468,73478,9
2021-09-22,1호선,서울역,20951,17404,38355,9
2021-09-22,9호선,고속터미널,14090,10061,24151,9
2021-09-23,7호선,고속터미널,17211,11651,28862,9
2021-09-23,7호선,가산디지털단지,41027,41041,82068,9
2021-09-23,분당선,선릉,11397,16955,28352,9
2021-09-23,8호선,잠실(송파구청),11436,13411,24847,9
2021-09-23,9호선,고속터미널,11698,13063,24761,9
2021-09-23,경부선,서울역,7693,1422,9115,9
2021-09-23,경부선,가산디지털단지,15802,18739,34541,9
2021-09-23,경의선,서울역,3990,4653,8643,9
2021-09-23,경의선,홍대입구,1618,1691,3309,9
2021-09-23,공항철도 1호선,서울역,7870,5551,13421,9
2021-09-23,공항철도 1호선,홍대입구,7908,8557,16465,9
2021-09-23,1호선,서울역,41066,32130,73196,9
2021-09-23,2호선,잠실(송파구청),55696,55902,111598,9
2021-09-23,2호선,선릉,47741,42518,90259,9
2021-09-23,2호선,강남,70212,68455,138667,9
2021-09-23,2호선,사당,30258,33471,63729,9
2021-09-23,2호선,신림,54440,55002,109442,9
2021-09-23,2호선,구로디지털단지,52344,52999,105343,9
2021-09-23,2호선,홍대입구,43130,45695,88825,9
2021-09-23,3호선,고속터미널,39764,31783,71547,9
2021-09-23,4호선,서울역,8569,11464,20033,9
2021-09-23,4호선,사당,20579,17602,38181,9
2021-09-24,1호선,서울역,39630,36504,76134,9
2021-09-24,2호선,잠실(송파구청),61937,61319,123256,9
2021-09-24,2호선,선릉,50671,45257,95928,9
2021-09-24,2호선,강남,76923,75508,152431,9
2021-09-24,2호선,사당,33590,36356,69946,9
2021-09-24,2호선,신림,58554,57801,116355,9
2021-09-24,2호선,구로디지털단지,54423,55073,109496,9
2021-09-24,2호선,홍대입구,48103,51491,99594,9
2021-09-24,3호선,고속터미널,39801,37930,77731,9
2021-09-24,4호선,서울역,9006,13071,22077,9
2021-09-24,4호선,사당,22670,19095,41765,9
2021-09-24,7호선,고속터미널,15760,12590,28350,9
2021-09-24,7호선,가산디지털단지,42073,42031,84104,9
2021-09-24,8호선,잠실(송파구청),12692,14830,27522,9
2021-09-24,9호선,고속터미널,12085,15465,27550,9
2021-09-24,경부선,서울역,5826,1765,7591,9
2021-09-24,경부선,가산디지털단지,16399,19437,35836,9
2021-09-24,경의선,서울역,3862,4962,8824,9
2021-09-24,경의선,홍대입구,1676,1822,3498,9
2021-09-24,공항철도 1호선,서울역,7129,6311,13440,9
2021-09-24,공항철도 1호선,홍대입구,8938,9317,18255,9
2021-09-24,분당선,선릉,12176,17928,30104,9
2021-09-25,경부선,서울역,4882,1267,6149,9
2021-09-25,9호선,고속터미널,10937,14640,25577,9
2021-09-25,8호선,잠실(송파구청),9708,11486,21194,9
2021-09-25,분당선,선릉,4518,6852,11370,9
2021-09-25,공항철도 1호선,홍대입구,9651,9717,19368,9
2021-09-25,공항철도 1호선,서울역,6030,5543,11573,9
2021-09-25,경의선,홍대입구,1617,1770,3387,9
2021-09-25,7호선,가산디지털단지,12892,11822,24714,9
2021-09-25,7호선,고속터미널,11313,8614,19927,9
2021-09-25,경의선,서울역,1155,1180,2335,9
2021-09-25,2호선,구로디지털단지,29399,28841,58240,9
2021-09-25,2호선,신림,43875,42489,86364,9
2021-09-25,2호선,사당,25306,28028,53334,9
2021-09-25,2호선,강남,52434,51433,103867,9
2021-09-25,2호선,선릉,20603,18246,38849,9
2021-09-25,2호선,잠실(송파구청),51558,48887,100445,9
2021-09-25,1호선,서울역,25011,23912,48923,9
2021-09-25,4호선,사당,17259,14978,32237,9
2021-09-25,4호선,서울역,4579,8997,13576,9
2021-09-25,2호선,홍대입구,48935,52770,101705,9
2021-09-25,3호선,고속터미널,39401,38015,77416,9
2021-09-25,경부선,가산디지털단지,5464,7505,12969,9
2021-09-26,4호선,사당,12433,11642,24075,9
2021-09-26,4호선,서울역,3569,6918,10487,9
2021-09-26,3호선,고속터미널,31965,29256,61221,9
2021-09-26,2호선,홍대입구,37124,37426,74550,9
2021-09-26,2호선,구로디지털단지,19654,19312,38966,9
2021-09-26,2호선,신림,31555,30850,62405,9
2021-09-26,2호선,사당,18149,20315,38464,9
2021-09-26,2호선,강남,29143,28016,57159,9
2021-09-26,2호선,잠실(송파구청),37329,34938,72267,9
2021-09-26,분당선,선릉,2463,3600,6063,9
2021-09-26,공항철도 1호선,홍대입구,7759,7472,15231,9
2021-09-26,공항철도 1호선,서울역,5781,5174,10955,9
2021-09-26,경의선,홍대입구,1307,1438,2745,9
2021-09-26,경의선,서울역,905,838,1743,9
2021-09-26,경부선,가산디지털단지,4011,5511,9522,9
2021-09-26,경부선,서울역,5630,1152,6782,9
2021-09-26,9호선,고속터미널,8659,11236,19895,9
2021-09-26,8호선,잠실(송파구청),7459,8315,15774,9
2021-09-26,7호선,가산디지털단지,9004,8412,17416,9
2021-09-26,7호선,고속터미널,9576,6519,16095,9
2021-09-26,2호선,선릉,10991,9492,20483,9
2021-09-26,1호선,서울역,21731,18551,40282,9
2021-09-27,3호선,고속터미널,32779,30745,63524,9
2021-09-27,2호선,홍대입구,41612,42696,84308,9
2021-09-27,2호선,구로디지털단지,57242,57791,115033,9
2021-09-27,2호선,신림,58429,57313,115742,9
2021-09-27,2호선,사당,32739,35439,68178,9
2021-09-27,2호선,강남,75404,73598,149002,9
2021-09-27,2호선,선릉,54527,48514,103041,9
2021-09-27,2호선,잠실(송파구청),56715,56821,113536,9
2021-09-27,1호선,서울역,37565,36169,73734,9
2021-09-27,분당선,선릉,13218,19388,32606,9
2021-09-27,공항철도 1호선,홍대입구,7497,7632,15129,9
2021-09-27,공항철도 1호선,서울역,6468,6118,12586,9
2021-09-27,경의선,홍대입구,1339,1534,2873,9
2021-09-27,경의선,서울역,4011,5086,9097,9
2021-09-27,경부선,가산디지털단지,17990,21011,39001,9
2021-09-27,경부선,서울역,4905,1574,6479,9
2021-09-27,9호선,고속터미널,10643,12954,23597,9
2021-09-27,8호선,잠실(송파구청),11779,13828,25607,9
2021-09-27,7호선,가산디지털단지,46287,46231,92518,9
2021-09-27,7호선,고속터미널,14676,12333,27009,9
2021-09-27,4호선,서울역,9679,12918,22597,9
2021-09-27,4호선,사당,21841,18501,40342,9
2021-09-28,7호선,가산디지털단지,46433,45902,92335,9
2021-09-28,7호선,고속터미널,14041,12168,26209,9
2021-09-28,8호선,잠실(송파구청),12168,13981,26149,9
2021-09-28,9호선,고속터미널,10273,12890,23163,9
2021-09-28,경부선,서울역,4482,1522,6004,9
2021-09-28,경부선,가산디지털단지,17615,20875,38490,9
2021-09-28,경의선,서울역,4058,4950,9008,9
2021-09-28,경의선,홍대입구,1440,1643,3083,9
2021-09-28,4호선,사당,22178,18695,40873,9
2021-09-28,4호선,서울역,9758,12869,22627,9
2021-09-28,3호선,고속터미널,33134,31583,64717,9
2021-09-28,2호선,홍대입구,42478,43484,85962,9
2021-09-28,공항철도 1호선,서울역,6202,5733,11935,9
2021-09-28,공항철도 1호선,홍대입구,7585,7636,15221,9
2021-09-28,분당선,선릉,13346,19555,32901,9
2021-09-28,2호선,구로디지털단지,57249,57950,115199,9
2021-09-28,2호선,신림,58686,57554,116240,9
2021-09-28,2호선,사당,33050,35571,68621,9
2021-09-28,2호선,강남,75864,73468,149332,9
2021-09-28,2호선,선릉,54268,48162,102430,9
2021-09-28,2호선,잠실(송파구청),57839,57177,115016,9
2021-09-28,1호선,서울역,37550,35432,72982,9
2021-09-29,경부선,가산디지털단지,17137,20240,37377,9
2021-09-29,경부선,서울역,4369,1502,5871,9
2021-09-29,9호선,고속터미널,10128,12613,22741,9
2021-09-29,8호선,잠실(송파구청),11472,13534,25006,9
2021-09-29,7호선,가산디지털단지,45222,45270,90492,9
2021-09-29,7호선,고속터미널,13518,11773,25291,9
2021-09-29,1호선,서울역,36745,34334,71079,9
2021-09-29,2호선,잠실(송파구청),54628,54871,109499,9
2021-09-29,2호선,선릉,53506,47550,101056,9
2021-09-29,2호선,강남,72702,71132,143834,9
2021-09-29,2호선,사당,32005,34638,66643,9
2021-09-29,2호선,신림,57473,55858,113331,9
2021-09-29,2호선,구로디지털단지,55571,56239,111810,9
2021-09-29,2호선,홍대입구,40822,42541,83363,9
2021-09-29,3호선,고속터미널,31945,30358,62303,9
2021-09-29,4호선,서울역,9736,12929,22665,9
2021-09-29,4호선,사당,21346,17859,39205,9
2021-09-29,공항철도 1호선,서울역,6277,5569,11846,9
2021-09-29,공항철도 1호선,홍대입구,7449,7577,15026,9
2021-09-29,분당선,선릉,13063,19145,32208,9
2021-09-29,경의선,홍대입구,1366,1532,2898,9
2021-09-29,경의선,서울역,3800,4796,8596,9
2021-09-30,1호선,서울역,38921,36910,75831,9
2021-09-30,2호선,잠실(송파구청),60114,59998,120112,9
2021-09-30,2호선,선릉,54065,48345,102410,9
2021-09-30,2호선,강남,75278,73606,148884,9
2021-09-30,2호선,사당,33833,36542,70375,9
2021-09-30,2호선,신림,59385,57821,117206,9
2021-09-30,2호선,구로디지털단지,57166,57726,114892,9
2021-09-30,2호선,홍대입구,44733,46403,91136,9
2021-09-30,경부선,서울역,4661,1606,6267,9
2021-09-30,경부선,가산디지털단지,17660,20762,38422,9
2021-09-30,경의선,서울역,4117,5225,9342,9
2021-09-30,경의선,홍대입구,1478,1605,3083,9
2021-09-30,공항철도 1호선,서울역,6817,6148,12965,9
2021-09-30,공항철도 1호선,홍대입구,8221,8231,16452,9
2021-09-30,분당선,선릉,12970,19297,32267,9
2021-09-30,3호선,고속터미널,34843,33676,68519,9
2021-09-30,4호선,서울역,9890,13340,23230,9
2021-09-30,4호선,사당,22659,18889,41548,9
2021-09-30,7호선,고속터미널,14027,12352,26379,9
2021-09-30,7호선,가산디지털단지,44905,45176,90081,9
2021-09-30,8호선,잠실(송파구청),12419,14650,27069,9
2021-09-30,9호선,고속터미널,11192,13791,24983,9
2021-10-01,분당선,선릉,12902,19049,31951,10
2021-10-01,공항철도 1호선,홍대입구,9123,9567,18690,10
2021-10-01,공항철도 1호선,서울역,8077,7732,15809,10
2021-10-01,4호선,사당,23921,19962,43883,10
2021-10-01,4호선,서울역,10003,15460,25463,10
2021-10-01,3호선,고속터미널,40458,42277,82735,10
2021-10-01,경의선,서울역,73,1176,1249,10
2021-10-01,경의선,홍대입구,1639,1920,3559,10
2021-10-01,경의선,서울역,4073,4111,8184,10
2021-10-01,경부선,가산디지털단지,17535,20709,38244,10
2021-10-01,경부선,서울역,6197,2167,8364,10
2021-10-01,9호선,고속터미널,12562,16838,29400,10
2021-10-01,8호선,잠실(송파구청),13090,15418,28508,10
2021-10-01,7호선,가산디지털단지,44558,43871,88429,10
2021-10-01,7호선,고속터미널,16110,13584,29694,10
2021-10-01,1호선,서울역,42350,41754,84104,10
2021-10-01,2호선,잠실(송파구청),63437,63001,126438,10
2021-10-01,2호선,선릉,53083,47437,100520,10
2021-10-01,2호선,강남,80219,78259,158478,10
2021-10-01,2호선,사당,35093,37797,72890,10
2021-10-01,2호선,신림,61374,59294,120668,10
2021-10-01,2호선,구로디지털단지,57415,57502,114917,10
2021-10-01,2호선,홍대입구,50464,52404,102868,10
2021-10-02,4호선,사당,18403,15835,34238,10
2021-10-02,4호선,서울역,4898,11312,16210,10
2021-10-02,3호선,고속터미널,41480,43984,85464,10
2021-10-02,1호선,서울역,27912,30215,58127,10
2021-10-02,2호선,잠실(송파구청),55475,52828,108303,10
2021-10-02,2호선,선릉,21747,19225,40972,10
2021-10-02,2호선,강남,52868,52299,105167,10
2021-10-02,2호선,사당,26401,29341,55742,10
2021-10-02,2호선,신림,45477,43500,88977,10
2021-10-02,2호선,구로디지털단지,30413,29820,60233,10
2021-10-02,2호선,홍대입구,52207,55757,107964,10
2021-10-02,7호선,가산디지털단지,13508,12152,25660,10
2021-10-02,7호선,고속터미널,12018,10069,22087,10
2021-10-02,8호선,잠실(송파구청),10859,12627,23486,10
2021-10-02,9호선,고속터미널,11669,16708,28377,10
2021-10-02,경부선,서울역,5621,1758,7379,10
2021-10-02,경부선,가산디지털단지,5765,7902,13667,10
2021-10-02,경의선,서울역,1438,1726,3164,10
2021-10-02,경의선,홍대입구,1703,1898,3601,10
2021-10-02,공항철도 1호선,서울역,6331,7155,13486,10
2021-10-02,공항철도 1호선,홍대입구,10582,10208,20790,10
2021-10-02,분당선,선릉,4658,7110,11768,10
2021-10-03,경의선,서울역,925,941,1866,10
2021-10-03,경의선,홍대입구,1454,1694,3148,10
2021-10-03,분당선,선릉,2506,3755,6261,10
2021-10-03,1호선,서울역,22579,20775,43354,10
2021-10-03,2호선,잠실(송파구청),43771,41039,84810,10
2021-10-03,2호선,선릉,11844,10180,22024,10
2021-10-03,2호선,강남,31137,30519,61656,10
2021-10-03,2호선,사당,19747,21945,41692,10
2021-10-03,2호선,신림,34598,33214,67812,10
2021-10-03,2호선,구로디지털단지,21505,20876,42381,10
2021-10-03,2호선,홍대입구,43475,44586,88061,10
2021-10-03,3호선,고속터미널,33212,31115,64327,10
2021-10-03,4호선,서울역,3764,7793,11557,10
2021-10-03,4호선,사당,13677,12501,26178,10
2021-10-03,공항철도 1호선,서울역,6003,5368,11371,10
2021-10-03,공항철도 1호선,홍대입구,9092,8909,18001,10
2021-10-03,7호선,고속터미널,9160,6490,15650,10
2021-10-03,7호선,가산디지털단지,9839,8969,18808,10
2021-10-03,8호선,잠실(송파구청),8887,10023,18910,10
2021-10-03,9호선,고속터미널,8869,12115,20984,10
2021-10-03,경부선,서울역,4954,1210,6164,10
2021-10-03,경부선,가산디지털단지,4458,6039,10497,10
2021-10-04,2호선,홍대입구,38417,38658,77075,10
2021-10-04,2호선,구로디지털단지,26203,26596,52799,10
2021-10-04,2호선,신림,36984,36590,73574,10
2021-10-04,2호선,사당,20512,22339,42851,10
2021-10-04,2호선,강남,41107,39943,81050,10
2021-10-04,2호선,선릉,19044,17036,36080,10
2021-10-04,2호선,잠실(송파구청),41128,39292,80420,10
2021-10-04,1호선,서울역,24466,21330,45796,10
2021-10-04,3호선,고속터미널,35624,32035,67659,10
2021-10-04,4호선,서울역,3797,7106,10903,10
2021-10-04,4호선,사당,13747,12420,26167,10
2021-10-04,7호선,고속터미널,10827,7456,18283,10
2021-10-04,7호선,가산디지털단지,12701,12263,24964,10
2021-10-04,8호선,잠실(송파구청),8926,9576,18502,10
2021-10-04,9호선,고속터미널,9241,11512,20753,10
2021-10-04,경부선,서울역,5842,1198,7040,10
2021-10-04,경부선,가산디지털단지,5398,7315,12713,10
2021-10-04,경의선,서울역,1210,1114,2324,10
2021-10-04,경의선,홍대입구,1198,1405,2603,10
2021-10-04,공항철도 1호선,서울역,6122,5219,11341,10
2021-10-04,공항철도 1호선,홍대입구,7786,7383,15169,10
2021-10-04,분당선,선릉,3887,5849,9736,10
2021-10-05,7호선,고속터미널,14672,12311,26983,10
2021-10-05,2호선,구로디지털단지,58132,58648,116780,10
2021-10-05,7호선,가산디지털단지,46570,46529,93099,10
2021-10-05,1호선,서울역,38303,36946,75249,10
2021-10-05,4호선,사당,22403,18678,41081,10
2021-10-05,4호선,서울역,9844,13170,23014,10
2021-10-05,3호선,고속터미널,33639,31976,65615,10
2021-10-05,2호선,홍대입구,42138,43023,85161,10
2021-10-05,2호선,잠실(송파구청),57485,57183,114668,10
2021-10-05,2호선,선릉,55737,49595,105332,10
2021-10-05,2호선,강남,76411,74720,151131,10
2021-10-05,2호선,사당,33262,35858,69120,10
2021-10-05,2호선,신림,59180,58121,117301,10
2021-10-05,9호선,고속터미널,10866,13080,23946,10
2021-10-05,8호선,잠실(송파구청),12110,13930,26040,10
2021-10-05,분당선,선릉,13482,20074,33556,10
2021-10-05,공항철도 1호선,홍대입구,7508,7745,15253,10
2021-10-05,공항철도 1호선,서울역,6533,6145,12678,10
2021-10-05,경의선,홍대입구,1407,1526,2933,10
2021-10-05,경의선,서울역,4103,5159,9262,10
2021-10-05,경부선,가산디지털단지,18398,21495,39893,10
2021-10-05,경부선,서울역,5037,1633,6670,10
2021-10-06,경부선,가산디지털단지,18065,21057,39122,10
2021-10-06,경부선,서울역,4395,1569,5964,10
2021-10-06,9호선,고속터미널,10733,13088,23821,10
2021-10-06,8호선,잠실(송파구청),11869,14177,26046,10
2021-10-06,7호선,가산디지털단지,46423,46626,93049,10
2021-10-06,7호선,고속터미널,14045,12298,26343,10
2021-10-06,4호선,사당,22251,18508,40759,10
2021-10-06,4호선,서울역,10033,13603,23636,10
2021-10-06,3호선,고속터미널,33328,31716,65044,10
2021-10-06,2호선,홍대입구,42386,43887,86273,10
2021-10-06,2호선,구로디지털단지,57248,57943,115191,10
2021-10-06,2호선,신림,59085,57093,116178,10
2021-10-06,2호선,사당,33265,35972,69237,10
2021-10-06,2호선,강남,75598,74152,149750,10
2021-10-06,2호선,선릉,54931,49103,104034,10
2021-10-06,2호선,잠실(송파구청),57608,57422,115030,10
2021-10-06,경의선,서울역,4093,4923,9016,10
2021-10-06,경의선,홍대입구,1424,1535,2959,10
2021-10-06,공항철도 1호선,서울역,6451,5785,12236,10
2021-10-06,공항철도 1호선,홍대입구,7771,7725,15496,10
2021-10-06,1호선,서울역,37866,36336,74202,10
2021-10-06,분당선,선릉,13260,19686,32946,10
2021-10-07,경부선,서울역,4747,1753,6500,10
2021-10-07,2호선,홍대입구,43948,45751,89699,10
2021-10-07,2호선,구로디지털단지,57599,57864,115463,10
2021-10-07,2호선,신림,59320,57512,116832,10
2021-10-07,2호선,사당,33820,36249,70069,10
2021-10-07,2호선,강남,75373,74229,149602,10
2021-10-07,2호선,선릉,54382,48965,103347,10
2021-10-07,2호선,잠실(송파구청),58837,59045,117882,10
2021-10-07,3호선,고속터미널,34385,33457,67842,10
2021-10-07,1호선,서울역,38769,37270,76039,10
2021-10-07,분당선,선릉,13275,19309,32584,10
2021-10-07,경부선,가산디지털단지,17877,20966,38843,10
2021-10-07,공항철도 1호선,홍대입구,7847,8058,15905,10
2021-10-07,공항철도 1호선,서울역,6672,6302,12974,10
2021-10-07,경의선,홍대입구,1438,1585,3023,10
2021-10-07,경의선,서울역,4214,5113,9327,10
2021-10-07,9호선,고속터미널,11050,13749,24799,10
2021-10-07,8호선,잠실(송파구청),12374,14629,27003,10
2021-10-07,7호선,가산디지털단지,45415,45799,91214,10
2021-10-07,7호선,고속터미널,14268,12452,26720,10
2021-10-07,4호선,사당,22518,19069,41587,10
2021-10-07,4호선,서울역,9946,13754,23700,10
2021-10-08,분당선,선릉,13043,19231,32274,10
2021-10-08,공항철도 1호선,홍대입구,9022,9050,18072,10
2021-10-08,공항철도 1호선,서울역,8513,8542,17055,10
2021-10-08,경의선,홍대입구,1674,1836,3510,10
2021-10-08,경의선,서울역,4152,5277,9429,10
2021-10-08,경부선,가산디지털단지,17607,20618,38225,10
2021-10-08,경부선,서울역,7022,2509,9531,10
2021-10-08,9호선,고속터미널,12592,17559,30151,10
2021-10-08,8호선,잠실(송파구청),13293,15792,29085,10
2021-10-08,7호선,가산디지털단지,44988,43962,88950,10
2021-10-08,7호선,고속터미널,16459,14267,30726,10
2021-10-08,4호선,사당,24075,20604,44679,10
2021-10-08,4호선,서울역,10044,16641,26685,10
2021-10-08,3호선,고속터미널,41883,46284,88167,10
2021-10-08,2호선,홍대입구,49257,52884,102141,10
2021-10-08,2호선,구로디지털단지,57798,57511,115309,10
2021-10-08,2호선,신림,61697,59293,120990,10
2021-10-08,2호선,사당,35518,38499,74017,10
2021-10-08,2호선,강남,81038,79857,160895,10
2021-10-08,2호선,선릉,53919,48028,101947,10
2021-10-08,2호선,잠실(송파구청),63617,63455,127072,10
2021-10-08,1호선,서울역,43942,44407,88349,10
2021-10-09,1호선,서울역,29541,32178,61719,10
2021-10-09,2호선,잠실(송파구청),56248,53641,109889,10
2021-10-09,2호선,선릉,19295,16911,36206,10
2021-10-09,2호선,강남,45442,45107,90549,10
2021-10-09,2호선,사당,24756,27383,52139,10
2021-10-09,2호선,신림,43711,41075,84786,10
2021-10-09,2호선,구로디지털단지,28904,28013,56917,10
2021-10-09,2호선,홍대입구,55233,58820,114053,10
2021-10-09,3호선,고속터미널,41222,46100,87322,10
2021-10-09,4호선,서울역,4840,12149,16989,10
2021-10-09,4호선,사당,17542,15119,32661,10
2021-10-09,7호선,고속터미널,11955,10292,22247,10
2021-10-09,7호선,가산디지털단지,13239,11949,25188,10
2021-10-09,8호선,잠실(송파구청),10833,12741,23574,10
2021-10-09,9호선,고속터미널,11202,17452,28654,10
2021-10-09,경부선,서울역,6291,2052,8343,10
2021-10-09,경부선,가산디지털단지,5934,7668,13602,10
2021-10-09,경의선,서울역,1232,1500,2732,10
2021-10-09,경의선,홍대입구,1858,2155,4013,10
2021-10-09,공항철도 1호선,서울역,6880,7954,14834,10
2021-10-09,공항철도 1호선,홍대입구,10884,10688,21572,10
2021-10-09,분당선,선릉,4131,6362,10493,10
2021-10-10,분당선,선릉,2568,3765,6333,10
2021-10-10,공항철도 1호선,홍대입구,8735,8440,17175,10
2021-10-10,공항철도 1호선,서울역,6476,5742,12218,10
2021-10-10,경의선,홍대입구,1469,1712,3181,10
2021-10-10,경의선,서울역,919,932,1851,10
2021-10-10,경부선,가산디지털단지,4095,5746,9841,10
2021-10-10,경부선,서울역,5905,1329,7234,10
2021-10-10,9호선,고속터미널,8321,11633,19954,10
2021-10-10,8호선,잠실(송파구청),9166,10251,19417,10
2021-10-10,7호선,가산디지털단지,9378,8273,17651,10
2021-10-10,7호선,고속터미널,10241,6853,17094,10
2021-10-10,4호선,사당,13501,11776,25277,10
2021-10-10,4호선,서울역,3692,8485,12177,10
2021-10-10,3호선,고속터미널,34621,32085,66706,10
2021-10-10,2호선,홍대입구,44911,44858,89769,10
2021-10-10,2호선,구로디지털단지,20318,19674,39992,10
2021-10-10,2호선,신림,32283,31869,64152,10
2021-10-10,2호선,사당,18608,20351,38959,10
2021-10-10,2호선,강남,31152,30307,61459,10
2021-10-10,2호선,선릉,11457,10209,21666,10
2021-10-10,2호선,잠실(송파구청),43430,40189,83619,10
2021-10-10,1호선,서울역,23858,21579,45437,10
2021-10-11,2호선,잠실(송파구청),46738,43539,90277,10
2021-10-11,2호선,선릉,19489,17473,36962,10
2021-10-11,2호선,강남,42588,41265,83853,10
2021-10-11,2호선,사당,22020,23959,45979,10
2021-10-11,2호선,신림,39260,39308,78568,10
2021-10-11,2호선,구로디지털단지,27317,27629,54946,10
2021-10-11,2호선,홍대입구,42619,43122,85741,10
2021-10-11,3호선,고속터미널,40869,35311,76180,10
2021-10-11,4호선,서울역,4320,8700,13020,10
2021-10-11,4호선,사당,14964,13775,28739,10
2021-10-11,7호선,고속터미널,12802,7970,20772,10
2021-10-11,7호선,가산디지털단지,14006,13388,27394,10
2021-10-11,8호선,잠실(송파구청),9849,10935,20784,10
2021-10-11,9호선,고속터미널,10766,13263,24029,10
2021-10-11,경부선,서울역,7021,1310,8331,10
2021-10-11,경부선,가산디지털단지,5511,7757,13268,10
2021-10-11,1호선,서울역,29518,24798,54316,10
2021-10-11,경의선,서울역,1299,1223,2522,10
2021-10-11,경의선,홍대입구,1380,1604,2984,10
2021-10-11,공항철도 1호선,서울역,7349,6180,13529,10
2021-10-11,공항철도 1호선,홍대입구,8540,8022,16562,10
2021-10-11,분당선,선릉,4018,5872,9890,10
2021-10-12,1호선,서울역,40264,37984,78248,10
2021-10-12,2호선,잠실(송파구청),60017,60351,120368,10
2021-10-12,2호선,선릉,55957,50028,105985,10
2021-10-12,2호선,강남,77263,75319,152582,10
2021-10-12,2호선,사당,33748,36936,70684,10
2021-10-12,2호선,신림,59644,58243,117887,10
2021-10-12,2호선,구로디지털단지,58945,59899,118844,10
2021-10-12,2호선,홍대입구,43149,44720,87869,10
2021-10-12,3호선,고속터미널,35289,33042,68331,10
2021-10-12,4호선,서울역,10189,13704,23893,10
2021-10-12,4호선,사당,22672,18985,41657,10
2021-10-12,7호선,고속터미널,14968,12528,27496,10
2021-10-12,7호선,가산디지털단지,47025,46924,93949,10
2021-10-12,8호선,잠실(송파구청),12218,14349,26567,10
2021-10-12,9호선,고속터미널,11133,13491,24624,10
2021-10-12,경부선,서울역,5429,1707,7136,10
2021-10-12,경부선,가산디지털단지,18241,21510,39751,10
2021-10-12,경의선,서울역,4337,5400,9737,10
2021-10-12,경의선,홍대입구,1435,1599,3034,10
2021-10-12,공항철도 1호선,서울역,7023,6314,13337,10
2021-10-12,공항철도 1호선,홍대입구,7874,8027,15901,10
2021-10-12,분당선,선릉,13550,20114,33664,10
2021-10-13,분당선,선릉,13560,20035,33595,10
2021-10-13,공항철도 1호선,홍대입구,8435,8342,16777,10
2021-10-13,공항철도 1호선,서울역,6702,6235,12937,10
2021-10-13,경의선,홍대입구,1692,1858,3550,10
2021-10-13,경의선,서울역,4285,5383,9668,10
2021-10-13,경부선,가산디지털단지,18316,21417,39733,10
2021-10-13,경부선,서울역,4793,1586,6379,10
2021-10-13,9호선,고속터미널,11419,14360,25779,10
2021-10-13,8호선,잠실(송파구청),12841,15251,28092,10
2021-10-13,7호선,가산디지털단지,46147,46253,92400,10
2021-10-13,7호선,고속터미널,14425,12774,27199,10
2021-10-13,4호선,사당,23328,19532,42860,10
2021-10-13,4호선,서울역,10445,14351,24796,10
2021-10-13,3호선,고속터미널,35304,33579,68883,10
2021-10-13,2호선,홍대입구,45217,47347,92564,10
2021-10-13,2호선,구로디지털단지,59204,59488,118692,10
2021-10-13,2호선,신림,60586,59156,119742,10
2021-10-13,2호선,사당,35090,37679,72769,10
2021-10-13,2호선,강남,78117,75978,154095,10
2021-10-13,2호선,선릉,55889,49633,105522,10
2021-10-13,2호선,잠실(송파구청),61605,61944,123549,10
2021-10-13,1호선,서울역,39952,38833,78785,10
2021-10-14,공항철도 1호선,홍대입구,8340,8304,16644,10
2021-10-14,공항철도 1호선,서울역,6978,6364,13342,10
2021-10-14,경의선,홍대입구,1432,1559,2991,10
2021-10-14,경의선,서울역,4334,5429,9763,10
2021-10-14,경부선,가산디지털단지,18081,21287,39368,10
2021-10-14,경부선,서울역,4936,1636,6572,10
2021-10-14,9호선,고속터미널,11486,14134,25620,10
2021-10-14,8호선,잠실(송파구청),12523,14687,27210,10
2021-10-14,7호선,가산디지털단지,45880,45921,91801,10
2021-10-14,7호선,고속터미널,14782,12818,27600,10
2021-10-14,4호선,사당,23062,19585,42647,10
2021-10-14,4호선,서울역,10205,14231,24436,10
2021-10-14,3호선,고속터미널,35559,34443,70002,10
2021-10-14,2호선,홍대입구,44548,46855,91403,10
2021-10-14,2호선,구로디지털단지,58638,59042,117680,10
2021-10-14,2호선,신림,60592,59028,119620,10
2021-10-14,2호선,사당,35088,37530,72618,10
2021-10-14,2호선,강남,77110,75528,152638,10
2021-10-14,2호선,선릉,55381,49408,104789,10
2021-10-14,2호선,잠실(송파구청),61079,60870,121949,10
2021-10-14,1호선,서울역,40207,38422,78629,10
2021-10-14,분당선,선릉,13281,19636,32917,10
2021-10-15,1호선,서울역,43300,41779,85079,10
2021-10-15,2호선,잠실(송파구청),64528,64115,128643,10
2021-10-15,2호선,선릉,54106,48067,102173,10
2021-10-15,2호선,강남,80757,79471,160228,10
2021-10-15,2호선,사당,36071,39031,75102,10
2021-10-15,2호선,신림,61866,59735,121601,10
2021-10-15,2호선,구로디지털단지,58420,58520,116940,10
2021-10-15,2호선,홍대입구,49345,52829,102174,10
2021-10-15,3호선,고속터미널,40739,42155,82894,10
2021-10-15,4호선,서울역,10003,15250,25253,10
2021-10-15,4호선,사당,24122,20388,44510,10
2021-10-15,7호선,고속터미널,16537,13853,30390,10
2021-10-15,7호선,가산디지털단지,44839,44257,89096,10
2021-10-15,8호선,잠실(송파구청),13298,15787,29085,10
2021-10-15,9호선,고속터미널,12663,16454,29117,10
2021-10-15,경부선,서울역,6746,2292,9038,10
2021-10-15,경부선,가산디지털단지,17703,20712,38415,10
2021-10-15,경의선,서울역,4231,5414,9645,10
2021-10-15,경의선,홍대입구,1671,1901,3572,10
2021-10-15,공항철도 1호선,서울역,8382,7961,16343,10
2021-10-15,공항철도 1호선,홍대입구,9363,9302,18665,10
2021-10-15,분당선,선릉,13116,19407,32523,10
2021-10-16,1호선,서울역,29661,30451,60112,10
2021-10-16,2호선,잠실(송파구청),59481,56888,116369,10
2021-10-16,2호선,선릉,23185,20209,43394,10
2021-10-16,2호선,강남,56982,56416,113398,10
2021-10-16,2호선,사당,28286,31252,59538,10
2021-10-16,2호선,신림,47798,46126,93924,10
2021-10-16,2호선,구로디지털단지,32156,31707,63863,10
2021-10-16,2호선,홍대입구,56503,58125,114628,10
2021-10-16,3호선,고속터미널,44333,44554,88887,10
2021-10-16,4호선,서울역,5133,11514,16647,10
2021-10-16,4호선,사당,19522,16968,36490,10
2021-10-16,7호선,고속터미널,12843,10434,23277,10
2021-10-16,7호선,가산디지털단지,15145,13542,28687,10
2021-10-16,8호선,잠실(송파구청),12641,14317,26958,10
2021-10-16,9호선,고속터미널,11424,16684,28108,10
2021-10-16,경부선,서울역,5584,1706,7290,10
2021-10-16,경부선,가산디지털단지,5992,8446,14438,10
2021-10-16,경의선,서울역,1161,1432,2593,10
2021-10-16,경의선,홍대입구,1704,2061,3765,10
2021-10-16,경의선,서울역,36,3,39,10
2021-10-16,공항철도 1호선,서울역,6533,6888,13421,10
2021-10-16,공항철도 1호선,홍대입구,10330,10303,20633,10
2021-10-16,분당선,선릉,4821,7569,12390,10
2021-10-17,2호선,선릉,11911,10268,22179,10
2021-10-17,2호선,강남,31812,30617,62429,10
2021-10-17,2호선,사당,19577,21298,40875,10
2021-10-17,2호선,신림,33963,32885,66848,10
2021-10-17,4호선,서울역,3665,8574,12239,10
2021-10-17,4호선,사당,13631,12587,26218,10
2021-10-17,7호선,고속터미널,10476,7026,17502,10
2021-10-17,7호선,가산디지털단지,11609,10556,22165,10
2021-10-17,8호선,잠실(송파구청),9566,10775,20341,10
2021-10-17,9호선,고속터미널,8870,11823,20693,10
2021-10-17,경부선,서울역,5999,1419,7418,10
2021-10-17,경부선,가산디지털단지,4525,6585,11110,10
2021-10-17,경의선,서울역,1015,977,1992,10
2021-10-17,경의선,홍대입구,1365,1596,2961,10
2021-10-17,공항철도 1호선,서울역,6556,5878,12434,10
2021-10-17,공항철도 1호선,홍대입구,8319,7413,15732,10
2021-10-17,분당선,선릉,2682,3833,6515,10
2021-10-17,2호선,구로디지털단지,21091,20810,41901,10
2021-10-17,2호선,홍대입구,40576,40377,80953,10
2021-10-17,3호선,고속터미널,35206,32974,68180,10
2021-10-17,1호선,서울역,25130,22780,47910,10
2021-10-17,2호선,잠실(송파구청),44553,41612,86165,10
2021-10-18,1호선,서울역,39339,37824,77163,10
2021-10-18,2호선,잠실(송파구청),57103,57169,114272,10
2021-10-18,2호선,선릉,54912,48728,103640,10
2021-10-18,2호선,강남,75174,73454,148628,10
2021-10-18,2호선,사당,33164,35603,68767,10
2021-10-18,2호선,신림,59127,57920,117047,10
2021-10-18,2호선,구로디지털단지,57715,58052,115767,10
2021-10-18,2호선,홍대입구,42688,43746,86434,10
2021-10-18,3호선,고속터미널,31491,29708,61199,10
2021-10-18,4호선,서울역,10040,13692,23732,10
2021-10-18,4호선,사당,22050,18782,40832,10
2021-10-18,7호선,고속터미널,14901,12488,27389,10
2021-10-18,7호선,가산디지털단지,46576,46242,92818,10
2021-10-18,8호선,잠실(송파구청),12128,14021,26149,10
2021-10-18,9호선,고속터미널,10625,12906,23531,10
2021-10-18,경부선,서울역,5181,1756,6937,10
2021-10-18,경부선,가산디지털단지,18149,21354,39503,10
2021-10-18,경의선,서울역,3584,5160,8744,10
2021-10-18,경의선,홍대입구,1325,1526,2851,10
2021-10-18,경의선,서울역,536,106,642,10
2021-10-18,공항철도 1호선,서울역,6814,6341,13155,10
2021-10-18,공항철도 1호선,홍대입구,7699,7754,15453,10
2021-10-18,분당선,선릉,13233,19773,33006,10
2021-10-19,1호선,서울역,39026,37067,76093,10
2021-10-19,2호선,구로디지털단지,58373,58630,117003,10
2021-10-19,2호선,신림,60165,58481,118646,10
2021-10-19,2호선,사당,34215,37200,71415,10
2021-10-19,2호선,강남,76177,74344,150521,10
2021-10-19,2호선,선릉,55758,49576,105334,10
2021-10-19,2호선,잠실(송파구청),61903,62122,124025,10
2021-10-19,7호선,고속터미널,14240,12618,26858,10
2021-10-19,7호선,가산디지털단지,46447,46377,92824,10
2021-10-19,8호선,잠실(송파구청),12767,14973,27740,10
2021-10-19,9호선,고속터미널,11083,13593,24676,10
2021-10-19,경부선,서울역,4548,1575,6123,10
2021-10-19,경부선,가산디지털단지,17966,21329,39295,10
2021-10-19,경의선,서울역,4120,5244,9364,10
2021-10-19,경의선,홍대입구,1414,1673,3087,10
2021-10-19,분당선,선릉,13266,19604,32870,10
2021-10-19,공항철도 1호선,서울역,6448,6045,12493,10
2021-10-19,공항철도 1호선,홍대입구,7599,7895,15494,10
2021-10-19,2호선,홍대입구,43542,44687,88229,10
2021-10-19,3호선,고속터미널,35163,33766,68929,10
2021-10-19,4호선,서울역,10054,13695,23749,10
2021-10-19,4호선,사당,23243,19442,42685,10
2021-10-20,7호선,가산디지털단지,46845,46899,93744,10
2021-10-20,4호선,사당,23893,20292,44185,10
2021-10-20,4호선,서울역,11006,14890,25896,10
2021-10-20,1호선,서울역,43293,41247,84540,10
2021-10-20,2호선,잠실(송파구청),62964,62629,125593,10
2021-10-20,2호선,선릉,56141,49902,106043,10
2021-10-20,2호선,강남,77819,75724,153543,10
2021-10-20,2호선,사당,36533,38686,75219,10
2021-10-20,2호선,신림,61731,60207,121938,10
2021-10-20,2호선,구로디지털단지,59483,59847,119330,10
2021-10-20,3호선,고속터미널,35963,34498,70461,10
2021-10-20,7호선,고속터미널,14389,12696,27085,10
2021-10-20,8호선,잠실(송파구청),12668,15211,27879,10
2021-10-20,9호선,고속터미널,11498,14271,25769,10
2021-10-20,경부선,서울역,4897,1599,6496,10
2021-10-20,경부선,가산디지털단지,18355,21605,39960,10
2021-10-20,경의선,서울역,4538,5386,9924,10
2021-10-20,경의선,홍대입구,1489,1746,3235,10
2021-10-20,공항철도 1호선,서울역,6935,6431,13366,10
2021-10-20,공항철도 1호선,홍대입구,8208,8299,16507,10
2021-10-20,분당선,선릉,13449,20129,33578,10
2021-10-20,2호선,홍대입구,45507,47418,92925,10
2021-10-21,8호선,잠실(송파구청),13026,15421,28447,10
2021-10-21,9호선,고속터미널,11412,14235,25647,10
2021-10-21,경부선,서울역,5226,1679,6905,10
2021-10-21,경부선,가산디지털단지,18231,21397,39628,10
2021-10-21,경의선,서울역,4188,5403,9591,10
2021-10-21,경의선,홍대입구,1516,1776,3292,10
2021-10-21,공항철도 1호선,서울역,7337,6630,13967,10
2021-10-21,공항철도 1호선,홍대입구,8248,8333,16581,10
2021-10-21,분당선,선릉,13303,19628,32931,10
2021-10-21,1호선,서울역,41035,39463,80498,10
2021-10-21,2호선,잠실(송파구청),63411,63262,126673,10
2021-10-21,2호선,선릉,55579,49641,105220,10
2021-10-21,2호선,강남,77360,75741,153101,10
2021-10-21,2호선,사당,35916,38781,74697,10
2021-10-21,2호선,신림,60815,59128,119943,10
2021-10-21,2호선,구로디지털단지,58564,58596,117160,10
2021-10-21,2호선,홍대입구,46038,48059,94097,10
2021-10-21,3호선,고속터미널,36659,35486,72145,10
2021-10-21,4호선,서울역,10389,14532,24921,10
2021-10-21,4호선,사당,23837,20193,44030,10
2021-10-21,7호선,고속터미널,14651,12615,27266,10
2021-10-21,7호선,가산디지털단지,46188,46282,92470,10
2021-10-22,경부선,가산디지털단지,17649,20810,38459,10
2021-10-22,경부선,서울역,7193,2307,9500,10
2021-10-22,9호선,고속터미널,12875,17143,30018,10
2021-10-22,8호선,잠실(송파구청),13939,16676,30615,10
2021-10-22,7호선,가산디지털단지,44916,44270,89186,10
2021-10-22,7호선,고속터미널,16675,13913,30588,10
2021-10-22,4호선,사당,25380,22352,47732,10
2021-10-22,4호선,서울역,10419,16386,26805,10
2021-10-22,3호선,고속터미널,42369,45018,87387,10
2021-10-22,1호선,서울역,45729,44341,90070,10
2021-10-22,2호선,잠실(송파구청),68633,67789,136422,10
2021-10-22,2호선,선릉,54619,48707,103326,10
2021-10-22,2호선,강남,82697,81299,163996,10
2021-10-22,2호선,사당,37599,41892,79491,10
2021-10-22,2호선,신림,63119,60478,123597,10
2021-10-22,2호선,구로디지털단지,58924,58532,117456,10
2021-10-22,2호선,홍대입구,52811,55769,108580,10
2021-10-22,분당선,선릉,13057,19572,32629,10
2021-10-22,공항철도 1호선,홍대입구,9957,10093,20050,10
2021-10-22,공항철도 1호선,서울역,8640,8354,16994,10
2021-10-22,경의선,홍대입구,1717,2131,3848,10
2021-10-22,경의선,서울역,4237,5607,9844,10
2021-10-23,경의선,홍대입구,1816,2223,4039,10
2021-10-23,경의선,서울역,1392,1446,2838,10
2021-10-23,경부선,가산디지털단지,6638,8851,15489,10
2021-10-23,경부선,서울역,6455,1688,8143,10
2021-10-23,9호선,고속터미널,12117,17484,29601,10
2021-10-23,8호선,잠실(송파구청),12105,14539,26644,10
2021-10-23,7호선,가산디지털단지,16000,14578,30578,10
2021-10-23,7호선,고속터미널,13756,10688,24444,10
2021-10-23,4호선,사당,20548,17627,38175,10
2021-10-23,4호선,서울역,5313,12179,17492,10
2021-10-23,3호선,고속터미널,45283,46730,92013,10
2021-10-23,2호선,홍대입구,60260,64158,124418,10
2021-10-23,2호선,구로디지털단지,33158,32466,65624,10
2021-10-23,2호선,신림,48909,46702,95611,10
2021-10-23,2호선,사당,29594,33149,62743,10
2021-10-23,2호선,강남,57308,57246,114554,10
2021-10-23,2호선,선릉,23859,20972,44831,10
2021-10-23,2호선,잠실(송파구청),64989,61557,126546,10
2021-10-23,1호선,서울역,31208,31936,63144,10
2021-10-23,분당선,선릉,5058,7990,13048,10
2021-10-23,공항철도 1호선,홍대입구,11556,11031,22587,10
2021-10-23,공항철도 1호선,서울역,7378,7629,15007,10
2021-10-24,7호선,고속터미널,11919,7654,19573,10
2021-10-24,7호선,가산디지털단지,11975,10889,22864,10
2021-10-24,8호선,잠실(송파구청),9457,10850,20307,10
2021-10-24,9호선,고속터미널,9919,13239,23158,10
2021-10-24,경부선,서울역,6931,1571,8502,10
2021-10-24,경부선,가산디지털단지,5008,7066,12074,10
2021-10-24,경의선,홍대입구,1603,1803,3406,10
2021-10-24,경의선,서울역,1118,982,2100,10
2021-10-24,1호선,서울역,26214,23809,50023,10
2021-10-24,2호선,잠실(송파구청),48901,45286,94187,10
2021-10-24,2호선,선릉,12921,11224,24145,10
2021-10-24,2호선,강남,33739,32249,65988,10
2021-10-24,2호선,사당,21032,23407,44439,10
2021-10-24,2호선,신림,35397,35047,70444,10
2021-10-24,2호선,구로디지털단지,22551,22283,44834,10
2021-10-24,2호선,홍대입구,44831,44711,89542,10
2021-10-24,3호선,고속터미널,37868,35168,73036,10
2021-10-24,4호선,서울역,3946,9276,13222,10
2021-10-24,4호선,사당,14496,13615,28111,10
2021-10-24,분당선,선릉,2836,4158,6994,10
2021-10-24,공항철도 1호선,홍대입구,9243,8509,17752,10
2021-10-24,공항철도 1호선,서울역,7297,6341,13638,10
2021-10-25,1호선,서울역,41620,39523,81143,10
2021-10-25,2호선,잠실(송파구청),61944,61990,123934,10
2021-10-25,2호선,선릉,56216,50135,106351,10
2021-10-25,2호선,강남,77152,75743,152895,10
2021-10-25,2호선,사당,34384,37564,71948,10
2021-10-25,2호선,신림,60575,58984,119559,10
2021-10-25,2호선,구로디지털단지,59164,59807,118971,10
2021-10-25,2호선,홍대입구,44334,45537,89871,10
2021-10-25,3호선,고속터미널,36705,34970,71675,10
2021-10-25,4호선,서울역,10307,14310,24617,10
2021-10-25,4호선,사당,23260,19747,43007,10
2021-10-25,7호선,고속터미널,15485,13166,28651,10
2021-10-25,7호선,가산디지털단지,46831,47027,93858,10
2021-10-25,8호선,잠실(송파구청),12775,15068,27843,10
2021-10-25,9호선,고속터미널,11542,13957,25499,10
2021-10-25,경부선,서울역,5619,1795,7414,10
2021-10-25,경부선,가산디지털단지,18596,21784,40380,10
2021-10-25,경의선,서울역,4356,5405,9761,10
2021-10-25,경의선,홍대입구,1488,1627,3115,10
2021-10-25,공항철도 1호선,서울역,7251,6810,14061,10
2021-10-25,공항철도 1호선,홍대입구,7995,8163,16158,10
2021-10-25,분당선,선릉,13286,20109,33395,10
2021-10-26,분당선,선릉,13839,20379,34218,10
2021-10-26,공항철도 1호선,홍대입구,8196,8144,16340,10
2021-10-26,공항철도 1호선,서울역,6884,6406,13290,10
2021-10-26,경의선,홍대입구,1504,1778,3282,10
2021-10-26,경의선,서울역,4396,5609,10005,10
2021-10-26,경부선,가산디지털단지,18635,21822,40457,10
2021-10-26,경부선,서울역,5041,1607,6648,10
2021-10-26,9호선,고속터미널,11562,14331,25893,10
2021-10-26,8호선,잠실(송파구청),13195,15853,29048,10
2021-10-26,7호선,가산디지털단지,47651,47668,95319,10
2021-10-26,7호선,고속터미널,15243,13274,28517,10
2021-10-26,4호선,사당,24516,20825,45341,10
2021-10-26,4호선,서울역,10674,14719,25393,10
2021-10-26,3호선,고속터미널,36065,34949,71014,10
2021-10-26,2호선,홍대입구,46260,47808,94068,10
2021-10-26,2호선,구로디지털단지,60294,60546,120840,10
2021-10-26,2호선,신림,61755,60271,122026,10
2021-10-26,2호선,사당,36308,39046,75354,10
2021-10-26,2호선,강남,79681,78083,157764,10
2021-10-26,2호선,선릉,57546,51159,108705,10
2021-10-26,2호선,잠실(송파구청),65101,64937,130038,10
2021-10-26,1호선,서울역,41639,39712,81351,10
2021-10-27,분당선,선릉,13786,20685,34471,10
2021-10-27,공항철도 1호선,홍대입구,8618,8843,17461,10
2021-10-27,공항철도 1호선,서울역,7202,6535,13737,10
2021-10-27,경의선,홍대입구,1577,1805,3382,10
2021-10-27,경의선,서울역,4224,5517,9741,10
2021-10-27,경부선,가산디지털단지,18734,21855,40589,10
2021-10-27,경부선,서울역,5265,1741,7006,10
2021-10-27,9호선,고속터미널,12094,14863,26957,10
2021-10-27,8호선,잠실(송파구청),13476,15840,29316,10
2021-10-27,7호선,가산디지털단지,47008,47104,94112,10
2021-10-27,7호선,고속터미널,15050,13188,28238,10
2021-10-27,4호선,사당,24757,21057,45814,10
2021-10-27,4호선,서울역,10895,15360,26255,10
2021-10-27,3호선,고속터미널,37167,35820,72987,10
2021-10-27,2호선,홍대입구,48439,50054,98493,10
2021-10-27,2호선,구로디지털단지,61083,61771,122854,10
2021-10-27,2호선,신림,62118,60979,123097,10
2021-10-27,2호선,사당,36672,39743,76415,10
2021-10-27,2호선,강남,80813,78662,159475,10
2021-10-27,2호선,선릉,58288,51608,109896,10
2021-10-27,2호선,잠실(송파구청),66935,66607,133542,10
2021-10-27,1호선,서울역,42450,40698,83148,10
2021-10-28,분당선,선릉,13394,20034,33428,10
2021-10-28,공항철도 1호선,홍대입구,9162,9013,18175,10
2021-10-28,공항철도 1호선,서울역,7539,6822,14361,10
2021-10-28,경의선,홍대입구,1642,1821,3463,10
2021-10-28,경의선,서울역,4297,5738,10035,10
2021-10-28,경부선,가산디지털단지,18328,21463,39791,10
2021-10-28,경부선,서울역,5659,1878,7537,10
2021-10-28,9호선,고속터미널,12046,14975,27021,10
2021-10-28,8호선,잠실(송파구청),13346,15842,29188,10
2021-10-28,7호선,가산디지털단지,46033,46202,92235,10
2021-10-28,7호선,고속터미널,15402,13130,28532,10
2021-10-28,4호선,사당,25154,20906,46060,10
2021-10-28,4호선,서울역,10575,15363,25938,10
2021-10-28,3호선,고속터미널,37997,36912,74909,10
2021-10-28,2호선,홍대입구,49901,51649,101550,10
2021-10-28,2호선,구로디지털단지,59806,59719,119525,10
2021-10-28,2호선,신림,62759,60426,123185,10
2021-10-28,2호선,사당,36390,40219,76609,10
2021-10-28,2호선,강남,80330,78605,158935,10
2021-10-28,2호선,선릉,56521,50533,107054,10
2021-10-28,2호선,잠실(송파구청),68077,67312,135389,10
2021-10-28,1호선,서울역,42809,41102,83911,10
2021-10-29,경의선,홍대입구,1826,2110,3936,10
2021-10-29,경의선,서울역,4381,5720,10101,10
2021-10-29,경부선,가산디지털단지,18095,20949,39044,10
2021-10-29,경부선,서울역,7647,2490,10137,10
2021-10-29,9호선,고속터미널,13432,18319,31751,10
2021-10-29,8호선,잠실(송파구청),14122,16916,31038,10
2021-10-29,7호선,가산디지털단지,44921,44515,89436,10
2021-10-29,7호선,고속터미널,17729,14365,32094,10
2021-10-29,4호선,사당,26003,22123,48126,10
2021-10-29,4호선,서울역,10773,17352,28125,10
2021-10-29,3호선,고속터미널,44216,46810,91026,10
2021-10-29,2호선,홍대입구,56048,59757,115805,10
2021-10-29,2호선,구로디지털단지,59428,59110,118538,10
2021-10-29,2호선,신림,63729,62028,125757,10
2021-10-29,2호선,사당,38558,42070,80628,10
2021-10-29,2호선,강남,84655,84011,168666,10
2021-10-29,2호선,선릉,55740,49507,105247,10
2021-10-29,2호선,잠실(송파구청),71828,71850,143678,10
2021-10-29,1호선,서울역,47574,46331,93905,10
2021-10-29,분당선,선릉,13034,19820,32854,10
2021-10-29,공항철도 1호선,홍대입구,10318,10749,21067,10
2021-10-29,공항철도 1호선,서울역,9123,8902,18025,10
2021-10-30,분당선,선릉,5113,8159,13272,10
2021-10-30,공항철도 1호선,홍대입구,12484,12328,24812,10
2021-10-30,공항철도 1호선,서울역,7824,8187,16011,10
2021-10-30,경의선,홍대입구,2015,2557,4572,10
2021-10-30,경의선,서울역,1387,1704,3091,10
2021-10-30,경부선,가산디지털단지,6588,8763,15351,10
2021-10-30,경부선,서울역,6910,1903,8813,10
2021-10-30,9호선,고속터미널,12396,17855,30251,10
2021-10-30,8호선,잠실(송파구청),12728,15464,28192,10
2021-10-30,7호선,가산디지털단지,15033,13819,28852,10
2021-10-30,7호선,고속터미널,14412,11138,25550,10
2021-10-30,4호선,사당,21122,18631,39753,10
2021-10-30,4호선,서울역,5704,13266,18970,10
2021-10-30,3호선,고속터미널,46367,47957,94324,10
2021-10-30,2호선,홍대입구,64173,69749,133922,10
2021-10-30,2호선,구로디지털단지,34238,33771,68009,10
2021-10-30,2호선,신림,50615,47831,98446,10
2021-10-30,2호선,사당,30865,34375,65240,10
2021-10-30,2호선,강남,60381,60378,120759,10
2021-10-30,2호선,선릉,24150,21361,45511,10
2021-10-30,2호선,잠실(송파구청),69975,66688,136663,10
2021-10-30,1호선,서울역,32921,33877,66798,10
2021-10-31,1호선,서울역,29039,26889,55928,10
2021-10-31,공항철도 1호선,홍대입구,10460,9590,20050,10
2021-10-31,공항철도 1호선,서울역,7894,7085,14979,10
2021-10-31,경의선,홍대입구,1724,1980,3704,10
2021-10-31,경의선,서울역,1163,1121,2284,10
2021-10-31,경부선,가산디지털단지,4943,6770,11713,10
2021-10-31,경부선,서울역,7461,1651,9112,10
2021-10-31,9호선,고속터미널,10200,13597,23797,10
2021-10-31,8호선,잠실(송파구청),10266,11791,22057,10
2021-10-31,7호선,가산디지털단지,11129,10498,21627,10
2021-10-31,7호선,고속터미널,13183,8152,21335,10
2021-10-31,4호선,사당,15219,14181,29400,10
2021-10-31,4호선,서울역,4204,10185,14389,10
2021-10-31,3호선,고속터미널,39882,36836,76718,10
2021-10-31,2호선,홍대입구,51690,51428,103118,10
2021-10-31,2호선,구로디지털단지,23613,23126,46739,10
2021-10-31,2호선,신림,36634,36238,72872,10
2021-10-31,2호선,사당,21870,24310,46180,10
2021-10-31,2호선,강남,35888,34675,70563,10
2021-10-31,2호선,선릉,13499,11539,25038,10
2021-10-31,2호선,잠실(송파구청),54985,50559,105544,10
2021-10-31,분당선,선릉,2837,4303,7140,10
2021-11-01,공항철도 1호선,홍대입구,8344,8440,16784,11
2021-11-01,공항철도 1호선,서울역,7242,6910,14152,11
2021-11-01,경의선,홍대입구,1477,1686,3163,11
2021-11-01,경의선,서울역,4438,5635,10073,11
2021-11-01,경부선,가산디지털단지,18801,21856,40657,11
2021-11-01,경부선,서울역,5903,1796,7699,11
2021-11-01,9호선,고속터미널,11341,13895,25236,11
2021-11-01,8호선,잠실(송파구청),12724,15409,28133,11
2021-11-01,7호선,가산디지털단지,47567,47746,95313,11
2021-11-01,7호선,고속터미널,15808,13136,28944,11
2021-11-01,4호선,사당,20821,19987,40808,11
2021-11-01,4호선,서울역,10710,15107,25817,11
2021-11-01,1호선,서울역,42897,40304,83201,11
2021-11-01,분당선,선릉,13347,20480,33827,11
2021-11-01,3호선,고속터미널,35265,33923,69188,11
2021-11-01,2호선,홍대입구,45737,48427,94164,11
2021-11-01,2호선,구로디지털단지,60417,60702,121119,11
2021-11-01,2호선,잠실(송파구청),63586,63679,127265,11
2021-11-01,2호선,선릉,56895,50844,107739,11
2021-11-01,2호선,강남,77095,77542,154637,11
2021-11-01,2호선,사당,37489,38346,75835,11
2021-11-01,2호선,신림,60916,58969,119885,11
2021-11-02,1호선,서울역,42269,40549,82818,11
2021-11-02,2호선,잠실(송파구청),65682,65419,131101,11
2021-11-02,2호선,선릉,58889,52472,111361,11
2021-11-02,2호선,강남,79761,79635,159396,11
2021-11-02,2호선,사당,36813,40279,77092,11
2021-11-02,2호선,신림,62234,60315,122549,11
2021-11-02,2호선,구로디지털단지,61629,61733,123362,11
2021-11-02,2호선,홍대입구,47136,49692,96828,11
2021-11-02,3호선,고속터미널,34607,33688,68295,11
2021-11-02,4호선,서울역,11332,15229,26561,11
2021-11-02,4호선,사당,24694,20778,45472,11
2021-11-02,7호선,고속터미널,14728,12927,27655,11
2021-11-02,7호선,가산디지털단지,48211,48395,96606,11
2021-11-02,8호선,잠실(송파구청),13085,15797,28882,11
2021-11-02,9호선,고속터미널,11167,13906,25073,11
2021-11-02,경부선,서울역,4868,1693,6561,11
2021-11-02,경부선,가산디지털단지,19019,20923,39942,11
2021-11-02,경의선,서울역,4472,5791,10263,11
2021-11-02,경의선,홍대입구,1573,1789,3362,11
2021-11-02,공항철도 1호선,서울역,6959,6519,13478,11
2021-11-02,공항철도 1호선,홍대입구,8549,8664,17213,11
2021-11-02,분당선,선릉,13888,21001,34889,11
2021-11-03,1호선,서울역,43224,41620,84844,11
2021-11-03,분당선,선릉,13774,20920,34694,11
2021-11-03,경의선,서울역,4486,5640,10126,11
2021-11-03,2호선,잠실(송파구청),68127,68280,136407,11
2021-11-03,2호선,선릉,58905,52376,111281,11
2021-11-03,2호선,강남,82299,82006,164305,11
2021-11-03,2호선,사당,37147,40938,78085,11
2021-11-03,2호선,신림,62985,60657,123642,11
2021-11-03,2호선,구로디지털단지,62008,62166,124174,11
2021-11-03,2호선,홍대입구,48806,52159,100965,11
2021-11-03,3호선,고속터미널,35335,34429,69764,11
2021-11-03,공항철도 1호선,홍대입구,9034,9240,18274,11
2021-11-03,공항철도 1호선,서울역,7277,6803,14080,11
2021-11-03,경의선,홍대입구,1623,1929,3552,11
2021-11-03,경부선,가산디지털단지,19099,22025,41124,11
2021-11-03,경부선,서울역,5122,1768,6890,11
2021-11-03,9호선,고속터미널,11990,14403,26393,11
2021-11-03,8호선,잠실(송파구청),13711,16638,30349,11
2021-11-03,7호선,가산디지털단지,47944,48277,96221,11
2021-11-03,7호선,고속터미널,14690,12948,27638,11
2021-11-03,4호선,서울역,11278,15769,27047,11
2021-11-03,4호선,사당,24959,21335,46294,11
2021-11-04,2호선,구로디지털단지,61556,61532,123088,11
2021-11-04,2호선,신림,62321,60273,122594,11
2021-11-04,2호선,사당,37286,40994,78280,11
2021-11-04,2호선,강남,81911,81925,163836,11
2021-11-04,2호선,선릉,58291,51949,110240,11
2021-11-04,2호선,잠실(송파구청),67738,67916,135654,11
2021-11-04,1호선,서울역,44063,42611,86674,11
2021-11-04,분당선,선릉,13616,20744,34360,11
2021-11-04,공항철도 1호선,홍대입구,9032,9006,18038,11
2021-11-04,공항철도 1호선,서울역,7671,7027,14698,11
2021-11-04,경의선,홍대입구,1578,1864,3442,11
2021-11-04,경의선,서울역,4531,5842,10373,11
2021-11-04,경부선,가산디지털단지,18936,21957,40893,11
2021-11-04,경부선,서울역,5505,1842,7347,11
2021-11-04,9호선,고속터미널,12028,14972,27000,11
2021-11-04,8호선,잠실(송파구청),13313,16319,29632,11
2021-11-04,7호선,가산디지털단지,47319,47701,95020,11
2021-11-04,7호선,고속터미널,15018,12994,28012,11
2021-11-04,4호선,사당,25292,21480,46772,11
2021-11-04,4호선,서울역,11108,16398,27506,11
2021-11-04,3호선,고속터미널,36900,35780,72680,11
2021-11-04,2호선,홍대입구,49055,52490,101545,11
2021-11-05,2호선,사당,39959,44346,84305,11
2021-11-05,경의선,홍대입구,1816,2241,4057,11
2021-11-05,경의선,서울역,4588,5960,10548,11
2021-11-05,경부선,가산디지털단지,19080,21887,40967,11
2021-11-05,경부선,서울역,7894,2601,10495,11
2021-11-05,9호선,고속터미널,13558,18338,31896,11
2021-11-05,8호선,잠실(송파구청),14159,17571,31730,11
2021-11-05,7호선,가산디지털단지,47022,46977,93999,11
2021-11-05,7호선,고속터미널,17688,14497,32185,11
2021-11-05,4호선,사당,26960,23290,50250,11
2021-11-05,4호선,서울역,11017,18464,29481,11
2021-11-05,3호선,고속터미널,43777,47063,90840,11
2021-11-05,1호선,서울역,49620,48802,98422,11
2021-11-05,2호선,홍대입구,55704,63397,119101,11
2021-11-05,2호선,구로디지털단지,62685,61633,124318,11
2021-11-05,2호선,신림,65695,62586,128281,11
2021-11-05,2호선,잠실(송파구청),73768,73797,147565,11
2021-11-05,2호선,선릉,57430,51150,108580,11
2021-11-05,2호선,강남,86937,89845,176782,11
2021-11-05,분당선,선릉,13342,20462,33804,11
2021-11-05,공항철도 1호선,홍대입구,10323,10939,21262,11
2021-11-05,공항철도 1호선,서울역,9497,9163,18660,11
2021-11-06,공항철도 1호선,서울역,7828,8391,16219,11
2021-11-06,공항철도 1호선,홍대입구,11789,12169,23958,11
2021-11-06,분당선,선릉,5037,8065,13102,11
2021-11-06,경의선,서울역,1472,1605,3077,11
2021-11-06,경의선,홍대입구,1966,2448,4414,11
2021-11-06,3호선,고속터미널,46622,48148,94770,11
2021-11-06,2호선,홍대입구,61055,70358,131413,11
2021-11-06,2호선,구로디지털단지,35364,34203,69567,11
2021-11-06,2호선,신림,51403,48329,99732,11
2021-11-06,2호선,사당,31880,35805,67685,11
2021-11-06,2호선,강남,60591,64409,125000,11
2021-11-06,2호선,선릉,24278,21006,45284,11
2021-11-06,2호선,잠실(송파구청),70753,67285,138038,11
2021-11-06,1호선,서울역,35801,36192,71993,11
2021-11-06,4호선,서울역,5961,14295,20256,11
2021-11-06,4호선,사당,22227,19638,41865,11
2021-11-06,7호선,고속터미널,15216,12069,27285,11
2021-11-06,7호선,가산디지털단지,15367,14178,29545,11
2021-11-06,8호선,잠실(송파구청),13049,15772,28821,11
2021-11-06,9호선,고속터미널,12598,18496,31094,11
2021-11-06,경부선,서울역,7642,2082,9724,11
2021-11-06,경부선,가산디지털단지,6874,8991,15865,11
2021-11-07,분당선,선릉,2860,4351,7211,11
2021-11-07,공항철도 1호선,홍대입구,9883,9178,19061,11
2021-11-07,공항철도 1호선,서울역,8276,7440,15716,11
2021-11-07,경의선,홍대입구,1606,1865,3471,11
2021-11-07,경의선,서울역,1187,1126,2313,11
2021-11-07,경부선,가산디지털단지,5363,7179,12542,11
2021-11-07,경부선,서울역,7977,1693,9670,11
2021-11-07,9호선,고속터미널,10620,14490,25110,11
2021-11-07,8호선,잠실(송파구청),10083,11360,21443,11
2021-11-07,7호선,가산디지털단지,11290,10627,21917,11
2021-11-07,7호선,고속터미널,13720,8685,22405,11
2021-11-07,4호선,사당,15873,14966,30839,11
2021-11-07,4호선,서울역,4418,10710,15128,11
2021-11-07,3호선,고속터미널,40528,37685,78213,11
2021-11-07,2호선,홍대입구,48166,48680,96846,11
2021-11-07,2호선,구로디지털단지,24601,24146,48747,11
2021-11-07,2호선,신림,37386,36835,74221,11
2021-11-07,2호선,사당,22937,25672,48609,11
2021-11-07,2호선,강남,35654,35479,71133,11
2021-11-07,2호선,선릉,13300,11601,24901,11
2021-11-07,2호선,잠실(송파구청),52461,49225,101686,11
2021-11-07,1호선,서울역,30772,28106,58878,11
2021-11-08,4호선,사당,22781,19415,42196,11
2021-11-08,7호선,고속터미널,15051,12475,27526,11
2021-11-08,7호선,가산디지털단지,48212,47484,95696,11
2021-11-08,8호선,잠실(송파구청),12491,14713,27204,11
2021-11-08,경부선,서울역,6007,1954,7961,11
2021-11-08,경의선,서울역,4202,5280,9482,11
2021-11-08,경의선,홍대입구,1279,1483,2762,11
2021-11-08,공항철도 1호선,서울역,7480,7265,14745,11
2021-11-08,공항철도 1호선,홍대입구,7498,7608,15106,11
2021-11-08,분당선,선릉,13491,20526,34017,11
2021-11-08,2호선,잠실(송파구청),56494,58015,114509,11
2021-11-08,2호선,선릉,55540,49648,105188,11
2021-11-08,2호선,강남,77570,77413,154983,11
2021-11-08,2호선,사당,33236,36592,69828,11
2021-11-08,2호선,신림,59263,57466,116729,11
2021-11-08,2호선,구로디지털단지,58467,59071,117538,11
2021-11-08,2호선,홍대입구,42472,44125,86597,11
2021-11-08,3호선,고속터미널,36596,34211,70807,11
2021-11-08,4호선,서울역,10499,14854,25353,11
2021-11-08,9호선,고속터미널,10720,13653,24373,11
2021-11-08,경부선,가산디지털단지,18041,21219,39260,11
2021-11-08,1호선,서울역,41922,39334,81256,11
2021-11-09,1호선,서울역,42800,40561,83361,11
2021-11-09,2호선,잠실(송파구청),63342,63683,127025,11
2021-11-09,2호선,선릉,58440,52231,110671,11
2021-11-09,2호선,강남,81216,81060,162276,11
2021-11-09,2호선,사당,36600,39777,76377,11
2021-11-09,2호선,신림,61481,59288,120769,11
2021-11-09,2호선,구로디지털단지,60899,61179,122078,11
2021-11-09,2호선,홍대입구,45223,47598,92821,11
2021-11-09,3호선,고속터미널,35966,34477,70443,11
2021-11-09,4호선,서울역,11229,15529,26758,11
2021-11-09,4호선,사당,24341,20836,45177,11
2021-11-09,7호선,고속터미널,14756,12824,27580,11
2021-11-09,7호선,가산디지털단지,48499,48455,96954,11
2021-11-09,8호선,잠실(송파구청),13459,15949,29408,11
2021-11-09,9호선,고속터미널,11111,13888,24999,11
2021-11-09,경부선,서울역,5056,1761,6817,11
2021-11-09,경부선,가산디지털단지,18394,21510,39904,11
2021-11-09,경의선,서울역,4346,5475,9821,11
2021-11-09,경의선,홍대입구,1420,1645,3065,11
2021-11-09,공항철도 1호선,서울역,7060,6520,13580,11
2021-11-09,공항철도 1호선,홍대입구,7891,8015,15906,11
2021-11-09,분당선,선릉,13987,20972,34959,11
2021-11-10,1호선,서울역,44256,42023,86279,11
2021-11-10,2호선,잠실(송파구청),67669,68335,136004,11
2021-11-10,2호선,선릉,59178,53016,112194,11
2021-11-10,2호선,강남,84587,84480,169067,11
2021-11-10,2호선,사당,37656,41482,79138,11
2021-11-10,2호선,신림,63824,61833,125657,11
2021-11-10,2호선,구로디지털단지,62679,62669,125348,11
2021-11-10,2호선,홍대입구,49961,52695,102656,11
2021-11-10,3호선,고속터미널,37979,36674,74653,11
2021-11-10,4호선,서울역,11599,16383,27982,11
2021-11-10,4호선,사당,25667,21855,47522,11
2021-11-10,7호선,고속터미널,15160,13371,28531,11
2021-11-10,7호선,가산디지털단지,49003,48945,97948,11
2021-11-10,8호선,잠실(송파구청),13957,16544,30501,11
2021-11-10,9호선,고속터미널,12090,15052,27142,11
2021-11-10,경부선,서울역,5529,1770,7299,11
2021-11-10,경부선,가산디지털단지,18938,22212,41150,11
2021-11-10,경의선,서울역,4405,5499,9904,11
2021-11-10,경의선,홍대입구,1577,1814,3391,11
2021-11-10,공항철도 1호선,서울역,7499,7003,14502,11
2021-11-10,공항철도 1호선,홍대입구,8784,9058,17842,11
2021-11-10,분당선,선릉,14131,21190,35321,11
2021-11-11,2호선,홍대입구,52503,56251,108754,11
2021-11-11,3호선,고속터미널,40036,39147,79183,11
2021-11-11,4호선,서울역,11570,17073,28643,11
2021-11-11,4호선,사당,26047,22203,48250,11
2021-11-11,7호선,고속터미널,15700,13644,29344,11
2021-11-11,7호선,가산디지털단지,48332,48414,96746,11
2021-11-11,8호선,잠실(송파구청),14106,16892,30998,11
2021-11-11,9호선,고속터미널,12142,15789,27931,11
2021-11-11,경부선,서울역,5934,1990,7924,11
2021-11-11,경부선,가산디지털단지,18560,21651,40211,11
2021-11-11,경의선,서울역,4636,5816,10452,11
2021-11-11,경의선,홍대입구,1587,1862,3449,11
2021-11-11,공항철도 1호선,서울역,7984,7390,15374,11
2021-11-11,공항철도 1호선,홍대입구,9307,9457,18764,11
2021-11-11,분당선,선릉,13915,20869,34784,11
2021-11-11,2호선,구로디지털단지,62666,62396,125062,11
2021-11-11,2호선,신림,64055,61947,126002,11
2021-11-11,2호선,사당,38848,42630,81478,11
2021-11-11,2호선,강남,84684,84623,169307,11
2021-11-11,2호선,선릉,58878,52658,111536,11
2021-11-11,2호선,잠실(송파구청),69667,70025,139692,11
2021-11-11,1호선,서울역,45900,44348,90248,11
2021-11-12,1호선,서울역,50931,50257,101188,11
2021-11-12,2호선,잠실(송파구청),73019,72900,145919,11
2021-11-12,2호선,선릉,57530,51178,108708,11
2021-11-12,2호선,강남,89317,92082,181399,11
2021-11-12,2호선,사당,40263,45440,85703,11
2021-11-12,2호선,신림,65638,62568,128206,11
2021-11-12,2호선,구로디지털단지,62071,61665,123736,11
2021-11-12,2호선,홍대입구,57887,65914,123801,11
2021-11-12,3호선,고속터미널,47248,50572,97820,11
2021-11-12,4호선,서울역,11644,19591,31235,11
2021-11-12,4호선,사당,27134,23773,50907,11
2021-11-12,7호선,고속터미널,18368,15006,33374,11
2021-11-12,7호선,가산디지털단지,47053,46517,93570,11
2021-11-12,8호선,잠실(송파구청),14549,17536,32085,11
2021-11-12,9호선,고속터미널,13580,19298,32878,11
2021-11-12,경부선,서울역,8440,2763,11203,11
2021-11-12,경부선,가산디지털단지,18697,21411,40108,11
2021-11-12,경의선,서울역,3245,5702,8947,11
2021-11-12,경의선,홍대입구,1801,2199,4000,11
2021-11-12,경의선,서울역,1195,296,1491,11
2021-11-12,공항철도 1호선,서울역,9808,9830,19638,11
2021-11-12,공항철도 1호선,홍대입구,10526,11498,22024,11
2021-11-12,분당선,선릉,13603,20678,34281,11
2021-11-13,분당선,선릉,5052,8129,13181,11
2021-11-13,공항철도 1호선,홍대입구,12285,12646,24931,11
2021-11-13,공항철도 1호선,서울역,8347,9060,17407,11
2021-11-13,경의선,홍대입구,1877,2386,4263,11
2021-11-13,경의선,서울역,1533,1614,3147,11
2021-11-13,경부선,가산디지털단지,6919,8907,15826,11
2021-11-13,경부선,서울역,8030,2156,10186,11
2021-11-13,9호선,고속터미널,12773,19090,31863,11
2021-11-13,8호선,잠실(송파구청),12629,15235,27864,11
2021-11-13,7호선,가산디지털단지,16518,15011,31529,11
2021-11-13,7호선,고속터미널,15393,11835,27228,11
2021-11-13,4호선,사당,22381,19658,42039,11
2021-11-13,4호선,서울역,6150,15612,21762,11
2021-11-13,3호선,고속터미널,49211,51572,100783,11
2021-11-13,2호선,홍대입구,62614,71630,134244,11
2021-11-13,2호선,구로디지털단지,35418,34467,69885,11
2021-11-13,2호선,신림,50467,47690,98157,11
2021-11-13,2호선,사당,32804,36423,69227,11
2021-11-13,2호선,강남,61857,65399,127256,11
2021-11-13,2호선,선릉,24571,21664,46235,11
2021-11-13,2호선,잠실(송파구청),67050,64393,131443,11
2021-11-13,1호선,서울역,38309,38972,77281,11
2021-11-14,9호선,고속터미널,10506,14206,24712,11
2021-11-14,8호선,잠실(송파구청),9769,11300,21069,11
2021-11-14,7호선,가산디지털단지,12066,11050,23116,11
2021-11-14,7호선,고속터미널,13868,8490,22358,11
2021-11-14,4호선,사당,15397,14433,29830,11
2021-11-14,4호선,서울역,4400,10835,15235,11
2021-11-14,3호선,고속터미널,41312,39077,80389,11
2021-11-14,2호선,홍대입구,48120,48022,96142,11
2021-11-14,2호선,구로디지털단지,24040,23804,47844,11
2021-11-14,2호선,신림,36729,36061,72790,11
2021-11-14,2호선,사당,22342,25012,47354,11
2021-11-14,2호선,강남,35726,35775,71501,11
2021-11-14,2호선,선릉,13071,11351,24422,11
2021-11-14,1호선,서울역,30215,27671,57886,11
2021-11-14,2호선,잠실(송파구청),49688,46499,96187,11
2021-11-14,분당선,선릉,2705,4238,6943,11
2021-11-14,공항철도 1호선,홍대입구,9775,9087,18862,11
2021-11-14,공항철도 1호선,서울역,8301,7486,15787,11
2021-11-14,경의선,홍대입구,1587,1800,3387,11
2021-11-14,경의선,서울역,1236,988,2224,11
2021-11-14,경부선,가산디지털단지,5186,7103,12289,11
2021-11-14,경부선,서울역,8087,1768,9855,11
2021-11-15,2호선,강남,81191,80776,161967,11
2021-11-15,2호선,사당,35521,38934,74455,11
2021-11-15,2호선,신림,60992,59574,120566,11
2021-11-15,2호선,구로디지털단지,61023,61244,122267,11
2021-11-15,2호선,홍대입구,47250,49757,97007,11
2021-11-15,3호선,고속터미널,34148,32341,66489,11
2021-11-15,4호선,서울역,11124,16145,27269,11
2021-11-15,4호선,사당,24194,20591,44785,11
2021-11-15,7호선,고속터미널,16083,13236,29319,11
2021-11-15,7호선,가산디지털단지,48094,48108,96202,11
2021-11-15,8호선,잠실(송파구청),13259,15881,29140,11
2021-11-15,9호선,고속터미널,11646,14350,25996,11
2021-11-15,경부선,서울역,6519,1940,8459,11
2021-11-15,경부선,가산디지털단지,19170,22009,41179,11
2021-11-15,경의선,서울역,4473,5594,10067,11
2021-11-15,경의선,홍대입구,1505,1700,3205,11
2021-11-15,공항철도 1호선,서울역,7705,7158,14863,11
2021-11-15,공항철도 1호선,홍대입구,8565,8735,17300,11
2021-11-15,분당선,선릉,13651,20888,34539,11
2021-11-15,1호선,서울역,44615,42446,87061,11
2021-11-15,2호선,잠실(송파구청),65124,65830,130954,11
2021-11-15,2호선,선릉,57758,51829,109587,11
2021-11-16,분당선,선릉,14187,21434,35621,11
2021-11-16,2호선,신림,62610,60408,123018,11
2021-11-16,2호선,구로디지털단지,62163,62306,124469,11
2021-11-16,2호선,홍대입구,48391,51036,99427,11
2021-11-16,2호선,강남,84026,82383,166409,11
2021-11-16,3호선,고속터미널,38097,37064,75161,11
2021-11-16,2호선,사당,37666,41264,78930,11
2021-11-16,2호선,선릉,59358,53306,112664,11
2021-11-16,7호선,고속터미널,15398,13280,28678,11
2021-11-16,7호선,가산디지털단지,48589,48890,97479,11
2021-11-16,8호선,잠실(송파구청),13206,15765,28971,11
2021-11-16,9호선,고속터미널,11833,14765,26598,11
2021-11-16,경부선,서울역,5714,1716,7430,11
2021-11-16,경부선,가산디지털단지,19068,22258,41326,11
2021-11-16,경의선,서울역,4514,5677,10191,11
2021-11-16,경의선,홍대입구,1481,1772,3253,11
2021-11-16,공항철도 1호선,홍대입구,8628,8869,17497,11
2021-11-16,공항철도 1호선,서울역,7380,6870,14250,11
2021-11-16,1호선,서울역,44102,42216,86318,11
2021-11-16,2호선,잠실(송파구청),66778,66482,133260,11
2021-11-16,4호선,서울역,11260,16022,27282,11
2021-11-16,4호선,사당,25284,21498,46782,11
2021-11-17,3호선,고속터미널,38288,37080,75368,11
2021-11-17,2호선,잠실(송파구청),69018,69244,138262,11
2021-11-17,4호선,서울역,11502,16590,28092,11
2021-11-17,4호선,사당,26087,22672,48759,11
2021-11-17,7호선,고속터미널,15504,13590,29094,11
2021-11-17,7호선,가산디지털단지,48469,48530,96999,11
2021-11-17,8호선,잠실(송파구청),13729,16392,30121,11
2021-11-17,1호선,서울역,46947,43866,90813,11
2021-11-17,9호선,고속터미널,12180,14967,27147,11
2021-11-17,경부선,서울역,5627,1785,7412,11
2021-11-17,경부선,가산디지털단지,19231,22249,41480,11
2021-11-17,분당선,선릉,13896,21262,35158,11
2021-11-17,공항철도 1호선,홍대입구,9047,9216,18263,11
2021-11-17,공항철도 1호선,서울역,7870,7140,15010,11
2021-11-17,경의선,서울역,4397,5827,10224,11
2021-11-17,경의선,홍대입구,1539,1812,3351,11
2021-11-17,2호선,선릉,59043,52549,111592,11
2021-11-17,2호선,강남,83467,83214,166681,11
2021-11-17,2호선,사당,38954,43386,82340,11
2021-11-17,2호선,신림,63925,61274,125199,11
2021-11-17,2호선,구로디지털단지,62289,62632,124921,11
2021-11-17,2호선,홍대입구,50367,53467,103834,11
2021-11-18,분당선,선릉,13827,21042,34869,11
2021-11-18,공항철도 1호선,홍대입구,9282,9491,18773,11
2021-11-18,공항철도 1호선,서울역,7836,7389,15225,11
2021-11-18,경의선,홍대입구,1677,1947,3624,11
2021-11-18,경의선,서울역,4483,5745,10228,11
2021-11-18,경부선,가산디지털단지,18883,21793,40676,11
2021-11-18,경부선,서울역,6166,2048,8214,11
2021-11-18,9호선,고속터미널,12004,15375,27379,11
2021-11-18,8호선,잠실(송파구청),13506,16270,29776,11
2021-11-18,7호선,가산디지털단지,47447,47888,95335,11
2021-11-18,7호선,고속터미널,15501,13449,28950,11
2021-11-18,4호선,사당,25177,21591,46768,11
2021-11-18,4호선,서울역,11202,16814,28016,11
2021-11-18,3호선,고속터미널,38447,37916,76363,11
2021-11-18,2호선,홍대입구,51916,55509,107425,11
2021-11-18,2호선,구로디지털단지,61357,61129,122486,11
2021-11-18,2호선,신림,63205,60471,123676,11
2021-11-18,2호선,사당,37725,41437,79162,11
2021-11-18,2호선,강남,82363,83235,165598,11
2021-11-18,2호선,선릉,57505,51756,109261,11
2021-11-18,2호선,잠실(송파구청),70111,69733,139844,11
2021-11-18,1호선,서울역,44766,43447,88213,11
2021-11-19,1호선,서울역,51324,50066,101390,11
2021-11-19,2호선,잠실(송파구청),73943,73675,147618,11
2021-11-19,2호선,선릉,57874,51955,109829,11
2021-11-19,2호선,강남,89195,92803,181998,11
2021-11-19,2호선,사당,40374,45034,85408,11
2021-11-19,2호선,신림,65562,62451,128013,11
2021-11-19,2호선,구로디지털단지,62107,61665,123772,11
2021-11-19,2호선,홍대입구,58159,66934,125093,11
2021-11-19,3호선,고속터미널,46762,50464,97226,11
2021-11-19,4호선,서울역,11543,19936,31479,11
2021-11-19,4호선,사당,27087,23641,50728,11
2021-11-19,7호선,고속터미널,18655,15137,33792,11
2021-11-19,7호선,가산디지털단지,46130,45853,91983,11
2021-11-19,9호선,고속터미널,14141,19687,33828,11
2021-11-19,경부선,서울역,8747,2720,11467,11
2021-11-19,경부선,가산디지털단지,18552,21467,40019,11
2021-11-19,경의선,서울역,4607,5926,10533,11
2021-11-19,경의선,홍대입구,1910,2238,4148,11
2021-11-19,공항철도 1호선,서울역,10160,9816,19976,11
2021-11-19,공항철도 1호선,홍대입구,10745,11640,22385,11
2021-11-19,분당선,선릉,13690,21035,34725,11
2021-11-19,8호선,잠실(송파구청),14577,17749,32326,11
2021-11-20,경부선,가산디지털단지,6840,8893,15733,11
2021-11-20,경부선,서울역,9020,2209,11229,11
2021-11-20,9호선,고속터미널,13136,18984,32120,11
2021-11-20,8호선,잠실(송파구청),12143,14920,27063,11
2021-11-20,7호선,가산디지털단지,15424,13960,29384,11
2021-11-20,7호선,고속터미널,15821,12292,28113,11
2021-11-20,4호선,사당,22410,19849,42259,11
2021-11-20,4호선,서울역,5826,14983,20809,11
2021-11-20,3호선,고속터미널,49254,51368,100622,11
2021-11-20,2호선,홍대입구,64178,73567,137745,11
2021-11-20,2호선,구로디지털단지,34881,34172,69053,11
2021-11-20,2호선,신림,50344,47394,97738,11
2021-11-20,2호선,사당,31994,35854,67848,11
2021-11-20,2호선,강남,62393,65968,128361,11
2021-11-20,2호선,선릉,25307,22328,47635,11
2021-11-20,2호선,잠실(송파구청),64746,61778,126524,11
2021-11-20,1호선,서울역,37172,36108,73280,11
2021-11-20,경의선,서울역,1541,1649,3190,11
2021-11-20,경의선,홍대입구,2029,2666,4695,11
2021-11-20,공항철도 1호선,서울역,8625,8899,17524,11
2021-11-20,공항철도 1호선,홍대입구,12444,13061,25505,11
2021-11-20,분당선,선릉,5361,8482,13843,11
2021-11-21,경부선,가산디지털단지,4838,6778,11616,11
2021-11-21,경부선,서울역,8515,1836,10351,11
2021-11-21,9호선,고속터미널,10670,14419,25089,11
2021-11-21,8호선,잠실(송파구청),9595,10731,20326,11
2021-11-21,7호선,가산디지털단지,10885,10147,21032,11
2021-11-21,7호선,고속터미널,14364,8610,22974,11
2021-11-21,경의선,서울역,1158,1053,2211,11
2021-11-21,경의선,홍대입구,1577,2084,3661,11
2021-11-21,공항철도 1호선,서울역,8546,7590,16136,11
2021-11-21,공항철도 1호선,홍대입구,9973,8916,18889,11
2021-11-21,분당선,선릉,2937,4591,7528,11
2021-11-21,2호선,강남,36846,36126,72972,11
2021-11-21,2호선,선릉,14034,12184,26218,11
2021-11-21,2호선,잠실(송파구청),47623,45380,93003,11
2021-11-21,1호선,서울역,31807,29415,61222,11
2021-11-21,2호선,구로디지털단지,23944,23532,47476,11
2021-11-21,2호선,신림,36161,35602,71763,11
2021-11-21,2호선,사당,22026,24345,46371,11
2021-11-21,2호선,홍대입구,49496,48657,98153,11
2021-11-21,3호선,고속터미널,42108,39633,81741,11
2021-11-21,4호선,서울역,4337,12585,16922,11
2021-11-21,4호선,사당,15649,14489,30138,11
2021-11-22,1호선,서울역,44489,42041,86530,11
2021-11-22,2호선,잠실(송파구청),63912,64192,128104,11
2021-11-22,2호선,선릉,58444,52230,110674,11
2021-11-22,2호선,강남,82649,81796,164445,11
2021-11-22,2호선,사당,35350,38633,73983,11
2021-11-22,2호선,신림,61667,59760,121427,11
2021-11-22,2호선,구로디지털단지,61004,61418,122422,11
2021-11-22,2호선,홍대입구,48786,50475,99261,11
2021-11-22,3호선,고속터미널,39314,37153,76467,11
2021-11-22,4호선,서울역,11084,15940,27024,11
2021-11-22,4호선,사당,24075,20494,44569,11
2021-11-22,7호선,고속터미널,16237,13454,29691,11
2021-11-22,7호선,가산디지털단지,48018,47645,95663,11
2021-11-22,8호선,잠실(송파구청),13392,16098,29490,11
2021-11-22,9호선,고속터미널,11654,15109,26763,11
2021-11-22,경부선,서울역,6525,1978,8503,11
2021-11-22,경부선,가산디지털단지,18142,21475,39617,11
2021-11-22,경의선,서울역,4392,5518,9910,11
2021-11-22,경의선,홍대입구,1488,1789,3277,11
2021-11-22,공항철도 1호선,서울역,7820,7280,15100,11
2021-11-22,공항철도 1호선,홍대입구,8626,9113,17739,11
2021-11-22,분당선,선릉,14029,21289,35318,11
2021-11-23,2호선,홍대입구,48475,51100,99575,11
2021-11-23,2호선,구로디지털단지,62345,62292,124637,11
2021-11-23,2호선,신림,62429,60619,123048,11
2021-11-23,2호선,사당,36937,40173,77110,11
2021-11-23,2호선,강남,84958,84098,169056,11
2021-11-23,2호선,선릉,59765,53674,113439,11
2021-11-23,2호선,잠실(송파구청),66373,66173,132546,11
2021-11-23,1호선,서울역,44027,41590,85617,11
2021-11-23,공항철도 1호선,홍대입구,8655,8897,17552,11
2021-11-23,분당선,선릉,14440,21850,36290,11
2021-11-23,공항철도 1호선,서울역,7346,6924,14270,11
2021-11-23,경의선,홍대입구,1546,1827,3373,11
2021-11-23,경의선,서울역,4462,5569,10031,11
2021-11-23,경부선,가산디지털단지,18641,21708,40349,11
2021-11-23,경부선,서울역,5629,1815,7444,11
2021-11-23,9호선,고속터미널,11529,14567,26096,11
2021-11-23,8호선,잠실(송파구청),13706,16229,29935,11
2021-11-23,7호선,가산디지털단지,48533,48503,97036,11
2021-11-23,7호선,고속터미널,15243,13476,28719,11
2021-11-23,4호선,사당,25075,21377,46452,11
2021-11-23,4호선,서울역,11257,16287,27544,11
2021-11-23,3호선,고속터미널,38114,36822,74936,11
2021-11-24,경의선,홍대입구,1610,1925,3535,11
2021-11-24,경의선,서울역,4399,5646,10045,11
2021-11-24,8호선,잠실(송파구청),13699,16416,30115,11
2021-11-24,7호선,가산디지털단지,47970,48233,96203,11
2021-11-24,7호선,고속터미널,15264,13379,28643,11
2021-11-24,4호선,사당,25136,21386,46522,11
2021-11-24,4호선,서울역,11555,16451,28006,11
2021-11-24,3호선,고속터미널,37711,36818,74529,11
2021-11-24,2호선,홍대입구,49788,52634,102422,11
2021-11-24,2호선,구로디지털단지,62320,62325,124645,11
2021-11-24,2호선,신림,63355,61400,124755,11
2021-11-24,2호선,사당,37718,41328,79046,11
2021-11-24,2호선,강남,84831,84387,169218,11
2021-11-24,2호선,선릉,59490,53357,112847,11
2021-11-24,2호선,잠실(송파구청),67270,67316,134586,11
2021-11-24,1호선,서울역,44218,42001,86219,11
2021-11-24,분당선,선릉,14299,21649,35948,11
2021-11-24,9호선,고속터미널,11826,14686,26512,11
2021-11-24,경부선,서울역,5553,1923,7476,11
2021-11-24,경부선,가산디지털단지,18825,21969,40794,11
2021-11-24,공항철도 1호선,홍대입구,9016,9166,18182,11
2021-11-24,공항철도 1호선,서울역,7556,6819,14375,11
2021-11-25,공항철도 1호선,서울역,8003,7411,15414,11
2021-11-25,공항철도 1호선,홍대입구,9243,9641,18884,11
2021-11-25,분당선,선릉,14436,21899,36335,11
2021-11-25,경부선,가산디지털단지,18858,21862,40720,11
2021-11-25,경부선,서울역,6294,2016,8310,11
2021-11-25,9호선,고속터미널,12245,15296,27541,11
2021-11-25,8호선,잠실(송파구청),13754,16702,30456,11
2021-11-25,7호선,가산디지털단지,48223,48274,96497,11
2021-11-25,7호선,고속터미널,15479,13489,28968,11
2021-11-25,4호선,사당,25582,21961,47543,11
2021-11-25,4호선,서울역,11479,16957,28436,11
2021-11-25,3호선,고속터미널,39186,38584,77770,11
2021-11-25,2호선,홍대입구,51748,54973,106721,11
2021-11-25,2호선,구로디지털단지,62267,62493,124760,11
2021-11-25,2호선,신림,63710,61236,124946,11
2021-11-25,2호선,사당,38403,42383,80786,11
2021-11-25,2호선,강남,85434,85770,171204,11
2021-11-25,2호선,선릉,60008,53785,113793,11
2021-11-25,2호선,잠실(송파구청),69449,69372,138821,11
2021-11-25,1호선,서울역,45703,43637,89340,11
2021-11-25,경의선,서울역,4518,5677,10195,11
2021-11-25,경의선,홍대입구,1600,1970,3570,11
2021-11-26,2호선,잠실(송파구청),73193,72841,146034,11
2021-11-26,2호선,선릉,58150,52340,110490,11
2021-11-26,2호선,강남,90583,93604,184187,11
2021-11-26,2호선,사당,40345,45292,85637,11
2021-11-26,2호선,신림,66039,62631,128670,11
2021-11-26,2호선,구로디지털단지,62411,62024,124435,11
2021-11-26,2호선,홍대입구,56954,64613,121567,11
2021-11-26,3호선,고속터미널,46426,49772,96198,11
2021-11-26,4호선,서울역,11571,20503,32074,11
2021-11-26,4호선,사당,27226,24087,51313,11
2021-11-26,7호선,고속터미널,18102,14746,32848,11
2021-11-26,7호선,가산디지털단지,47026,46468,93494,11
2021-11-26,8호선,잠실(송파구청),14458,17798,32256,11
2021-11-26,9호선,고속터미널,13622,19013,32635,11
2021-11-26,경부선,서울역,8577,2675,11252,11
2021-11-26,경부선,가산디지털단지,18636,21449,40085,11
2021-11-26,경의선,서울역,4634,5990,10624,11
2021-11-26,경의선,홍대입구,1747,2208,3955,11
2021-11-26,공항철도 1호선,서울역,9982,9562,19544,11
2021-11-26,공항철도 1호선,홍대입구,10354,11361,21715,11
2021-11-26,분당선,선릉,13724,21337,35061,11
2021-11-26,1호선,서울역,51052,50260,101312,11
2021-11-27,공항철도 1호선,서울역,8569,8694,17263,11
2021-11-27,공항철도 1호선,홍대입구,12006,12319,24325,11
2021-11-27,분당선,선릉,5526,8594,14120,11
2021-11-27,8호선,잠실(송파구청),12514,14821,27335,11
2021-11-27,9호선,고속터미널,12971,19106,32077,11
2021-11-27,경부선,서울역,8683,2270,10953,11
2021-11-27,경부선,가산디지털단지,6607,8825,15432,11
2021-11-27,경의선,서울역,1552,1679,3231,11
2021-11-27,경의선,홍대입구,1967,2523,4490,11
2021-11-27,경의선,서울역,3,2,5,11
2021-11-27,4호선,사당,22020,19971,41991,11
2021-11-27,4호선,서울역,6004,15323,21327,11
2021-11-27,3호선,고속터미널,50246,51673,101919,11
2021-11-27,7호선,가산디지털단지,15662,14074,29736,11
2021-11-27,7호선,고속터미널,15053,11650,26703,11
2021-11-27,2호선,홍대입구,63451,71886,135337,11
2021-11-27,2호선,구로디지털단지,34434,33904,68338,11
2021-11-27,2호선,신림,50133,47392,97525,11
2021-11-27,2호선,사당,32089,36139,68228,11
2021-11-27,2호선,강남,62641,65972,128613,11
2021-11-27,2호선,선릉,25012,22366,47378,11
2021-11-27,2호선,잠실(송파구청),65625,63482,129107,11
2021-11-27,1호선,서울역,36779,37426,74205,11
2021-11-28,공항철도 1호선,서울역,8299,7556,15855,11
2021-11-28,분당선,선릉,3127,4574,7701,11
2021-11-28,공항철도 1호선,홍대입구,9575,8842,18417,11
2021-11-28,1호선,서울역,30756,28808,59564,11
2021-11-28,2호선,잠실(송파구청),49546,47343,96889,11
2021-11-28,2호선,선릉,13886,11879,25765,11
2021-11-28,2호선,강남,36019,35870,71889,11
2021-11-28,2호선,사당,21829,24966,46795,11
2021-11-28,2호선,신림,36960,36087,73047,11
2021-11-28,2호선,구로디지털단지,23582,23295,46877,11
2021-11-28,2호선,홍대입구,48702,48609,97311,11
2021-11-28,3호선,고속터미널,41287,39579,80866,11
2021-11-28,4호선,서울역,4366,11730,16096,11
2021-11-28,4호선,사당,15575,14429,30004,11
2021-11-28,7호선,고속터미널,13820,8488,22308,11
2021-11-28,7호선,가산디지털단지,11545,10678,22223,11
2021-11-28,8호선,잠실(송파구청),9887,11390,21277,11
2021-11-28,9호선,고속터미널,10445,14405,24850,11
2021-11-28,경부선,서울역,8975,1927,10902,11
2021-11-28,경부선,가산디지털단지,4926,6829,11755,11
2021-11-28,경의선,서울역,1213,1097,2310,11
2021-11-28,경의선,홍대입구,1562,1737,3299,11
2021-11-29,1호선,서울역,44369,41725,86094,11
2021-11-29,2호선,잠실(송파구청),67378,68382,135760,11
2021-11-29,2호선,선릉,58653,52348,111001,11
2021-11-29,2호선,강남,80865,80992,161857,11
2021-11-29,2호선,사당,35473,38934,74407,11
2021-11-29,2호선,신림,61632,59972,121604,11
2021-11-29,2호선,구로디지털단지,61085,61141,122226,11
2021-11-29,2호선,홍대입구,47364,49512,96876,11
2021-11-29,3호선,고속터미널,38935,36835,75770,11
2021-11-29,4호선,서울역,11063,15830,26893,11
2021-11-29,4호선,사당,23847,20362,44209,11
2021-11-29,7호선,고속터미널,15874,13108,28982,11
2021-11-29,7호선,가산디지털단지,47553,47858,95411,11
2021-11-29,8호선,잠실(송파구청),13364,16062,29426,11
2021-11-29,9호선,고속터미널,11897,14766,26663,11
2021-11-29,경부선,서울역,6453,1945,8398,11
2021-11-29,경부선,가산디지털단지,18852,21779,40631,11
2021-11-29,경의선,서울역,4508,5673,10181,11
2021-11-29,경의선,홍대입구,1467,1759,3226,11
2021-11-29,공항철도 1호선,서울역,7701,7091,14792,11
2021-11-29,공항철도 1호선,홍대입구,8596,8644,17240,11
2021-11-29,분당선,선릉,14169,21445,35614,11
2021-11-30,1호선,서울역,41764,39190,80954,11
2021-11-30,2호선,잠실(송파구청),63302,64057,127359,11
2021-11-30,2호선,선릉,57724,51861,109585,11
2021-11-30,2호선,강남,79857,80079,159936,11
2021-11-30,2호선,사당,35274,38462,73736,11
2021-11-30,2호선,신림,60245,58559,118804,11
2021-11-30,2호선,구로디지털단지,59266,60024,119290,11
2021-11-30,2호선,홍대입구,45209,47118,92327,11
2021-11-30,3호선,고속터미널,35827,34403,70230,11
2021-11-30,4호선,서울역,10974,15083,26057,11
2021-11-30,4호선,사당,23490,20019,43509,11
2021-11-30,7호선,고속터미널,14361,12454,26815,11
2021-11-30,7호선,가산디지털단지,47461,47615,95076,11
2021-11-30,8호선,잠실(송파구청),13236,15995,29231,11
2021-11-30,9호선,고속터미널,10758,13532,24290,11
2021-11-30,경부선,서울역,5475,1823,7298,11
2021-11-30,경부선,가산디지털단지,18304,21331,39635,11
2021-11-30,경의선,서울역,4123,5180,9303,11
2021-11-30,경의선,홍대입구,1348,1617,2965,11
2021-11-30,공항철도 1호선,서울역,7078,6527,13605,11
2021-11-30,공항철도 1호선,홍대입구,7882,8223,16105,11
2021-11-30,분당선,선릉,14025,21550,35575,11
2021-12-01,분당선,선릉,14350,21496,35846,12
2021-12-01,공항철도 1호선,홍대입구,8326,8764,17090,12
2021-12-01,공항철도 1호선,서울역,7045,6483,13528,12
2021-12-01,경의선,홍대입구,1452,1770,3222,12
2021-12-01,경의선,서울역,4254,5483,9737,12
2021-12-01,경부선,가산디지털단지,18564,21516,40080,12
2021-12-01,경부선,서울역,5249,1732,6981,12
2021-12-01,9호선,고속터미널,11503,14355,25858,12
2021-12-01,8호선,잠실(송파구청),13942,16606,30548,12
2021-12-01,7호선,가산디지털단지,48278,48141,96419,12
2021-12-01,7호선,고속터미널,14437,12875,27312,12
2021-12-01,4호선,사당,24764,20887,45651,12
2021-12-01,4호선,서울역,11163,16007,27170,12
2021-12-01,3호선,고속터미널,37630,35814,73444,12
2021-12-01,2호선,홍대입구,48820,51577,100397,12
2021-12-01,2호선,구로디지털단지,61490,61375,122865,12
2021-12-01,2호선,신림,62969,60818,123787,12
2021-12-01,2호선,사당,36148,39582,75730,12
2021-12-01,2호선,강남,82909,82231,165140,12
2021-12-01,2호선,선릉,58807,52652,111459,12
2021-12-01,2호선,잠실(송파구청),66957,66848,133805,12
2021-12-01,1호선,서울역,42122,40739,82861,12
2021-12-02,분당선,선릉,14336,21473,35809,12
2021-12-02,공항철도 1호선,홍대입구,8538,8794,17332,12
2021-12-02,공항철도 1호선,서울역,7177,6776,13953,12
2021-12-02,1호선,서울역,42962,40963,83925,12
2021-12-02,경의선,홍대입구,1511,1841,3352,12
2021-12-02,경의선,서울역,4434,5533,9967,12
2021-12-02,경부선,가산디지털단지,18583,21664,40247,12
2021-12-02,경부선,서울역,5550,1848,7398,12
2021-12-02,9호선,고속터미널,11414,14301,25715,12
2021-12-02,8호선,잠실(송파구청),13688,16244,29932,12
2021-12-02,7호선,가산디지털단지,47624,47670,95294,12
2021-12-02,7호선,고속터미널,14714,12760,27474,12
2021-12-02,4호선,사당,24598,20975,45573,12
2021-12-02,4호선,서울역,11158,16009,27167,12
2021-12-02,3호선,고속터미널,37648,35078,72726,12
2021-12-02,2호선,홍대입구,47933,50681,98614,12
2021-12-02,2호선,구로디지털단지,61046,61304,122350,12
2021-12-02,2호선,신림,62641,60331,122972,12
2021-12-02,2호선,사당,36677,39828,76505,12
2021-12-02,2호선,강남,81786,81332,163118,12
2021-12-02,2호선,선릉,58153,52380,110533,12
2021-12-02,2호선,잠실(송파구청),65691,65969,131660,12
2021-12-03,1호선,서울역,48018,47289,95307,12
2021-12-03,2호선,잠실(송파구청),70018,69692,139710,12
2021-12-03,2호선,선릉,57702,51466,109168,12
2021-12-03,2호선,강남,86804,90089,176893,12
2021-12-03,2호선,사당,38964,43624,82588,12
2021-12-03,2호선,신림,64535,61565,126100,12
2021-12-03,2호선,구로디지털단지,61798,61382,123180,12
2021-12-03,2호선,홍대입구,53534,60330,113864,12
2021-12-03,3호선,고속터미널,44064,47021,91085,12
2021-12-03,4호선,서울역,11180,18781,29961,12
2021-12-03,4호선,사당,26298,23050,49348,12
2021-12-03,7호선,고속터미널,17065,14187,31252,12
2021-12-03,7호선,가산디지털단지,47231,46592,93823,12
2021-12-03,8호선,잠실(송파구청),14430,17604,32034,12
2021-12-03,9호선,고속터미널,12866,17492,30358,12
2021-12-03,경부선,서울역,7997,2588,10585,12
2021-12-03,경부선,가산디지털단지,18338,21139,39477,12
2021-12-03,경의선,서울역,4367,5853,10220,12
2021-12-03,경의선,홍대입구,1701,2190,3891,12
2021-12-03,공항철도 1호선,서울역,8954,8817,17771,12
2021-12-03,공항철도 1호선,홍대입구,9657,10518,20175,12
2021-12-03,분당선,선릉,13872,21314,35186,12
2021-12-04,1호선,서울역,31225,32456,63681,12
2021-12-04,2호선,잠실(송파구청),59837,57205,117042,12
2021-12-04,2호선,선릉,24113,21141,45254,12
2021-12-04,2호선,강남,58404,60898,119302,12
2021-12-04,2호선,사당,30324,33482,63806,12
2021-12-04,2호선,신림,48772,46136,94908,12
2021-12-04,2호선,구로디지털단지,33488,32550,66038,12
2021-12-04,2호선,홍대입구,56846,63681,120527,12
2021-12-04,3호선,고속터미널,45930,46474,92404,12
2021-12-04,4호선,서울역,5209,13037,18246,12
2021-12-04,4호선,사당,20296,18211,38507,12
2021-12-04,7호선,고속터미널,13522,10773,24295,12
2021-12-04,7호선,가산디지털단지,14861,13409,28270,12
2021-12-04,8호선,잠실(송파구청),11992,14442,26434,12
2021-12-04,9호선,고속터미널,11578,16928,28506,12
2021-12-04,경부선,서울역,6703,1931,8634,12
2021-12-04,경부선,가산디지털단지,6270,8270,14540,12
2021-12-04,경의선,서울역,1229,1459,2688,12
2021-12-04,경의선,홍대입구,1659,2150,3809,12
2021-12-04,공항철도 1호선,서울역,7393,7614,15007,12
2021-12-04,공항철도 1호선,홍대입구,10624,11214,21838,12
2021-12-04,분당선,선릉,5251,8172,13423,12
2021-12-05,2호선,홍대입구,42958,42457,85415,12
2021-12-05,2호선,잠실(송파구청),43381,40487,83868,12
2021-12-05,2호선,선릉,12601,10905,23506,12
2021-12-05,2호선,강남,32171,31549,63720,12
2021-12-05,2호선,사당,20059,22629,42688,12
2021-12-05,2호선,신림,34547,34211,68758,12
2021-12-05,2호선,구로디지털단지,22857,22499,45356,12
2021-12-05,3호선,고속터미널,36794,35346,72140,12
2021-12-05,4호선,서울역,4088,9483,13571,12
2021-12-05,4호선,사당,14223,13321,27544,12
2021-12-05,7호선,고속터미널,11749,7641,19390,12
2021-12-05,7호선,가산디지털단지,10543,9756,20299,12
2021-12-05,8호선,잠실(송파구청),9249,10432,19681,12
2021-12-05,9호선,고속터미널,9077,12475,21552,12
2021-12-05,경부선,서울역,7671,1567,9238,12
2021-12-05,경부선,가산디지털단지,4541,6276,10817,12
2021-12-05,경의선,서울역,1075,956,2031,12
2021-12-05,경의선,홍대입구,1486,1806,3292,12
2021-12-05,공항철도 1호선,서울역,7410,6412,13822,12
2021-12-05,공항철도 1호선,홍대입구,8774,7902,16676,12
2021-12-05,분당선,선릉,2826,4260,7086,12
2021-12-05,1호선,서울역,27413,24385,51798,12
2021-12-06,분당선,선릉,13760,20923,34683,12
2021-12-06,공항철도 1호선,홍대입구,8132,8114,16246,12
2021-12-06,공항철도 1호선,서울역,7158,6751,13909,12
2021-12-06,경의선,홍대입구,1408,1735,3143,12
2021-12-06,경의선,서울역,4429,5452,9881,12
2021-12-06,경부선,가산디지털단지,18658,21591,40249,12
2021-12-06,경부선,서울역,5932,1816,7748,12
2021-12-06,9호선,고속터미널,11226,14063,25289,12
2021-12-06,8호선,잠실(송파구청),13069,15630,28699,12
2021-12-06,7호선,가산디지털단지,47348,47588,94936,12
2021-12-06,7호선,고속터미널,15136,12856,27992,12
2021-12-06,4호선,사당,22971,19814,42785,12
2021-12-06,4호선,서울역,10677,14723,25400,12
2021-12-06,3호선,고속터미널,36227,34423,70650,12
2021-12-06,2호선,홍대입구,45174,46894,92068,12
2021-12-06,2호선,구로디지털단지,59982,60466,120448,12
2021-12-06,2호선,신림,60675,58814,119489,12
2021-12-06,2호선,사당,34064,37716,71780,12
2021-12-06,2호선,강남,78293,77940,156233,12
2021-12-06,2호선,선릉,56565,50778,107343,12
2021-12-06,2호선,잠실(송파구청),62087,62457,124544,12
2021-12-06,1호선,서울역,41699,39707,81406,12
2021-12-07,1호선,서울역,40546,38681,79227,12
2021-12-07,2호선,잠실(송파구청),64932,65178,130110,12
2021-12-07,2호선,선릉,58182,52113,110295,12
2021-12-07,2호선,강남,79747,79154,158901,12
2021-12-07,2호선,사당,35979,39173,75152,12
2021-12-07,2호선,신림,61579,59549,121128,12
2021-12-07,2호선,구로디지털단지,60708,61331,122039,12
2021-12-07,2호선,홍대입구,45950,48061,94011,12
2021-12-07,3호선,고속터미널,35045,33957,69002,12
2021-12-07,4호선,서울역,10791,14906,25697,12
2021-12-07,4호선,사당,23885,20046,43931,12
2021-12-07,7호선,고속터미널,14717,13031,27748,12
2021-12-07,7호선,가산디지털단지,47925,48152,96077,12
2021-12-07,8호선,잠실(송파구청),13269,15794,29063,12
2021-12-07,9호선,고속터미널,11263,13800,25063,12
2021-12-07,경부선,서울역,4986,1651,6637,12
2021-12-07,경부선,가산디지털단지,18649,21719,40368,12
2021-12-07,경의선,서울역,4274,5337,9611,12
2021-12-07,경의선,홍대입구,1477,1751,3228,12
2021-12-07,공항철도 1호선,서울역,6686,6371,13057,12
2021-12-07,공항철도 1호선,홍대입구,8351,8562,16913,12
2021-12-07,분당선,선릉,14122,21378,35500,12
2021-12-08,2호선,홍대입구,47889,50668,98557,12
2021-12-08,2호선,구로디지털단지,60565,60850,121415,12
2021-12-08,2호선,신림,61681,59653,121334,12
2021-12-08,2호선,사당,35637,39430,75067,12
2021-12-08,2호선,강남,79046,78696,157742,12
2021-12-08,2호선,선릉,57143,51077,108220,12
2021-12-08,2호선,잠실(송파구청),66129,66091,132220,12
2021-12-08,1호선,서울역,41184,39072,80256,12
2021-12-08,분당선,선릉,13643,20929,34572,12
2021-12-08,공항철도 1호선,홍대입구,8494,8572,17066,12
2021-12-08,공항철도 1호선,서울역,6913,6345,13258,12
2021-12-08,경의선,홍대입구,1653,1861,3514,12
2021-12-08,경의선,서울역,4187,5349,9536,12
2021-12-08,경부선,가산디지털단지,18659,21422,40081,12
2021-12-08,경부선,서울역,5072,1667,6739,12
2021-12-08,9호선,고속터미널,11236,14122,25358,12
2021-12-08,8호선,잠실(송파구청),13249,16026,29275,12
2021-12-08,7호선,가산디지털단지,47278,47360,94638,12
2021-12-08,7호선,고속터미널,14308,12733,27041,12
2021-12-08,4호선,사당,23938,20068,44006,12
2021-12-08,4호선,서울역,10659,15182,25841,12
2021-12-08,3호선,고속터미널,34890,33431,68321,12
2021-12-09,1호선,서울역,41261,39338,80599,12
2021-12-09,2호선,잠실(송파구청),64625,64680,129305,12
2021-12-09,2호선,선릉,56839,51424,108263,12
2021-12-09,2호선,강남,78207,78310,156517,12
2021-12-09,2호선,사당,35603,39152,74755,12
2021-12-09,2호선,신림,62194,59553,121747,12
2021-12-09,2호선,구로디지털단지,59870,59754,119624,12
2021-12-09,2호선,홍대입구,48595,51293,99888,12
2021-12-09,3호선,고속터미널,35534,34542,70076,12
2021-12-09,4호선,서울역,10556,15096,25652,12
2021-12-09,4호선,사당,23967,20284,44251,12
2021-12-09,7호선,고속터미널,14309,12558,26867,12
2021-12-09,7호선,가산디지털단지,46354,46397,92751,12
2021-12-09,8호선,잠실(송파구청),12977,16009,28986,12
2021-12-09,9호선,고속터미널,11250,13843,25093,12
2021-12-09,경부선,서울역,5186,1773,6959,12
2021-12-09,경부선,가산디지털단지,18458,21166,39624,12
2021-12-09,경의선,서울역,4213,5366,9579,12
2021-12-09,경의선,홍대입구,1697,1847,3544,12
2021-12-09,공항철도 1호선,서울역,7378,6701,14079,12
2021-12-09,공항철도 1호선,홍대입구,8713,9039,17752,12
2021-12-09,분당선,선릉,13838,20900,34738,12
2021-12-10,9호선,고속터미널,12204,16345,28549,12
2021-12-10,8호선,잠실(송파구청),13558,16817,30375,12
2021-12-10,7호선,가산디지털단지,45360,45116,90476,12
2021-12-10,7호선,고속터미널,16041,13811,29852,12
2021-12-10,4호선,사당,25545,21977,47522,12
2021-12-10,4호선,서울역,10609,17640,28249,12
2021-12-10,3호선,고속터미널,40938,43841,84779,12
2021-12-10,2호선,홍대입구,51414,58398,109812,12
2021-12-10,2호선,구로디지털단지,60260,59731,119991,12
2021-12-10,2호선,신림,63457,60506,123963,12
2021-12-10,2호선,사당,36823,41523,78346,12
2021-12-10,2호선,강남,82338,84517,166855,12
2021-12-10,2호선,선릉,55133,49791,104924,12
2021-12-10,2호선,잠실(송파구청),66496,66189,132685,12
2021-12-10,1호선,서울역,45002,44956,89958,12
2021-12-10,경부선,서울역,7303,2638,9941,12
2021-12-10,경부선,가산디지털단지,18206,20606,38812,12
2021-12-10,경의선,서울역,4290,5525,9815,12
2021-12-10,경의선,홍대입구,1767,2027,3794,12
2021-12-10,공항철도 1호선,서울역,8299,8380,16679,12
2021-12-10,공항철도 1호선,홍대입구,9322,9891,19213,12
2021-12-10,분당선,선릉,13363,20507,33870,12
2021-12-11,2호선,홍대입구,54580,60635,115215,12
2021-12-11,2호선,구로디지털단지,32565,31871,64436,12
2021-12-11,2호선,신림,47801,45203,93004,12
2021-12-11,2호선,사당,28535,31885,60420,12
2021-12-11,2호선,강남,55516,57470,112986,12
2021-12-11,2호선,선릉,23201,20399,43600,12
2021-12-11,2호선,잠실(송파구청),57926,55816,113742,12
2021-12-11,1호선,서울역,28810,29777,58587,12
2021-12-11,9호선,고속터미널,11255,15600,26855,12
2021-12-11,경부선,서울역,6173,1820,7993,12
2021-12-11,경부선,가산디지털단지,6222,8214,14436,12
2021-12-11,경의선,서울역,1181,1334,2515,12
2021-12-11,경의선,홍대입구,1683,2042,3725,12
2021-12-11,공항철도 1호선,서울역,6853,7147,14000,12
2021-12-11,공항철도 1호선,홍대입구,9890,10375,20265,12
2021-12-11,분당선,선릉,4976,7858,12834,12
2021-12-11,8호선,잠실(송파구청),11346,13539,24885,12
2021-12-11,7호선,가산디지털단지,14502,13059,27561,12
2021-12-11,7호선,고속터미널,12744,10110,22854,12
2021-12-11,4호선,사당,19917,17121,37038,12
2021-12-11,4호선,서울역,5077,12307,17384,12
2021-12-11,3호선,고속터미널,42249,43363,85612,12
2021-12-12,1호선,서울역,26202,22072,48274,12
2021-12-12,2호선,잠실(송파구청),44408,41283,85691,12
2021-12-12,2호선,선릉,12816,11118,23934,12
2021-12-12,2호선,강남,32164,31683,63847,12
2021-12-12,2호선,사당,19485,21705,41190,12
2021-12-12,2호선,신림,34503,34420,68923,12
2021-12-12,2호선,구로디지털단지,21822,21762,43584,12
2021-12-12,2호선,홍대입구,41697,41043,82740,12
2021-12-12,3호선,고속터미널,35647,33664,69311,12
2021-12-12,4호선,서울역,3757,9233,12990,12
2021-12-12,4호선,사당,13609,12726,26335,12
2021-12-12,7호선,고속터미널,11004,7159,18163,12
2021-12-12,7호선,가산디지털단지,10122,9331,19453,12
2021-12-12,8호선,잠실(송파구청),9195,10410,19605,12
2021-12-12,9호선,고속터미널,8717,11453,20170,12
2021-12-12,경부선,서울역,7124,1580,8704,12
2021-12-12,경부선,가산디지털단지,4179,5953,10132,12
2021-12-12,경의선,서울역,1055,952,2007,12
2021-12-12,경의선,홍대입구,1291,1489,2780,12
2021-12-12,공항철도 1호선,서울역,7343,5982,13325,12
2021-12-12,공항철도 1호선,홍대입구,8240,7808,16048,12
2021-12-12,분당선,선릉,2807,4158,6965,12
2021-12-13,분당선,선릉,13313,20219,33532,12
2021-12-13,공항철도 1호선,홍대입구,7860,8134,15994,12
2021-12-13,공항철도 1호선,서울역,7122,6410,13532,12
2021-12-13,경의선,홍대입구,1492,1647,3139,12
2021-12-13,경의선,서울역,4066,5038,9104,12
2021-12-13,경부선,가산디지털단지,17707,20775,38482,12
2021-12-13,경부선,서울역,5695,1837,7532,12
2021-12-13,9호선,고속터미널,10820,13506,24326,12
2021-12-13,8호선,잠실(송파구청),12820,15262,28082,12
2021-12-13,7호선,가산디지털단지,46371,45975,92346,12
2021-12-13,7호선,고속터미널,14765,12304,27069,12
2021-12-13,4호선,사당,22314,18734,41048,12
2021-12-13,4호선,서울역,9967,14363,24330,12
2021-12-13,3호선,고속터미널,34879,33352,68231,12
2021-12-13,2호선,홍대입구,45234,46929,92163,12
2021-12-13,2호선,구로디지털단지,58256,58916,117172,12
2021-12-13,2호선,신림,58787,56771,115558,12
2021-12-13,2호선,사당,32619,35860,68479,12
2021-12-13,2호선,강남,75815,75233,151048,12
2021-12-13,2호선,선릉,55017,49015,104032,12
2021-12-13,2호선,잠실(송파구청),60824,61067,121891,12
2021-12-13,1호선,서울역,39836,37215,77051,12
2021-12-14,공항철도 1호선,서울역,6721,6130,12851,12
2021-12-14,공항철도 1호선,홍대입구,8236,8374,16610,12
2021-12-14,분당선,선릉,13592,20658,34250,12
2021-12-14,경의선,홍대입구,1507,1762,3269,12
2021-12-14,1호선,서울역,40101,38003,78104,12
2021-12-14,경의선,서울역,4137,5287,9424,12
2021-12-14,경부선,가산디지털단지,18127,20951,39078,12
2021-12-14,경부선,서울역,5119,1727,6846,12
2021-12-14,9호선,고속터미널,10849,13148,23997,12
2021-12-14,8호선,잠실(송파구청),13375,15623,28998,12
2021-12-14,7호선,가산디지털단지,46757,46317,93074,12
2021-12-14,7호선,고속터미널,14224,12346,26570,12
2021-12-14,4호선,사당,23700,19835,43535,12
2021-12-14,4호선,서울역,10643,14504,25147,12
2021-12-14,3호선,고속터미널,34390,33094,67484,12
2021-12-14,2호선,홍대입구,47142,49205,96347,12
2021-12-14,2호선,구로디지털단지,59535,59789,119324,12
2021-12-14,2호선,신림,60055,58487,118542,12
2021-12-14,2호선,사당,34330,37684,72014,12
2021-12-14,2호선,강남,78104,77810,155914,12
2021-12-14,2호선,선릉,56242,50363,106605,12
2021-12-14,2호선,잠실(송파구청),63628,63168,126796,12
2021-12-15,2호선,잠실(송파구청),67113,67431,134544,12
2021-12-15,2호선,선릉,55571,49822,105393,12
2021-12-15,2호선,강남,79022,78962,157984,12
2021-12-15,2호선,사당,34995,38410,73405,12
2021-12-15,2호선,신림,61971,59660,121631,12
2021-12-15,2호선,구로디지털단지,59600,59955,119555,12
2021-12-15,2호선,홍대입구,49565,52210,101775,12
2021-12-15,3호선,고속터미널,34655,33575,68230,12
2021-12-15,4호선,서울역,10445,14796,25241,12
2021-12-15,4호선,사당,23592,19968,43560,12
2021-12-15,7호선,고속터미널,14338,12384,26722,12
2021-12-15,7호선,가산디지털단지,45946,46401,92347,12
2021-12-15,8호선,잠실(송파구청),14016,17130,31146,12
2021-12-15,9호선,고속터미널,11350,13928,25278,12
2021-12-15,경부선,서울역,4953,1714,6667,12
2021-12-15,경부선,가산디지털단지,18346,21262,39608,12
2021-12-15,경의선,서울역,4153,5203,9356,12
2021-12-15,경의선,홍대입구,1652,1974,3626,12
2021-12-15,공항철도 1호선,서울역,6960,6252,13212,12
2021-12-15,공항철도 1호선,홍대입구,8804,8928,17732,12
2021-12-15,분당선,선릉,13403,20317,33720,12
2021-12-15,1호선,서울역,39927,37858,77785,12
2021-12-16,분당선,선릉,13428,20541,33969,12
2021-12-16,2호선,잠실(송파구청),67970,67860,135830,12
2021-12-16,2호선,선릉,55475,49970,105445,12
2021-12-16,2호선,강남,80021,80494,160515,12
2021-12-16,2호선,사당,35442,38944,74386,12
2021-12-16,2호선,신림,61742,59419,121161,12
2021-12-16,2호선,구로디지털단지,59922,60046,119968,12
2021-12-16,2호선,홍대입구,50662,54024,104686,12
2021-12-16,3호선,고속터미널,35627,34846,70473,12
2021-12-16,공항철도 1호선,홍대입구,8963,9317,18280,12
2021-12-16,공항철도 1호선,서울역,7213,6652,13865,12
2021-12-16,경의선,홍대입구,1615,2043,3658,12
2021-12-16,경의선,서울역,4146,5348,9494,12
2021-12-16,경부선,가산디지털단지,18259,20914,39173,12
2021-12-16,경부선,서울역,5509,1788,7297,12
2021-12-16,9호선,고속터미널,11332,13852,25184,12
2021-12-16,8호선,잠실(송파구청),14277,17370,31647,12
2021-12-16,7호선,가산디지털단지,45403,45713,91116,12
2021-12-16,7호선,고속터미널,14373,12370,26743,12
2021-12-16,4호선,사당,23993,20373,44366,12
2021-12-16,4호선,서울역,10282,15258,25540,12
2021-12-16,1호선,서울역,41469,39908,81377,12
2021-12-17,분당선,선릉,13122,19833,32955,12
2021-12-17,공항철도 1호선,홍대입구,9838,10835,20673,12
2021-12-17,공항철도 1호선,서울역,8784,8536,17320,12
2021-12-17,경의선,홍대입구,1580,2106,3686,12
2021-12-17,경의선,서울역,3979,5281,9260,12
2021-12-17,경부선,가산디지털단지,16824,20132,36956,12
2021-12-17,경부선,서울역,7441,2581,10022,12
2021-12-17,9호선,고속터미널,12639,16804,29443,12
2021-12-17,8호선,잠실(송파구청),15279,18374,33653,12
2021-12-17,7호선,가산디지털단지,45066,43851,88917,12
2021-12-17,7호선,고속터미널,16843,13703,30546,12
2021-12-17,4호선,사당,25829,21729,47558,12
2021-12-17,4호선,서울역,10495,17670,28165,12
2021-12-17,3호선,고속터미널,43210,45043,88253,12
2021-12-17,2호선,홍대입구,56318,62093,118411,12
2021-12-17,2호선,구로디지털단지,59333,58877,118210,12
2021-12-17,2호선,신림,63615,61185,124800,12
2021-12-17,2호선,사당,36607,40500,77107,12
2021-12-17,2호선,강남,84979,86793,171772,12
2021-12-17,2호선,선릉,54615,49230,103845,12
2021-12-17,2호선,잠실(송파구청),70720,70810,141530,12
2021-12-17,1호선,서울역,45469,44594,90063,12
2021-12-18,1호선,서울역,29950,29731,59681,12
2021-12-18,2호선,잠실(송파구청),61401,57946,119347,12
2021-12-18,2호선,선릉,23041,19627,42668,12
2021-12-18,2호선,강남,58475,54861,113336,12
2021-12-18,2호선,사당,26566,29142,55708,12
2021-12-18,2호선,신림,46263,45162,91425,12
2021-12-18,2호선,구로디지털단지,31531,31507,63038,12
2021-12-18,2호선,홍대입구,57138,57477,114615,12
2021-12-18,3호선,고속터미널,44020,43855,87875,12
2021-12-18,4호선,서울역,5055,12745,17800,12
2021-12-18,4호선,사당,18570,16143,34713,12
2021-12-18,분당선,선릉,5196,7893,13089,12
2021-12-18,공항철도 1호선,홍대입구,10698,10595,21293,12
2021-12-18,공항철도 1호선,서울역,7376,7327,14703,12
2021-12-18,경의선,홍대입구,1625,2013,3638,12
2021-12-18,경의선,서울역,1233,1276,2509,12
2021-12-18,경부선,가산디지털단지,5738,7661,13399,12
2021-12-18,경부선,서울역,6309,1972,8281,12
2021-12-18,9호선,고속터미널,11373,15732,27105,12
2021-12-18,8호선,잠실(송파구청),14260,15852,30112,12
2021-12-18,7호선,가산디지털단지,14292,12470,26762,12
2021-12-18,7호선,고속터미널,12594,9793,22387,12
2021-12-19,1호선,서울역,26690,23988,50678,12
2021-12-19,2호선,잠실(송파구청),48123,45270,93393,12
2021-12-19,2호선,선릉,13206,11524,24730,12
2021-12-19,2호선,강남,33169,32132,65301,12
2021-12-19,2호선,사당,19490,21753,41243,12
2021-12-19,2호선,신림,35290,34804,70094,12
2021-12-19,2호선,구로디지털단지,22462,22648,45110,12
2021-12-19,2호선,홍대입구,44317,43782,88099,12
2021-12-19,3호선,고속터미널,35916,34251,70167,12
2021-12-19,4호선,서울역,3994,9668,13662,12
2021-12-19,4호선,사당,13864,12959,26823,12
2021-12-19,7호선,고속터미널,10522,7234,17756,12
2021-12-19,7호선,가산디지털단지,9874,9387,19261,12
2021-12-19,8호선,잠실(송파구청),11159,12707,23866,12
2021-12-19,9호선,고속터미널,8945,12128,21073,12
2021-12-19,경부선,서울역,7250,1749,8999,12
2021-12-19,경부선,가산디지털단지,4423,6109,10532,12
2021-12-19,경의선,서울역,1014,969,1983,12
2021-12-19,경의선,홍대입구,1463,1704,3167,12
2021-12-19,공항철도 1호선,서울역,7398,6174,13572,12
2021-12-19,공항철도 1호선,홍대입구,9018,8206,17224,12
2021-12-19,분당선,선릉,2824,4361,7185,12
2021-12-20,1호선,서울역,40739,38818,79557,12
2021-12-20,2호선,잠실(송파구청),65777,65065,130842,12
2021-12-20,2호선,선릉,55246,49124,104370,12
2021-12-20,2호선,강남,78545,76894,155439,12
2021-12-20,2호선,사당,33314,36257,69571,12
2021-12-20,2호선,신림,59661,58324,117985,12
2021-12-20,2호선,구로디지털단지,58557,58797,117354,12
2021-12-20,2호선,홍대입구,49021,50090,99111,12
2021-12-20,3호선,고속터미널,36599,34347,70946,12
2021-12-20,4호선,서울역,10355,14711,25066,12
2021-12-20,4호선,사당,22561,18633,41194,12
2021-12-20,7호선,고속터미널,15144,12389,27533,12
2021-12-20,7호선,가산디지털단지,46247,45971,92218,12
2021-12-20,8호선,잠실(송파구청),13476,15846,29322,12
2021-12-20,9호선,고속터미널,11319,14318,25637,12
2021-12-20,경부선,서울역,5844,1894,7738,12
2021-12-20,경부선,가산디지털단지,17936,20789,38725,12
2021-12-20,경의선,서울역,4120,5095,9215,12
2021-12-20,경의선,홍대입구,1599,1806,3405,12
2021-12-20,공항철도 1호선,서울역,7495,6719,14214,12
2021-12-20,공항철도 1호선,홍대입구,9021,8936,17957,12
2021-12-20,분당선,선릉,13271,20076,33347,12
2021-12-21,분당선,선릉,13758,20370,34128,12
2021-12-21,1호선,서울역,40891,38987,79878,12
2021-12-21,2호선,잠실(송파구청),68680,68816,137496,12
2021-12-21,2호선,선릉,57333,50888,108221,12
2021-12-21,2호선,강남,82030,80306,162336,12
2021-12-21,2호선,사당,34843,38037,72880,12
2021-12-21,2호선,신림,60870,59739,120609,12
2021-12-21,2호선,구로디지털단지,59636,59776,119412,12
2021-12-21,2호선,홍대입구,52505,53638,106143,12
2021-12-21,3호선,고속터미널,38136,36319,74455,12
2021-12-21,4호선,서울역,10554,14841,25395,12
2021-12-21,4호선,사당,23823,19586,43409,12
2021-12-21,7호선,고속터미널,14765,12706,27471,12
2021-12-21,7호선,가산디지털단지,46972,46793,93765,12
2021-12-21,8호선,잠실(송파구청),14186,16532,30718,12
2021-12-21,9호선,고속터미널,11670,14646,26316,12
2021-12-21,경부선,서울역,5387,1754,7141,12
2021-12-21,경부선,가산디지털단지,18180,20947,39127,12
2021-12-21,경의선,서울역,4170,5259,9429,12
2021-12-21,경의선,홍대입구,1726,1885,3611,12
2021-12-21,공항철도 1호선,서울역,7203,6339,13542,12
2021-12-21,공항철도 1호선,홍대입구,9455,9459,18914,12
2021-12-22,1호선,서울역,42060,39925,81985,12
2021-12-22,2호선,잠실(송파구청),70872,70953,141825,12
2021-12-22,2호선,선릉,57183,50583,107766,12
2021-12-22,2호선,강남,83330,81439,164769,12
2021-12-22,2호선,사당,35572,38539,74111,12
2021-12-22,2호선,신림,62375,61077,123452,12
2021-12-22,2호선,구로디지털단지,59972,60213,120185,12
2021-12-22,2호선,홍대입구,54900,56569,111469,12
2021-12-22,3호선,고속터미널,39288,37505,76793,12
2021-12-22,4호선,서울역,10934,15733,26667,12
2021-12-22,4호선,사당,24316,20240,44556,12
2021-12-22,7호선,고속터미널,15009,12900,27909,12
2021-12-22,7호선,가산디지털단지,46676,46345,93021,12
2021-12-22,8호선,잠실(송파구청),14588,17040,31628,12
2021-12-22,9호선,고속터미널,12101,15238,27339,12
2021-12-22,경부선,서울역,5372,1920,7292,12
2021-12-22,경부선,가산디지털단지,18149,20897,39046,12
2021-12-22,경의선,서울역,4224,5391,9615,12
2021-12-22,경의선,홍대입구,1766,2137,3903,12
2021-12-22,공항철도 1호선,서울역,7542,6606,14148,12
2021-12-22,공항철도 1호선,홍대입구,10015,10277,20292,12
2021-12-22,분당선,선릉,13632,20414,34046,12
2021-12-23,분당선,선릉,13895,20669,34564,12
2021-12-23,공항철도 1호선,홍대입구,10467,10457,20924,12
2021-12-23,공항철도 1호선,서울역,7739,6995,14734,12
2021-12-23,경의선,홍대입구,1792,2089,3881,12
2021-12-23,경의선,서울역,4272,5342,9614,12
2021-12-23,경부선,가산디지털단지,18083,20711,38794,12
2021-12-23,경부선,서울역,5736,1978,7714,12
2021-12-23,9호선,고속터미널,12320,16100,28420,12
2021-12-23,8호선,잠실(송파구청),15082,17532,32614,12
2021-12-23,7호선,가산디지털단지,46077,46145,92222,12
2021-12-23,7호선,고속터미널,15375,13404,28779,12
2021-12-23,4호선,사당,24786,20244,45030,12
2021-12-23,4호선,서울역,10835,16501,27336,12
2021-12-23,3호선,고속터미널,42040,41215,83255,12
2021-12-23,2호선,홍대입구,56666,58667,115333,12
2021-12-23,2호선,구로디지털단지,60201,60191,120392,12
2021-12-23,2호선,신림,62711,60506,123217,12
2021-12-23,2호선,사당,36074,39548,75622,12
2021-12-23,2호선,강남,84423,83257,167680,12
2021-12-23,2호선,선릉,57433,50853,108286,12
2021-12-23,2호선,잠실(송파구청),72168,72132,144300,12
2021-12-23,1호선,서울역,42979,41439,84418,12
2021-12-24,2호선,홍대입구,63438,66279,129717,12
2021-12-24,2호선,구로디지털단지,58047,57745,115792,12
2021-12-24,2호선,신림,63853,62655,126508,12
2021-12-24,2호선,사당,34370,37402,71772,12
2021-12-24,2호선,강남,82610,80472,163082,12
2021-12-24,2호선,선릉,52149,45817,97966,12
2021-12-24,2호선,잠실(송파구청),77126,77081,154207,12
2021-12-24,1호선,서울역,45246,45633,90879,12
2021-12-24,4호선,서울역,10394,18450,28844,12
2021-12-24,4호선,사당,24601,19856,44457,12
2021-12-24,3호선,고속터미널,49707,53209,102916,12
2021-12-24,7호선,고속터미널,16328,14115,30443,12
2021-12-24,7호선,가산디지털단지,44056,42277,86333,12
2021-12-24,8호선,잠실(송파구청),16938,19639,36577,12
2021-12-24,9호선,고속터미널,13376,18857,32233,12
2021-12-24,경부선,서울역,6919,2860,9779,12
2021-12-24,경부선,가산디지털단지,16641,19475,36116,12
2021-12-24,분당선,선릉,12641,18331,30972,12
2021-12-24,공항철도 1호선,홍대입구,11332,11596,22928,12
2021-12-24,공항철도 1호선,서울역,8579,8721,17300,12
2021-12-24,경의선,홍대입구,1790,2294,4084,12
2021-12-24,경의선,서울역,4106,5338,9444,12
2021-12-25,경부선,가산디지털단지,4276,6179,10455,12
2021-12-25,경부선,서울역,4732,1796,6528,12
2021-12-25,9호선,고속터미널,8505,12528,21033,12
2021-12-25,8호선,잠실(송파구청),15265,16788,32053,12
2021-12-25,7호선,가산디지털단지,10964,9432,20396,12
2021-12-25,7호선,고속터미널,8761,6943,15704,12
2021-12-25,4호선,사당,14968,12753,27721,12
2021-12-25,4호선,서울역,5005,11114,16119,12
2021-12-25,3호선,고속터미널,36399,36608,73007,12
2021-12-25,2호선,홍대입구,63119,64892,128011,12
2021-12-25,2호선,구로디지털단지,25372,25162,50534,12
2021-12-25,2호선,신림,40232,38740,78972,12
2021-12-25,2호선,사당,19937,21701,41638,12
2021-12-25,2호선,강남,39794,38813,78607,12
2021-12-25,2호선,선릉,14148,12562,26710,12
2021-12-25,2호선,잠실(송파구청),68897,64657,133554,12
2021-12-25,1호선,서울역,24963,25027,49990,12
2021-12-25,분당선,선릉,2843,4218,7061,12
2021-12-25,공항철도 1호선,홍대입구,10580,10530,21110,12
2021-12-25,공항철도 1호선,서울역,5659,5762,11421,12
2021-12-25,경의선,홍대입구,1745,2238,3983,12
2021-12-25,경의선,서울역,959,1032,1991,12
2021-12-26,1호선,서울역,24089,21302,45391,12
2021-12-26,2호선,잠실(송파구청),42732,40278,83010,12
2021-12-26,2호선,선릉,11172,9504,20676,12
2021-12-26,2호선,강남,29494,28184,57678,12
2021-12-26,2호선,사당,16394,18302,34696,12
2021-12-26,2호선,신림,31465,31055,62520,12
2021-12-26,2호선,구로디지털단지,18975,18966,37941,12
2021-12-26,2호선,홍대입구,41179,40204,81383,12
2021-12-26,3호선,고속터미널,34731,32312,67043,12
2021-12-26,4호선,서울역,3515,8942,12457,12
2021-12-26,4호선,사당,12004,11129,23133,12
2021-12-26,7호선,고속터미널,9838,6154,15992,12
2021-12-26,7호선,가산디지털단지,8561,7501,16062,12
2021-12-26,분당선,선릉,2229,3387,5616,12
2021-12-26,공항철도 1호선,홍대입구,7954,7605,15559,12
2021-12-26,공항철도 1호선,서울역,6881,5701,12582,12
2021-12-26,경의선,홍대입구,1227,1551,2778,12
2021-12-26,경의선,서울역,864,749,1613,12
2021-12-26,경부선,가산디지털단지,3483,5006,8489,12
2021-12-26,경부선,서울역,6819,1663,8482,12
2021-12-26,9호선,고속터미널,8216,10720,18936,12
2021-12-26,8호선,잠실(송파구청),9369,10511,19880,12
2021-12-27,7호선,고속터미널,14840,12020,26860,12
2021-12-27,7호선,가산디지털단지,44126,43370,87496,12
2021-12-27,8호선,잠실(송파구청),13493,15653,29146,12
2021-12-27,분당선,선릉,12665,19129,31794,12
2021-12-27,공항철도 1호선,홍대입구,8890,8925,17815,12
2021-12-27,공항철도 1호선,서울역,7288,6731,14019,12
2021-12-27,경의선,홍대입구,1371,1520,2891,12
2021-12-27,경의선,서울역,3890,4802,8692,12
2021-12-27,9호선,고속터미널,10837,13999,24836,12
2021-12-27,경부선,서울역,6274,1997,8271,12
2021-12-27,경부선,가산디지털단지,16648,19319,35967,12
2021-12-27,4호선,서울역,9644,14569,24213,12
2021-12-27,3호선,고속터미널,37547,35591,73138,12
2021-12-27,2호선,홍대입구,48673,49387,98060,12
2021-12-27,2호선,구로디지털단지,55203,55605,110808,12
2021-12-27,2호선,신림,57212,56248,113460,12
2021-12-27,2호선,사당,31563,34524,66087,12
2021-12-27,2호선,강남,78234,76148,154382,12
2021-12-27,2호선,선릉,52511,46301,98812,12
2021-12-27,2호선,잠실(송파구청),63457,63078,126535,12
2021-12-27,1호선,서울역,40321,38102,78423,12
2021-12-27,4호선,사당,21826,18311,40137,12
2021-12-28,9호선,고속터미널,10990,14123,25113,12
2021-12-28,8호선,잠실(송파구청),13675,15930,29605,12
2021-12-28,7호선,가산디지털단지,45380,45087,90467,12
2021-12-28,7호선,고속터미널,14754,12525,27279,12
2021-12-28,4호선,사당,23269,19606,42875,12
2021-12-28,4호선,서울역,10007,15020,25027,12
2021-12-28,1호선,서울역,40338,37856,78194,12
2021-12-28,2호선,잠실(송파구청),65536,65145,130681,12
2021-12-28,2호선,선릉,55497,49125,104622,12
2021-12-28,2호선,강남,81429,78765,160194,12
2021-12-28,2호선,사당,34390,37375,71765,12
2021-12-28,2호선,신림,59839,58796,118635,12
2021-12-28,3호선,고속터미널,37597,36565,74162,12
2021-12-28,2호선,홍대입구,51165,52459,103624,12
2021-12-28,2호선,구로디지털단지,57913,58215,116128,12
2021-12-28,분당선,선릉,13343,19934,33277,12
2021-12-28,공항철도 1호선,홍대입구,9267,9249,18516,12
2021-12-28,공항철도 1호선,서울역,7187,6599,13786,12
2021-12-28,경의선,홍대입구,1630,1720,3350,12
2021-12-28,경의선,서울역,4001,4937,8938,12
2021-12-28,경부선,가산디지털단지,17126,19917,37043,12
2021-12-28,경부선,서울역,5383,1807,7190,12
2021-12-29,7호선,고속터미널,14612,12897,27509,12
2021-12-29,7호선,가산디지털단지,45353,45014,90367,12
2021-12-29,8호선,잠실(송파구청),14618,16980,31598,12
2021-12-29,9호선,고속터미널,11656,15065,26721,12
2021-12-29,경부선,서울역,5474,1937,7411,12
2021-12-29,경부선,가산디지털단지,17237,20110,37347,12
2021-12-29,경의선,서울역,4052,5130,9182,12
2021-12-29,경의선,홍대입구,1810,2082,3892,12
2021-12-29,공항철도 1호선,서울역,7240,6799,14039,12
2021-12-29,공항철도 1호선,홍대입구,10160,10084,20244,12
2021-12-29,분당선,선릉,13197,19894,33091,12
2021-12-29,1호선,서울역,41530,40060,81590,12
2021-12-29,2호선,잠실(송파구청),70754,69929,140683,12
2021-12-29,2호선,선릉,55224,48670,103894,12
2021-12-29,2호선,강남,81818,78259,160077,12
2021-12-29,2호선,사당,35679,38510,74189,12
2021-12-29,2호선,신림,61614,60037,121651,12
2021-12-29,2호선,구로디지털단지,58946,58716,117662,12
2021-12-29,2호선,홍대입구,54292,55675,109967,12
2021-12-29,3호선,고속터미널,39390,38753,78143,12
2021-12-29,4호선,서울역,10269,15323,25592,12
2021-12-29,4호선,사당,24147,20232,44379,12
2021-12-30,8호선,잠실(송파구청),15274,17403,32677,12
2021-12-30,2호선,홍대입구,55979,56487,112466,12
2021-12-30,2호선,구로디지털단지,57471,57488,114959,12
2021-12-30,2호선,신림,61046,59100,120146,12
2021-12-30,2호선,사당,34806,37733,72539,12
2021-12-30,2호선,강남,81608,78734,160342,12
2021-12-30,2호선,선릉,52877,46819,99696,12
2021-12-30,2호선,잠실(송파구청),70773,70150,140923,12
2021-12-30,7호선,고속터미널,14419,12968,27387,12
2021-12-30,1호선,서울역,40241,40830,81071,12
2021-12-30,7호선,가산디지털단지,43047,42726,85773,12
2021-12-30,경부선,서울역,5596,2225,7821,12
2021-12-30,경부선,가산디지털단지,16243,19058,35301,12
2021-12-30,3호선,고속터미널,40408,42420,82828,12
2021-12-30,경의선,홍대입구,1693,2036,3729,12
2021-12-30,경의선,서울역,3857,4838,8695,12
2021-12-30,분당선,선릉,12573,19033,31606,12
2021-12-30,9호선,고속터미널,11478,15682,27160,12
2021-12-30,공항철도 1호선,홍대입구,10268,10607,20875,12
2021-12-30,공항철도 1호선,서울역,6972,7210,14182,12
2021-12-30,4호선,서울역,9785,16257,26042,12
2021-12-30,4호선,사당,24118,19729,43847,12
2021-12-31,7호선,고속터미널,14742,13506,28248,12
2021-12-31,7호선,가산디지털단지,36036,34412,70448,12
2021-12-31,8호선,잠실(송파구청),15261,17791,33052,12
2021-12-31,9호선,고속터미널,11380,18452,29832,12
2021-12-31,4호선,사당,21902,18134,40036,12
2021-12-31,4호선,서울역,8446,16939,25385,12
2021-12-31,3호선,고속터미널,42987,53395,96382,12
2021-12-31,2호선,홍대입구,55450,57298,112748,12
2021-12-31,2호선,구로디지털단지,51946,50673,102619,12
2021-12-31,2호선,신림,59887,55833,115720,12
2021-12-31,2호선,사당,30643,33622,64265,12
2021-12-31,2호선,강남,72823,69903,142726,12
2021-12-31,2호선,선릉,43555,38325,81880,12
2021-12-31,2호선,잠실(송파구청),67434,68719,136153,12
2021-12-31,1호선,서울역,39146,43677,82823,12
2021-12-31,경부선,서울역,6055,2928,8983,12
2021-12-31,경부선,가산디지털단지,13481,16010,29491,12
2021-12-31,공항철도 1호선,서울역,7776,8677,16453,12
2021-12-31,공항철도 1호선,홍대입구,9995,9956,19951,12
2021-12-31,분당선,선릉,10099,14935,25034,12
2021-12-31,경의선,서울역,3321,4497,7818,12
2021-12-31,경의선,홍대입구,1629,1827,3456,12
2022-01-01,1호선,서울역,18398,16926,35324,1
2022-01-01,2호선,구로디지털단지,18363,18352,36715,1
2022-01-01,2호선,신림,29564,29162,58726,1
2022-01-01,2호선,사당,15292,16173,31465,1
2022-01-01,2호선,강남,26200,24977,51177,1
2022-01-01,2호선,선릉,9197,7746,16943,1
2022-01-01,2호선,잠실(송파구청),35454,33619,69073,1
2022-01-01,2호선,홍대입구,38842,38438,77280,1
2022-01-01,분당선,선릉,1980,2837,4817,1
2022-01-01,공항철도 1호선,홍대입구,6979,6898,13877,1
2022-01-01,공항철도 1호선,서울역,4845,4299,9144,1
2022-01-01,경의선,홍대입구,1134,1294,2428,1
2022-01-01,경의선,서울역,687,726,1413,1
2022-01-01,경부선,가산디지털단지,3643,5070,8713,1
2022-01-01,경부선,서울역,3983,1105,5088,1
2022-01-01,9호선,고속터미널,5747,8054,13801,1
2022-01-01,8호선,잠실(송파구청),8337,9287,17624,1
2022-01-01,7호선,가산디지털단지,9016,7932,16948,1
2022-01-01,7호선,고속터미널,6805,4829,11634,1
2022-01-01,4호선,사당,10613,9321,19934,1
2022-01-01,3호선,고속터미널,21392,21318,42710,1
2022-01-01,4호선,서울역,3123,6657,9780,1
2022-01-02,1호선,서울역,26464,20031,46495,1
2022-01-02,분당선,선릉,2172,3237,5409,1
2022-01-02,공항철도 1호선,홍대입구,8011,7906,15917,1
2022-01-02,공항철도 1호선,서울역,7609,5335,12944,1
2022-01-02,경의선,홍대입구,1329,1653,2982,1
2022-01-02,경의선,서울역,914,790,1704,1
2022-01-02,경부선,가산디지털단지,3867,5643,9510,1
2022-01-02,경부선,서울역,8276,1456,9732,1
2022-01-02,9호선,고속터미널,9114,10548,19662,1
2022-01-02,8호선,잠실(송파구청),9634,10188,19822,1
2022-01-02,7호선,가산디지털단지,8629,8532,17161,1
2022-01-02,7호선,고속터미널,12940,6335,19275,1
2022-01-02,4호선,사당,11615,11338,22953,1
2022-01-02,4호선,서울역,3227,7255,10482,1
2022-01-02,3호선,고속터미널,39814,30429,70243,1
2022-01-02,2호선,홍대입구,39667,39606,79273,1
2022-01-02,2호선,구로디지털단지,19473,20224,39697,1
2022-01-02,2호선,신림,30662,32909,63571,1
2022-01-02,2호선,사당,16722,18540,35262,1
2022-01-02,2호선,강남,28851,27608,56459,1
2022-01-02,2호선,선릉,9592,8449,18041,1
2022-01-02,2호선,잠실(송파구청),41857,38814,80671,1
2022-01-03,1호선,서울역,40413,36361,76774,1
2022-01-03,2호선,잠실(송파구청),61246,61197,122443,1
2022-01-03,2호선,선릉,54376,47992,102368,1
2022-01-03,2호선,강남,82703,79988,162691,1
2022-01-03,2호선,사당,31943,35058,67001,1
2022-01-03,2호선,신림,58307,57981,116288,1
2022-01-03,2호선,구로디지털단지,57836,58202,116038,1
2022-01-03,2호선,홍대입구,46517,47843,94360,1
2022-01-03,3호선,고속터미널,36229,32417,68646,1
2022-01-03,4호선,서울역,10530,14163,24693,1
2022-01-03,4호선,사당,21998,18031,40029,1
2022-01-03,7호선,고속터미널,15191,11984,27175,1
2022-01-03,7호선,가산디지털단지,47004,46739,93743,1
2022-01-03,8호선,잠실(송파구청),13182,15254,28436,1
2022-01-03,9호선,고속터미널,10878,13257,24135,1
2022-01-03,경부선,서울역,6012,1755,7767,1
2022-01-03,경부선,가산디지털단지,18081,20593,38674,1
2022-01-03,경의선,서울역,4219,5051,9270,1
2022-01-03,경의선,홍대입구,1529,1810,3339,1
2022-01-03,공항철도 1호선,서울역,6955,5972,12927,1
2022-01-03,공항철도 1호선,홍대입구,8463,8721,17184,1
2022-01-03,분당선,선릉,13385,19921,33306,1
2022-01-04,1호선,서울역,39092,36147,75239,1
2022-01-04,2호선,잠실(송파구청),64568,64231,128799,1
2022-01-04,2호선,선릉,56679,50209,106888,1
2022-01-04,2호선,강남,85529,82798,168327,1
2022-01-04,2호선,사당,34043,36815,70858,1
2022-01-04,2호선,신림,60080,59323,119403,1
2022-01-04,2호선,구로디지털단지,58965,59323,118288,1
2022-01-04,2호선,홍대입구,49289,49959,99248,1
2022-01-04,3호선,고속터미널,35692,33353,69045,1
2022-01-04,4호선,서울역,10632,14490,25122,1
2022-01-04,4호선,사당,23412,19014,42426,1
2022-01-04,7호선,고속터미널,14584,12311,26895,1
2022-01-04,7호선,가산디지털단지,47783,47569,95352,1
2022-01-04,8호선,잠실(송파구청),13673,15757,29430,1
2022-01-04,9호선,고속터미널,10962,13876,24838,1
2022-01-04,경부선,서울역,4733,1570,6303,1
2022-01-04,경부선,가산디지털단지,18184,21058,39242,1
2022-01-04,경의선,서울역,4089,5117,9206,1
2022-01-04,경의선,홍대입구,1621,1903,3524,1
2022-01-04,공항철도 1호선,서울역,6535,5727,12262,1
2022-01-04,공항철도 1호선,홍대입구,8879,9076,17955,1
2022-01-04,분당선,선릉,13895,20726,34621,1
2022-01-05,2호선,홍대입구,50074,51299,101373,1
2022-01-05,3호선,고속터미널,36547,34559,71106,1
2022-01-05,4호선,서울역,10765,14349,25114,1
2022-01-05,4호선,사당,23635,19229,42864,1
2022-01-05,7호선,고속터미널,14621,12311,26932,1
2022-01-05,7호선,가산디지털단지,47299,47272,94571,1
2022-01-05,8호선,잠실(송파구청),13302,15608,28910,1
2022-01-05,9호선,고속터미널,11344,14525,25869,1
2022-01-05,경부선,서울역,3969,1344,5313,1
2022-01-05,경부선,가산디지털단지,18325,21116,39441,1
2022-01-05,경의선,서울역,4043,4975,9018,1
2022-01-05,경의선,홍대입구,1671,1945,3616,1
2022-01-05,공항철도 1호선,서울역,6250,5837,12087,1
2022-01-05,공항철도 1호선,홍대입구,8796,8848,17644,1
2022-01-05,분당선,선릉,13813,20498,34311,1
2022-01-05,1호선,서울역,38744,36262,75006,1
2022-01-05,2호선,잠실(송파구청),64727,64090,128817,1
2022-01-05,2호선,선릉,57173,50828,108001,1
2022-01-05,2호선,강남,85391,82379,167770,1
2022-01-05,2호선,사당,34666,37483,72149,1
2022-01-05,2호선,신림,60772,59804,120576,1
2022-01-05,2호선,구로디지털단지,59242,59546,118788,1
2022-01-06,1호선,서울역,40340,38347,78687,1
2022-01-06,2호선,잠실(송파구청),66777,66556,133333,1
2022-01-06,2호선,선릉,57573,51419,108992,1
2022-01-06,2호선,강남,86215,84876,171091,1
2022-01-06,2호선,사당,35198,38257,73455,1
2022-01-06,2호선,신림,61525,60435,121960,1
2022-01-06,2호선,구로디지털단지,59838,59844,119682,1
2022-01-06,2호선,홍대입구,52648,53736,106384,1
2022-01-06,3호선,고속터미널,37030,35434,72464,1
2022-01-06,4호선,서울역,10702,15245,25947,1
2022-01-06,4호선,사당,24095,19898,43993,1
2022-01-06,7호선,고속터미널,14893,12710,27603,1
2022-01-06,7호선,가산디지털단지,47851,47621,95472,1
2022-01-06,8호선,잠실(송파구청),14152,16381,30533,1
2022-01-06,9호선,고속터미널,11423,14551,25974,1
2022-01-06,경부선,서울역,5188,1718,6906,1
2022-01-06,경부선,가산디지털단지,18386,21296,39682,1
2022-01-06,경의선,서울역,4186,5046,9232,1
2022-01-06,경의선,홍대입구,1639,2004,3643,1
2022-01-06,공항철도 1호선,서울역,6785,6376,13161,1
2022-01-06,공항철도 1호선,홍대입구,9087,9319,18406,1
2022-01-06,분당선,선릉,14080,20884,34964,1
2022-01-07,경부선,가산디지털단지,18345,20984,39329,1
2022-01-07,7호선,가산디지털단지,46641,46210,92851,1
2022-01-07,2호선,강남,90564,89305,179869,1
2022-01-07,9호선,고속터미널,12236,16914,29150,1
2022-01-07,7호선,고속터미널,16470,13718,30188,1
2022-01-07,3호선,고속터미널,42206,43483,85689,1
2022-01-07,2호선,구로디지털단지,60359,60335,120694,1
2022-01-07,4호선,사당,25145,20410,45555,1
2022-01-07,2호선,사당,36489,39801,76290,1
2022-01-07,4호선,서울역,10652,16669,27321,1
2022-01-07,공항철도 1호선,서울역,8082,7816,15898,1
2022-01-07,1호선,서울역,43576,42324,85900,1
2022-01-07,경의선,서울역,4068,5197,9265,1
2022-01-07,경부선,서울역,6925,2329,9254,1
2022-01-07,2호선,선릉,57994,51049,109043,1
2022-01-07,분당선,선릉,13922,20862,34784,1
2022-01-07,2호선,신림,62877,61917,124794,1
2022-01-07,2호선,잠실(송파구청),69885,69051,138936,1
2022-01-07,8호선,잠실(송파구청),14795,17253,32048,1
2022-01-07,공항철도 1호선,홍대입구,10075,10175,20250,1
2022-01-07,2호선,홍대입구,57310,59625,116935,1
2022-01-07,경의선,홍대입구,1740,2101,3841,1
2022-01-08,1호선,서울역,27185,26970,54155,1
2022-01-08,2호선,잠실(송파구청),60847,58266,119113,1
2022-01-08,2호선,선릉,22333,19574,41907,1
2022-01-08,2호선,강남,60515,59780,120295,1
2022-01-08,2호선,사당,28402,31021,59423,1
2022-01-08,2호선,신림,47240,45940,93180,1
2022-01-08,2호선,구로디지털단지,32316,31994,64310,1
2022-01-08,2호선,홍대입구,58826,62640,121466,1
2022-01-08,3호선,고속터미널,43388,43336,86724,1
2022-01-08,4호선,서울역,4983,11276,16259,1
2022-01-08,4호선,사당,19763,17186,36949,1
2022-01-08,7호선,고속터미널,12746,9760,22506,1
2022-01-08,7호선,가산디지털단지,13612,12272,25884,1
2022-01-08,8호선,잠실(송파구청),12827,14581,27408,1
2022-01-08,9호선,고속터미널,10828,15273,26101,1
2022-01-08,경부선,서울역,5739,1763,7502,1
2022-01-08,경부선,가산디지털단지,5682,7715,13397,1
2022-01-08,경의선,서울역,1105,1279,2384,1
2022-01-08,경의선,홍대입구,1873,2008,3881,1
2022-01-08,공항철도 1호선,서울역,6410,6441,12851,1
2022-01-08,공항철도 1호선,홍대입구,11262,10856,22118,1
2022-01-08,분당선,선릉,4793,7354,12147,1
2022-01-09,경의선,서울역,924,820,1744,1
2022-01-09,경의선,홍대입구,1495,1658,3153,1
2022-01-09,공항철도 1호선,서울역,6686,5804,12490,1
2022-01-09,공항철도 1호선,홍대입구,9031,8378,17409,1
2022-01-09,분당선,선릉,2650,4017,6667,1
2022-01-09,1호선,서울역,22698,20411,43109,1
2022-01-09,2호선,잠실(송파구청),44557,41825,86382,1
2022-01-09,2호선,선릉,12572,10627,23199,1
2022-01-09,2호선,강남,33870,32354,66224,1
2022-01-09,2호선,사당,19329,21450,40779,1
2022-01-09,2호선,신림,34676,33117,67793,1
2022-01-09,2호선,구로디지털단지,21940,21522,43462,1
2022-01-09,2호선,홍대입구,45921,44982,90903,1
2022-01-09,3호선,고속터미널,34914,32930,67844,1
2022-01-09,4호선,서울역,3631,8516,12147,1
2022-01-09,4호선,사당,13623,12686,26309,1
2022-01-09,7호선,고속터미널,10273,6987,17260,1
2022-01-09,7호선,가산디지털단지,9291,8559,17850,1
2022-01-09,8호선,잠실(송파구청),9598,10440,20038,1
2022-01-09,9호선,고속터미널,8526,11666,20192,1
2022-01-09,경부선,서울역,6199,1467,7666,1
2022-01-09,경부선,가산디지털단지,4089,5640,9729,1
2022-01-10,경의선,홍대입구,1590,1837,3427,1
2022-01-10,경의선,서울역,4265,5251,9516,1
2022-01-10,경부선,가산디지털단지,18655,21484,40139,1
2022-01-10,경부선,서울역,5709,1922,7631,1
2022-01-10,9호선,고속터미널,11095,14222,25317,1
2022-01-10,8호선,잠실(송파구청),13458,15694,29152,1
2022-01-10,7호선,가산디지털단지,48208,48064,96272,1
2022-01-10,7호선,고속터미널,15207,12340,27547,1
2022-01-10,4호선,사당,23239,18896,42135,1
2022-01-10,4호선,서울역,10949,15215,26164,1
2022-01-10,3호선,고속터미널,36650,34476,71126,1
2022-01-10,2호선,홍대입구,49806,50788,100594,1
2022-01-10,2호선,구로디지털단지,59721,60233,119954,1
2022-01-10,2호선,신림,60732,57854,118586,1
2022-01-10,2호선,사당,34247,37503,71750,1
2022-01-10,2호선,강남,86972,84796,171768,1
2022-01-10,2호선,선릉,58395,51412,109807,1
2022-01-10,2호선,잠실(송파구청),64779,64626,129405,1
2022-01-10,1호선,서울역,41049,39058,80107,1
2022-01-10,분당선,선릉,13981,20845,34826,1
2022-01-10,공항철도 1호선,홍대입구,9072,8905,17977,1
2022-01-10,공항철도 1호선,서울역,7054,6596,13650,1
2022-01-11,경의선,홍대입구,1503,1814,3317,1
2022-01-11,경의선,서울역,4095,5109,9204,1
2022-01-11,8호선,잠실(송파구청),13885,16051,29936,1
2022-01-11,7호선,가산디지털단지,48557,48232,96789,1
2022-01-11,7호선,고속터미널,14757,12761,27518,1
2022-01-11,4호선,사당,24414,19734,44148,1
2022-01-11,4호선,서울역,10936,15468,26404,1
2022-01-11,3호선,고속터미널,36778,34875,71653,1
2022-01-11,2호선,홍대입구,51041,51762,102803,1
2022-01-11,2호선,구로디지털단지,60101,60296,120397,1
2022-01-11,2호선,신림,61582,60628,122210,1
2022-01-11,2호선,사당,35225,38314,73539,1
2022-01-11,2호선,강남,89258,87157,176415,1
2022-01-11,2호선,선릉,58922,52472,111394,1
2022-01-11,2호선,잠실(송파구청),66829,66520,133349,1
2022-01-11,1호선,서울역,41022,39000,80022,1
2022-01-11,경부선,가산디지털단지,18251,21322,39573,1
2022-01-11,경부선,서울역,5288,1800,7088,1
2022-01-11,9호선,고속터미널,10971,14125,25096,1
2022-01-11,분당선,선릉,14530,21629,36159,1
2022-01-11,공항철도 1호선,홍대입구,9059,9226,18285,1
2022-01-11,공항철도 1호선,서울역,6951,6315,13266,1
2022-01-12,공항철도 1호선,홍대입구,9082,9139,18221,1
2022-01-12,경의선,홍대입구,1533,1831,3364,1
2022-01-12,경의선,서울역,4061,5127,9188,1
2022-01-12,경부선,가산디지털단지,18105,21002,39107,1
2022-01-12,경부선,서울역,5345,1798,7143,1
2022-01-12,9호선,고속터미널,11174,14138,25312,1
2022-01-12,8호선,잠실(송파구청),14155,16400,30555,1
2022-01-12,7호선,가산디지털단지,47246,46973,94219,1
2022-01-12,7호선,고속터미널,14762,12688,27450,1
2022-01-12,1호선,서울역,40827,38656,79483,1
2022-01-12,2호선,잠실(송파구청),67271,67606,134877,1
2022-01-12,2호선,선릉,57818,51313,109131,1
2022-01-12,2호선,강남,87834,85411,173245,1
2022-01-12,2호선,사당,35068,38291,73359,1
2022-01-12,2호선,신림,61441,60475,121916,1
2022-01-12,2호선,구로디지털단지,59366,59222,118588,1
2022-01-12,2호선,홍대입구,51272,52155,103427,1
2022-01-12,3호선,고속터미널,36363,34880,71243,1
2022-01-12,4호선,서울역,10818,15502,26320,1
2022-01-12,4호선,사당,23786,19455,43241,1
2022-01-12,분당선,선릉,14154,21020,35174,1
2022-01-12,공항철도 1호선,서울역,6969,6421,13390,1
2022-01-13,2호선,홍대입구,53135,54210,107345,1
2022-01-13,2호선,구로디지털단지,59515,59456,118971,1
2022-01-13,2호선,신림,61880,60695,122575,1
2022-01-13,2호선,사당,35641,38657,74298,1
2022-01-13,2호선,강남,88800,86176,174976,1
2022-01-13,2호선,선릉,57998,51795,109793,1
2022-01-13,2호선,잠실(송파구청),67588,67405,134993,1
2022-01-13,1호선,서울역,41730,39204,80934,1
2022-01-13,7호선,고속터미널,15184,13051,28235,1
2022-01-13,7호선,가산디지털단지,47433,47083,94516,1
2022-01-13,8호선,잠실(송파구청),14087,16394,30481,1
2022-01-13,공항철도 1호선,서울역,7144,6641,13785,1
2022-01-13,공항철도 1호선,홍대입구,9404,9503,18907,1
2022-01-13,분당선,선릉,14289,20972,35261,1
2022-01-13,9호선,고속터미널,11284,14602,25886,1
2022-01-13,경부선,서울역,5869,1926,7795,1
2022-01-13,경부선,가산디지털단지,18155,20882,39037,1
2022-01-13,경의선,서울역,4035,5045,9080,1
2022-01-13,경의선,홍대입구,1613,1837,3450,1
2022-01-13,4호선,사당,24403,19705,44108,1
2022-01-13,4호선,서울역,11030,15854,26884,1
2022-01-13,3호선,고속터미널,37660,36306,73966,1
2022-01-14,1호선,서울역,44956,43212,88168,1
2022-01-14,2호선,잠실(송파구청),69692,69282,138974,1
2022-01-14,경부선,가산디지털단지,17992,20604,38596,1
2022-01-14,2호선,선릉,57531,51023,108554,1
2022-01-14,2호선,강남,92109,89913,182022,1
2022-01-14,경부선,서울역,7472,2704,10176,1
2022-01-14,7호선,고속터미널,17078,14107,31185,1
2022-01-14,7호선,가산디지털단지,46086,45467,91553,1
2022-01-14,8호선,잠실(송파구청),14551,17040,31591,1
2022-01-14,9호선,고속터미널,12438,16952,29390,1
2022-01-14,2호선,사당,36555,39892,76447,1
2022-01-14,2호선,신림,63065,61543,124608,1
2022-01-14,2호선,구로디지털단지,59640,59669,119309,1
2022-01-14,2호선,홍대입구,57559,59788,117347,1
2022-01-14,3호선,고속터미널,43375,44994,88369,1
2022-01-14,4호선,서울역,10987,17339,28326,1
2022-01-14,4호선,사당,25293,20702,45995,1
2022-01-14,경의선,홍대입구,1814,2106,3920,1
2022-01-14,경의선,서울역,4153,5128,9281,1
2022-01-14,분당선,선릉,13855,20565,34420,1
2022-01-14,공항철도 1호선,홍대입구,10621,10857,21478,1
2022-01-14,공항철도 1호선,서울역,8651,8303,16954,1
2022-01-15,4호선,사당,19531,17100,36631,1
2022-01-15,4호선,서울역,5171,11444,16615,1
2022-01-15,3호선,고속터미널,44642,44580,89222,1
2022-01-15,2호선,홍대입구,63354,66211,129565,1
2022-01-15,2호선,구로디지털단지,32413,31999,64412,1
2022-01-15,2호선,신림,48103,46495,94598,1
2022-01-15,2호선,사당,28815,31814,60629,1
2022-01-15,2호선,강남,61843,60249,122092,1
2022-01-15,2호선,선릉,23308,20365,43673,1
2022-01-15,2호선,잠실(송파구청),60696,58670,119366,1
2022-01-15,1호선,서울역,28600,28201,56801,1
2022-01-15,분당선,선릉,5010,7712,12722,1
2022-01-15,공항철도 1호선,홍대입구,12420,12262,24682,1
2022-01-15,공항철도 1호선,서울역,6948,7002,13950,1
2022-01-15,경의선,홍대입구,1914,2220,4134,1
2022-01-15,경의선,서울역,1120,1207,2327,1
2022-01-15,경부선,가산디지털단지,5769,7796,13565,1
2022-01-15,경부선,서울역,6133,1899,8032,1
2022-01-15,9호선,고속터미널,10865,15712,26577,1
2022-01-15,8호선,잠실(송파구청),12444,14527,26971,1
2022-01-15,7호선,가산디지털단지,13586,12445,26031,1
2022-01-15,7호선,고속터미널,13111,9897,23008,1
2022-01-16,4호선,사당,14050,12927,26977,1
2022-01-16,4호선,서울역,3974,9609,13583,1
2022-01-16,분당선,선릉,2666,4150,6816,1
2022-01-16,1호선,서울역,24951,22877,47828,1
2022-01-16,2호선,잠실(송파구청),47523,44419,91942,1
2022-01-16,2호선,선릉,12606,10737,23343,1
2022-01-16,2호선,강남,35106,32806,67912,1
2022-01-16,2호선,사당,20188,21859,42047,1
2022-01-16,2호선,신림,35219,35149,70368,1
2022-01-16,2호선,구로디지털단지,22203,22088,44291,1
2022-01-16,2호선,홍대입구,49697,48109,97806,1
2022-01-16,3호선,고속터미널,36869,35095,71964,1
2022-01-16,9호선,고속터미널,8440,11905,20345,1
2022-01-16,경부선,서울역,6961,1733,8694,1
2022-01-16,경부선,가산디지털단지,4171,5844,10015,1
2022-01-16,경의선,서울역,916,899,1815,1
2022-01-16,경의선,홍대입구,1567,1806,3373,1
2022-01-16,8호선,잠실(송파구청),10113,11270,21383,1
2022-01-16,7호선,가산디지털단지,9536,8717,18253,1
2022-01-16,7호선,고속터미널,10553,7174,17727,1
2022-01-16,공항철도 1호선,서울역,6946,6178,13124,1
2022-01-16,공항철도 1호선,홍대입구,9826,9062,18888,1
2022-01-17,4호선,서울역,11231,15610,26841,1
2022-01-17,4호선,사당,23307,19203,42510,1
2022-01-17,2호선,선릉,59123,51712,110835,1
2022-01-17,2호선,강남,88930,85584,174514,1
2022-01-17,2호선,사당,34328,37450,71778,1
2022-01-17,1호선,서울역,41857,39516,81373,1
2022-01-17,2호선,잠실(송파구청),64564,64198,128762,1
2022-01-17,2호선,신림,61183,60578,121761,1
2022-01-17,2호선,구로디지털단지,59603,59983,119586,1
2022-01-17,2호선,홍대입구,50570,51028,101598,1
2022-01-17,3호선,고속터미널,36629,34942,71571,1
2022-01-17,7호선,고속터미널,15522,12581,28103,1
2022-01-17,7호선,가산디지털단지,48784,47393,96177,1
2022-01-17,8호선,잠실(송파구청),13693,15624,29317,1
2022-01-17,9호선,고속터미널,11317,14138,25455,1
2022-01-17,경부선,서울역,6001,2006,8007,1
2022-01-17,경부선,가산디지털단지,18557,21377,39934,1
2022-01-17,경의선,서울역,4215,5159,9374,1
2022-01-17,경의선,홍대입구,1484,1781,3265,1
2022-01-17,공항철도 1호선,서울역,7423,6725,14148,1
2022-01-17,공항철도 1호선,홍대입구,8906,8810,17716,1
2022-01-17,분당선,선릉,14551,21112,35663,1
2022-01-18,분당선,선릉,14497,21645,36142,1
2022-01-18,경의선,서울역,4117,5210,9327,1
2022-01-18,경부선,가산디지털단지,18576,21677,40253,1
2022-01-18,경부선,서울역,5607,1767,7374,1
2022-01-18,9호선,고속터미널,11374,14462,25836,1
2022-01-18,8호선,잠실(송파구청),13861,16140,30001,1
2022-01-18,7호선,가산디지털단지,48163,48232,96395,1
2022-01-18,7호선,고속터미널,15215,13108,28323,1
2022-01-18,4호선,사당,24205,19798,44003,1
2022-01-18,4호선,서울역,11233,15830,27063,1
2022-01-18,3호선,고속터미널,37143,35608,72751,1
2022-01-18,2호선,홍대입구,51102,52065,103167,1
2022-01-18,2호선,구로디지털단지,60453,60605,121058,1
2022-01-18,2호선,신림,62161,60911,123072,1
2022-01-18,2호선,사당,35643,38624,74267,1
2022-01-18,2호선,강남,89782,87751,177533,1
2022-01-18,2호선,선릉,59315,52714,112029,1
2022-01-18,2호선,잠실(송파구청),67048,66552,133600,1
2022-01-18,1호선,서울역,41563,39218,80781,1
2022-01-18,공항철도 1호선,홍대입구,9005,9218,18223,1
2022-01-18,공항철도 1호선,서울역,7128,6552,13680,1
2022-01-18,경의선,홍대입구,1575,1750,3325,1
2022-01-19,2호선,구로디지털단지,61216,61080,122296,1
2022-01-19,2호선,신림,62548,62373,124921,1
2022-01-19,2호선,사당,36668,39637,76305,1
2022-01-19,2호선,강남,90594,87403,177997,1
2022-01-19,2호선,선릉,60485,53015,113500,1
2022-01-19,2호선,잠실(송파구청),69130,68694,137824,1
2022-01-19,1호선,서울역,43713,40739,84452,1
2022-01-19,분당선,선릉,14844,21985,36829,1
2022-01-19,공항철도 1호선,홍대입구,9135,9487,18622,1
2022-01-19,공항철도 1호선,서울역,7573,6883,14456,1
2022-01-19,경의선,홍대입구,1640,1813,3453,1
2022-01-19,경의선,서울역,4260,5258,9518,1
2022-01-19,경부선,가산디지털단지,19168,21884,41052,1
2022-01-19,경부선,서울역,6079,1985,8064,1
2022-01-19,9호선,고속터미널,11646,14971,26617,1
2022-01-19,8호선,잠실(송파구청),14945,17411,32356,1
2022-01-19,7호선,가산디지털단지,49441,48818,98259,1
2022-01-19,7호선,고속터미널,15601,13390,28991,1
2022-01-19,4호선,사당,24720,20315,45035,1
2022-01-19,4호선,서울역,11740,16804,28544,1
2022-01-19,3호선,고속터미널,38580,36275,74855,1
2022-01-19,2호선,홍대입구,51993,53039,105032,1
2022-01-20,3호선,고속터미널,38949,37151,76100,1
2022-01-20,4호선,서울역,11238,16579,27817,1
2022-01-20,4호선,사당,24783,20501,45284,1
2022-01-20,7호선,고속터미널,15514,13237,28751,1
2022-01-20,7호선,가산디지털단지,47837,47688,95525,1
2022-01-20,8호선,잠실(송파구청),14154,16494,30648,1
2022-01-20,9호선,고속터미널,11684,14910,26594,1
2022-01-20,경부선,서울역,6051,1972,8023,1
2022-01-20,경부선,가산디지털단지,18423,21402,39825,1
2022-01-20,경의선,서울역,4259,5342,9601,1
2022-01-20,경의선,홍대입구,1632,1941,3573,1
2022-01-20,공항철도 1호선,서울역,7493,6907,14400,1
2022-01-20,공항철도 1호선,홍대입구,9702,9632,19334,1
2022-01-20,분당선,선릉,14380,21488,35868,1
2022-01-20,2호선,홍대입구,53551,54651,108202,1
2022-01-20,2호선,구로디지털단지,60461,60614,121075,1
2022-01-20,2호선,신림,63222,61648,124870,1
2022-01-20,2호선,사당,36242,39568,75810,1
2022-01-20,2호선,강남,89339,87282,176621,1
2022-01-20,2호선,선릉,58951,52645,111596,1
2022-01-20,2호선,잠실(송파구청),68645,68286,136931,1
2022-01-20,1호선,서울역,43402,41037,84439,1
2022-01-21,분당선,선릉,14175,21071,35246,1
2022-01-21,공항철도 1호선,홍대입구,10129,10441,20570,1
2022-01-21,공항철도 1호선,서울역,8801,8243,17044,1
2022-01-21,경의선,홍대입구,1787,2086,3873,1
2022-01-21,경의선,서울역,4196,5342,9538,1
2022-01-21,경부선,가산디지털단지,18194,21082,39276,1
2022-01-21,경부선,서울역,7530,2454,9984,1
2022-01-21,9호선,고속터미널,12581,16999,29580,1
2022-01-21,8호선,잠실(송파구청),14519,17005,31524,1
2022-01-21,7호선,가산디지털단지,46564,45952,92516,1
2022-01-21,7호선,고속터미널,16905,13928,30833,1
2022-01-21,4호선,사당,26270,22040,48310,1
2022-01-21,4호선,서울역,11151,17816,28967,1
2022-01-21,3호선,고속터미널,44144,44964,89108,1
2022-01-21,2호선,홍대입구,56189,58740,114929,1
2022-01-21,2호선,구로디지털단지,60224,60333,120557,1
2022-01-21,2호선,신림,64508,63198,127706,1
2022-01-21,2호선,사당,38617,42109,80726,1
2022-01-21,2호선,강남,92932,91167,184099,1
2022-01-21,2호선,선릉,57932,51335,109267,1
2022-01-21,2호선,잠실(송파구청),70855,69615,140470,1
2022-01-21,1호선,서울역,46637,44427,91064,1
2022-01-22,3호선,고속터미널,45305,44716,90021,1
2022-01-22,2호선,홍대입구,63399,66290,129689,1
2022-01-22,4호선,서울역,5410,12120,17530,1
2022-01-22,4호선,사당,20069,17199,37268,1
2022-01-22,7호선,고속터미널,13223,10310,23533,1
2022-01-22,7호선,가산디지털단지,14212,12790,27002,1
2022-01-22,8호선,잠실(송파구청),12627,14506,27133,1
2022-01-22,9호선,고속터미널,11234,16062,27296,1
2022-01-22,경부선,서울역,6382,2012,8394,1
2022-01-22,경부선,가산디지털단지,6102,8013,14115,1
2022-01-22,경의선,서울역,1153,1317,2470,1
2022-01-22,경의선,홍대입구,1840,2192,4032,1
2022-01-22,공항철도 1호선,서울역,6980,7121,14101,1
2022-01-22,공항철도 1호선,홍대입구,12357,12190,24547,1
2022-01-22,분당선,선릉,5017,7990,13007,1
2022-01-22,1호선,서울역,28977,28803,57780,1
2022-01-22,2호선,구로디지털단지,33563,32984,66547,1
2022-01-22,2호선,신림,49464,48148,97612,1
2022-01-22,2호선,사당,30064,32649,62713,1
2022-01-22,2호선,강남,62465,61334,123799,1
2022-01-22,2호선,선릉,23672,20913,44585,1
2022-01-22,2호선,잠실(송파구청),62632,59632,122264,1
2022-01-23,1호선,서울역,23835,21440,45275,1
2022-01-23,2호선,잠실(송파구청),46400,43069,89469,1
2022-01-23,2호선,선릉,12504,10935,23439,1
2022-01-23,2호선,강남,35304,33656,68960,1
2022-01-23,2호선,사당,20511,22655,43166,1
2022-01-23,2호선,신림,35605,35342,70947,1
2022-01-23,2호선,구로디지털단지,22260,21887,44147,1
2022-01-23,2호선,홍대입구,48221,47073,95294,1
2022-01-23,3호선,고속터미널,35272,33988,69260,1
2022-01-23,4호선,서울역,4027,8922,12949,1
2022-01-23,4호선,사당,14144,13180,27324,1
2022-01-23,7호선,고속터미널,10471,7472,17943,1
2022-01-23,7호선,가산디지털단지,9635,8951,18586,1
2022-01-23,8호선,잠실(송파구청),9225,10588,19813,1
2022-01-23,9호선,고속터미널,8530,11945,20475,1
2022-01-23,경부선,서울역,6427,1656,8083,1
2022-01-23,경부선,가산디지털단지,4211,5831,10042,1
2022-01-23,경의선,서울역,851,898,1749,1
2022-01-23,경의선,홍대입구,1565,1794,3359,1
2022-01-23,공항철도 1호선,서울역,6657,5921,12578,1
2022-01-23,공항철도 1호선,홍대입구,9840,9195,19035,1
2022-01-23,분당선,선릉,2755,4159,6914,1
2022-01-24,공항철도 1호선,서울역,7358,6956,14314,1
2022-01-24,공항철도 1호선,홍대입구,8910,9006,17916,1
2022-01-24,분당선,선릉,14085,21261,35346,1
2022-01-24,2호선,신림,61664,60370,122034,1
2022-01-24,2호선,사당,34740,37793,72533,1
2022-01-24,2호선,강남,87455,85914,173369,1
2022-01-24,2호선,선릉,57972,51638,109610,1
2022-01-24,4호선,서울역,10864,15442,26306,1
2022-01-24,4호선,사당,23653,19408,43061,1
2022-01-24,2호선,잠실(송파구청),65603,65223,130826,1
2022-01-24,1호선,서울역,41306,39822,81128,1
2022-01-24,7호선,고속터미널,15878,13176,29054,1
2022-01-24,3호선,고속터미널,37539,35783,73322,1
2022-01-24,2호선,홍대입구,49818,50731,100549,1
2022-01-24,2호선,구로디지털단지,59992,60197,120189,1
2022-01-24,7호선,가산디지털단지,47964,48049,96013,1
2022-01-24,8호선,잠실(송파구청),13465,15598,29063,1
2022-01-24,9호선,고속터미널,11473,14441,25914,1
2022-01-24,경부선,서울역,5757,1926,7683,1
2022-01-24,경부선,가산디지털단지,18650,21529,40179,1
2022-01-24,경의선,서울역,4265,5267,9532,1
2022-01-24,경의선,홍대입구,1547,1655,3202,1
2022-01-25,경부선,가산디지털단지,18824,21661,40485,1
2022-01-25,1호선,서울역,41537,39739,81276,1
2022-01-25,4호선,사당,24558,20036,44594,1
2022-01-25,4호선,서울역,11021,15894,26915,1
2022-01-25,3호선,고속터미널,37772,36985,74757,1
2022-01-25,2호선,홍대입구,50950,51776,102726,1
2022-01-25,2호선,구로디지털단지,60520,60634,121154,1
2022-01-25,2호선,신림,61983,60624,122607,1
2022-01-25,2호선,사당,36033,39314,75347,1
2022-01-25,2호선,강남,88820,86868,175688,1
2022-01-25,2호선,선릉,58570,51906,110476,1
2022-01-25,2호선,잠실(송파구청),67366,67356,134722,1
2022-01-25,분당선,선릉,14275,21490,35765,1
2022-01-25,공항철도 1호선,홍대입구,9275,9237,18512,1
2022-01-25,공항철도 1호선,서울역,7022,6581,13603,1
2022-01-25,경의선,홍대입구,1584,1749,3333,1
2022-01-25,경의선,서울역,4245,5345,9590,1
2022-01-25,경부선,서울역,5481,1867,7348,1
2022-01-25,9호선,고속터미널,11431,14992,26423,1
2022-01-25,8호선,잠실(송파구청),13725,16004,29729,1
2022-01-25,7호선,가산디지털단지,48036,48004,96040,1
2022-01-25,7호선,고속터미널,15521,13225,28746,1
2022-01-26,4호선,서울역,11174,16894,28068,1
2022-01-26,4호선,사당,24444,20090,44534,1
2022-01-26,3호선,고속터미널,38125,38019,76144,1
2022-01-26,7호선,고속터미널,15474,13393,28867,1
2022-01-26,7호선,가산디지털단지,47561,47472,95033,1
2022-01-26,1호선,서울역,42167,41207,83374,1
2022-01-26,8호선,잠실(송파구청),13856,16270,30126,1
2022-01-26,9호선,고속터미널,11773,15517,27290,1
2022-01-26,경부선,서울역,5523,1994,7517,1
2022-01-26,경부선,가산디지털단지,18833,21554,40387,1
2022-01-26,경의선,서울역,4187,5300,9487,1
2022-01-26,경의선,홍대입구,1731,1998,3729,1
2022-01-26,공항철도 1호선,서울역,7071,6853,13924,1
2022-01-26,공항철도 1호선,홍대입구,9430,9473,18903,1
2022-01-26,분당선,선릉,14187,21071,35258,1
2022-01-26,2호선,잠실(송파구청),68262,67853,136115,1
2022-01-26,2호선,선릉,58871,51999,110870,1
2022-01-26,2호선,강남,88530,85855,174385,1
2022-01-26,2호선,사당,36681,39503,76184,1
2022-01-26,2호선,신림,62999,61637,124636,1
2022-01-26,2호선,구로디지털단지,60610,60593,121203,1
2022-01-26,2호선,홍대입구,53110,53614,106724,1
2022-01-27,분당선,선릉,13925,20479,34404,1
2022-01-27,공항철도 1호선,홍대입구,9567,9311,18878,1
2022-01-27,공항철도 1호선,서울역,7083,7897,14980,1
2022-01-27,경의선,홍대입구,1627,1838,3465,1
2022-01-27,경의선,서울역,4034,5220,9254,1
2022-01-27,경부선,가산디지털단지,18644,21335,39979,1
2022-01-27,경부선,서울역,5437,2435,7872,1
2022-01-27,9호선,고속터미널,11657,16139,27796,1
2022-01-27,8호선,잠실(송파구청),13698,15970,29668,1
2022-01-27,7호선,가산디지털단지,46554,46764,93318,1
2022-01-27,7호선,고속터미널,14868,13728,28596,1
2022-01-27,4호선,사당,24074,19631,43705,1
2022-01-27,4호선,서울역,10729,17696,28425,1
2022-01-27,3호선,고속터미널,38641,41346,79987,1
2022-01-27,2호선,홍대입구,51805,52873,104678,1
2022-01-27,2호선,구로디지털단지,60098,59717,119815,1
2022-01-27,2호선,신림,63104,60538,123642,1
2022-01-27,2호선,사당,35433,38249,73682,1
2022-01-27,2호선,강남,87398,85315,172713,1
2022-01-27,2호선,선릉,57138,50565,107703,1
2022-01-27,2호선,잠실(송파구청),66420,66215,132635,1
2022-01-27,1호선,서울역,40907,44780,85687,1
2022-01-28,1호선,서울역,38242,39895,78137,1
2022-01-28,2호선,잠실(송파구청),66146,65513,131659,1
2022-01-28,2호선,선릉,52544,46044,98588,1
2022-01-28,2호선,강남,86385,83877,170262,1
2022-01-28,2호선,사당,34683,37854,72537,1
2022-01-28,2호선,신림,63605,59295,122900,1
2022-01-28,2호선,구로디지털단지,57624,56705,114329,1
2022-01-28,2호선,홍대입구,53953,55044,108997,1
2022-01-28,3호선,고속터미널,42711,62417,105128,1
2022-01-28,4호선,서울역,9898,15116,25014,1
2022-01-28,4호선,사당,24087,19449,43536,1
2022-01-28,7호선,고속터미널,15461,16157,31618,1
2022-01-28,7호선,가산디지털단지,43662,42765,86427,1
2022-01-28,8호선,잠실(송파구청),14240,16430,30670,1
2022-01-28,9호선,고속터미널,12310,23067,35377,1
2022-01-28,경부선,서울역,4562,2068,6630,1
2022-01-28,경부선,가산디지털단지,16836,19496,36332,1
2022-01-28,경의선,서울역,3560,4869,8429,1
2022-01-28,경의선,홍대입구,1587,1790,3377,1
2022-01-28,공항철도 1호선,서울역,6656,6664,13320,1
2022-01-28,공항철도 1호선,홍대입구,9662,9741,19403,1
2022-01-28,분당선,선릉,12474,18571,31045,1
2022-01-29,공항철도 1호선,홍대입구,9117,8551,17668,1
2022-01-29,공항철도 1호선,서울역,4540,5493,10033,1
2022-01-29,경의선,홍대입구,1429,1673,3102,1
2022-01-29,경의선,서울역,820,991,1811,1
2022-01-29,경부선,가산디지털단지,4718,5897,10615,1
2022-01-29,경부선,서울역,2853,1536,4389,1
2022-01-29,9호선,고속터미널,8773,19640,28413,1
2022-01-29,8호선,잠실(송파구청),10491,11558,22049,1
2022-01-29,7호선,가산디지털단지,11297,9560,20857,1
2022-01-29,7호선,고속터미널,9028,10889,19917,1
2022-01-29,4호선,사당,15676,13304,28980,1
2022-01-29,4호선,서울역,4074,9099,13173,1
2022-01-29,3호선,고속터미널,35794,56093,91887,1
2022-01-29,2호선,홍대입구,47166,47569,94735,1
2022-01-29,2호선,구로디지털단지,27413,25446,52859,1
2022-01-29,2호선,신림,41764,36642,78406,1
2022-01-29,2호선,사당,21888,23978,45866,1
2022-01-29,2호선,강남,46702,45958,92660,1
2022-01-29,2호선,선릉,16621,14513,31134,1
2022-01-29,2호선,잠실(송파구청),46446,44730,91176,1
2022-01-29,1호선,서울역,19588,24323,43911,1
2022-01-29,분당선,선릉,3649,5354,9003,1
2022-01-30,공항철도 1호선,서울역,3695,4628,8323,1
2022-01-30,공항철도 1호선,홍대입구,7202,6627,13829,1
2022-01-30,분당선,선릉,1845,2608,4453,1
2022-01-30,경의선,홍대입구,1203,1313,2516,1
2022-01-30,경의선,서울역,655,735,1390,1
2022-01-30,경부선,가산디지털단지,3529,4439,7968,1
2022-01-30,경부선,서울역,2526,1206,3732,1
2022-01-30,9호선,고속터미널,6281,14433,20714,1
2022-01-30,8호선,잠실(송파구청),7950,9081,17031,1
2022-01-30,7호선,가산디지털단지,8157,6825,14982,1
2022-01-30,7호선,고속터미널,6759,7722,14481,1
2022-01-30,4호선,사당,11370,9536,20906,1
2022-01-30,4호선,서울역,3166,7232,10398,1
2022-01-30,3호선,고속터미널,26728,42041,68769,1
2022-01-30,2호선,홍대입구,35149,34713,69862,1
2022-01-30,2호선,구로디지털단지,18368,17111,35479,1
2022-01-30,2호선,신림,30405,26212,56617,1
2022-01-30,2호선,사당,14732,16128,30860,1
2022-01-30,2호선,강남,26059,25004,51063,1
2022-01-30,2호선,잠실(송파구청),36173,34622,70795,1
2022-01-30,1호선,서울역,15691,19367,35058,1
2022-01-30,2호선,선릉,9118,7709,16827,1
2022-01-31,분당선,선릉,1399,1891,3290,1
2022-01-31,공항철도 1호선,홍대입구,5113,4476,9589,1
2022-01-31,공항철도 1호선,서울역,3675,4141,7816,1
2022-01-31,경의선,홍대입구,750,894,1644,1
2022-01-31,경의선,서울역,642,663,1305,1
2022-01-31,경부선,가산디지털단지,3124,3931,7055,1
2022-01-31,경부선,서울역,2886,939,3825,1
2022-01-31,9호선,고속터미널,4686,9228,13914,1
2022-01-31,8호선,잠실(송파구청),6106,6739,12845,1
2022-01-31,7호선,가산디지털단지,6882,5726,12608,1
2022-01-31,7호선,고속터미널,6671,5249,11920,1
2022-01-31,4호선,사당,8037,6982,15019,1
2022-01-31,4호선,서울역,2552,5878,8430,1
2022-01-31,3호선,고속터미널,17880,24849,42729,1
2022-01-31,2호선,홍대입구,25297,24169,49466,1
2022-01-31,2호선,구로디지털단지,14330,13472,27802,1
2022-01-31,2호선,신림,23366,20345,43711,1
2022-01-31,2호선,사당,10684,11885,22569,1
2022-01-31,2호선,강남,18308,17141,35449,1
2022-01-31,2호선,선릉,6472,5276,11748,1
2022-01-31,2호선,잠실(송파구청),26747,25859,52606,1
2022-01-31,1호선,서울역,15649,16857,32506,1
2022-02-01,9호선,고속터미널,7335,4824,12159,2
2022-02-01,8호선,잠실(송파구청),5356,5827,11183,2
2022-02-01,7호선,가산디지털단지,4948,5187,10135,2
2022-02-01,7호선,고속터미널,14674,3901,18575,2
2022-02-01,4호선,사당,7021,6430,13451,2
2022-02-01,4호선,서울역,2332,4904,7236,2
2022-02-01,3호선,고속터미널,30168,13336,43504,2
2022-02-01,2호선,홍대입구,18355,19663,38018,2
2022-02-01,2호선,구로디지털단지,11935,13310,25245,2
2022-02-01,2호선,신림,19446,23401,42847,2
2022-02-01,2호선,사당,9376,10026,19402,2
2022-02-01,2호선,강남,12192,12225,24417,2
2022-02-01,2호선,선릉,4339,4146,8485,2
2022-02-01,2호선,잠실(송파구청),22539,20628,43167,2
2022-02-01,1호선,서울역,16407,14010,30417,2
2022-02-01,경의선,홍대입구,488,701,1189,2
2022-02-01,경의선,서울역,600,571,1171,2
2022-02-01,경부선,가산디지털단지,2682,4236,6918,2
2022-02-01,경부선,서울역,3855,784,4639,2
2022-02-01,공항철도 1호선,서울역,4841,3412,8253,2
2022-02-01,공항철도 1호선,홍대입구,3308,3596,6904,2
2022-02-01,분당선,선릉,949,1562,2511,2
2022-02-02,경부선,가산디지털단지,3427,5218,8645,2
2022-02-02,경부선,서울역,5395,904,6299,2
2022-02-02,경의선,서울역,670,664,1334,2
2022-02-02,경의선,홍대입구,989,1270,2259,2
2022-02-02,공항철도 1호선,서울역,5252,3864,9116,2
2022-02-02,공항철도 1호선,홍대입구,6220,6582,12802,2
2022-02-02,분당선,선릉,1689,2776,4465,2
2022-02-02,1호선,서울역,19614,15617,35231,2
2022-02-02,2호선,잠실(송파구청),36509,33632,70141,2
2022-02-02,2호선,선릉,8165,7780,15945,2
2022-02-02,2호선,강남,23905,22983,46888,2
2022-02-02,2호선,사당,14687,16403,31090,2
2022-02-02,2호선,신림,25843,30769,56612,2
2022-02-02,2호선,구로디지털단지,16668,18435,35103,2
2022-02-02,2호선,홍대입구,32410,34201,66611,2
2022-02-02,3호선,고속터미널,54010,25892,79902,2
2022-02-02,4호선,서울역,2878,5400,8278,2
2022-02-02,4호선,사당,10191,9934,20125,2
2022-02-02,7호선,고속터미널,20754,5661,26415,2
2022-02-02,7호선,가산디지털단지,7844,8191,16035,2
2022-02-02,8호선,잠실(송파구청),8588,9474,18062,2
2022-02-02,9호선,고속터미널,12259,9083,21342,2
2022-02-03,경부선,가산디지털단지,15432,18162,33594,2
2022-02-03,8호선,잠실(송파구청),12582,14425,27007,2
2022-02-03,7호선,가산디지털단지,41031,40743,81774,2
2022-02-03,분당선,선릉,11776,17802,29578,2
2022-02-03,공항철도 1호선,홍대입구,8089,9034,17123,2
2022-02-03,공항철도 1호선,서울역,8013,5265,13278,2
2022-02-03,경의선,홍대입구,1441,1677,3118,2
2022-02-03,경의선,서울역,3828,4488,8316,2
2022-02-03,경부선,서울역,8335,1516,9851,2
2022-02-03,9호선,고속터미널,10907,12957,23864,2
2022-02-03,7호선,고속터미널,17272,11588,28860,2
2022-02-03,4호선,사당,20585,17051,37636,2
2022-02-03,4호선,서울역,8832,11956,20788,2
2022-02-03,2호선,홍대입구,46546,47687,94233,2
2022-02-03,2호선,구로디지털단지,52174,52355,104529,2
2022-02-03,2호선,신림,54914,55941,110855,2
2022-02-03,2호선,사당,29962,33183,63145,2
2022-02-03,2호선,강남,76628,74210,150838,2
2022-02-03,2호선,선릉,48506,42652,91158,2
2022-02-03,2호선,잠실(송파구청),58185,57664,115849,2
2022-02-03,1호선,서울역,40979,32120,73099,2
2022-02-03,3호선,고속터미널,39424,31243,70667,2
2022-02-04,2호선,홍대입구,51236,52727,103963,2
2022-02-04,2호선,구로디지털단지,54993,55304,110297,2
2022-02-04,2호선,신림,58841,58500,117341,2
2022-02-04,2호선,사당,33218,36066,69284,2
2022-02-04,2호선,강남,83260,81092,164352,2
2022-02-04,2호선,선릉,51134,45096,96230,2
2022-02-04,2호선,잠실(송파구청),62610,61353,123963,2
2022-02-04,1호선,서울역,39412,35770,75182,2
2022-02-04,분당선,선릉,12473,18610,31083,2
2022-02-04,공항철도 1호선,홍대입구,9131,10008,19139,2
2022-02-04,공항철도 1호선,서울역,7211,6188,13399,2
2022-02-04,경의선,홍대입구,1537,1887,3424,2
2022-02-04,경의선,서울역,3680,4659,8339,2
2022-02-04,경부선,가산디지털단지,16046,18894,34940,2
2022-02-04,경부선,서울역,6167,1810,7977,2
2022-02-04,9호선,고속터미널,11116,14306,25422,2
2022-02-04,8호선,잠실(송파구청),13618,15740,29358,2
2022-02-04,7호선,가산디지털단지,41891,41740,83631,2
2022-02-04,7호선,고속터미널,15470,12244,27714,2
2022-02-04,4호선,사당,22607,18592,41199,2
2022-02-04,4호선,서울역,9371,13533,22904,2
2022-02-04,3호선,고속터미널,39289,37132,76421,2
2022-02-05,3호선,고속터미널,38852,36716,75568,2
2022-02-05,4호선,서울역,4228,8561,12789,2
2022-02-05,4호선,사당,16674,14412,31086,2
2022-02-05,7호선,고속터미널,11261,8644,19905,2
2022-02-05,7호선,가산디지털단지,11896,10783,22679,2
2022-02-05,8호선,잠실(송파구청),10690,12103,22793,2
2022-02-05,9호선,고속터미널,9025,12896,21921,2
2022-02-05,경부선,서울역,5264,1285,6549,2
2022-02-05,경부선,가산디지털단지,4929,6674,11603,2
2022-02-05,경의선,서울역,896,993,1889,2
2022-02-05,경의선,홍대입구,1473,1921,3394,2
2022-02-05,공항철도 1호선,서울역,5693,5323,11016,2
2022-02-05,공항철도 1호선,홍대입구,10237,10417,20654,2
2022-02-05,분당선,선릉,4186,6544,10730,2
2022-02-05,1호선,서울역,22832,21468,44300,2
2022-02-05,2호선,잠실(송파구청),50475,47748,98223,2
2022-02-05,2호선,선릉,19872,17786,37658,2
2022-02-05,2호선,강남,54188,52583,106771,2
2022-02-05,2호선,사당,25012,27112,52124,2
2022-02-05,2호선,신림,42273,42100,84373,2
2022-02-05,2호선,구로디지털단지,29021,28634,57655,2
2022-02-05,2호선,홍대입구,52918,54533,107451,2
2022-02-06,경의선,홍대입구,1241,1490,2731,2
2022-02-06,경의선,서울역,684,680,1364,2
2022-02-06,경부선,가산디지털단지,3571,4801,8372,2
2022-02-06,경부선,서울역,5455,1186,6641,2
2022-02-06,9호선,고속터미널,7257,10003,17260,2
2022-02-06,8호선,잠실(송파구청),7800,8573,16373,2
2022-02-06,7호선,가산디지털단지,8016,7410,15426,2
2022-02-06,7호선,고속터미널,8562,5988,14550,2
2022-02-06,4호선,사당,11987,11106,23093,2
2022-02-06,4호선,서울역,3264,6596,9860,2
2022-02-06,2호선,홍대입구,39899,38842,78741,2
2022-02-06,3호선,고속터미널,29931,28013,57944,2
2022-02-06,2호선,구로디지털단지,19385,19197,38582,2
2022-02-06,2호선,신림,31357,30942,62299,2
2022-02-06,2호선,사당,17539,19165,36704,2
2022-02-06,2호선,강남,29281,28033,57314,2
2022-02-06,2호선,선릉,10920,9548,20468,2
2022-02-06,2호선,잠실(송파구청),37179,35210,72389,2
2022-02-06,1호선,서울역,19362,16886,36248,2
2022-02-06,분당선,선릉,2289,3480,5769,2
2022-02-06,공항철도 1호선,홍대입구,7832,7537,15369,2
2022-02-06,공항철도 1호선,서울역,5533,4575,10108,2
2022-02-07,공항철도 1호선,서울역,6251,5819,12070,2
2022-02-07,공항철도 1호선,홍대입구,8273,8333,16606,2
2022-02-07,분당선,선릉,13241,20114,33355,2
2022-02-07,1호선,서울역,37914,36091,74005,2
2022-02-07,2호선,잠실(송파구청),58794,58722,117516,2
2022-02-07,2호선,선릉,56023,49520,105543,2
2022-02-07,2호선,강남,81821,80344,162165,2
2022-02-07,2호선,사당,32360,35226,67586,2
2022-02-07,2호선,신림,58784,57941,116725,2
2022-02-07,2호선,구로디지털단지,57405,57874,115279,2
2022-02-07,2호선,홍대입구,45748,46300,92048,2
2022-02-07,3호선,고속터미널,34253,31743,65996,2
2022-02-07,4호선,서울역,10287,13919,24206,2
2022-02-07,4호선,사당,22020,17908,39928,2
2022-02-07,7호선,고속터미널,14625,12138,26763,2
2022-02-07,7호선,가산디지털단지,46853,46662,93515,2
2022-02-07,8호선,잠실(송파구청),12525,14444,26969,2
2022-02-07,9호선,고속터미널,10393,13291,23684,2
2022-02-07,경부선,서울역,5206,1732,6938,2
2022-02-07,경부선,가산디지털단지,18200,21155,39355,2
2022-02-07,경의선,서울역,3962,4883,8845,2
2022-02-07,경의선,홍대입구,1400,1569,2969,2
2022-02-08,4호선,사당,23031,18762,41793,2
2022-02-08,4호선,서울역,10252,13864,24116,2
2022-02-08,3호선,고속터미널,33609,32388,65997,2
2022-02-08,2호선,홍대입구,46324,46901,93225,2
2022-02-08,2호선,구로디지털단지,57806,57855,115661,2
2022-02-08,2호선,신림,59342,58415,117757,2
2022-02-08,2호선,사당,33539,36299,69838,2
2022-02-08,2호선,강남,82469,80567,163036,2
2022-02-08,2호선,선릉,55870,49379,105249,2
2022-02-08,2호선,잠실(송파구청),60928,60050,120978,2
2022-02-08,1호선,서울역,38004,35865,73869,2
2022-02-08,분당선,선릉,13308,20036,33344,2
2022-02-08,공항철도 1호선,홍대입구,8408,8453,16861,2
2022-02-08,공항철도 1호선,서울역,6405,5736,12141,2
2022-02-08,경의선,홍대입구,1458,1635,3093,2
2022-02-08,경의선,서울역,3939,5045,8984,2
2022-02-08,경부선,가산디지털단지,18117,20947,39064,2
2022-02-08,경부선,서울역,4536,1536,6072,2
2022-02-08,9호선,고속터미널,10466,13322,23788,2
2022-02-08,8호선,잠실(송파구청),12720,14631,27351,2
2022-02-08,7호선,가산디지털단지,46448,46145,92593,2
2022-02-08,7호선,고속터미널,14019,12258,26277,2
2022-02-09,1호선,서울역,38756,36031,74787,2
2022-02-09,2호선,잠실(송파구청),62171,61072,123243,2
2022-02-09,2호선,선릉,55563,49450,105013,2
2022-02-09,2호선,강남,80793,78754,159547,2
2022-02-09,2호선,사당,33853,36663,70516,2
2022-02-09,2호선,신림,60056,58673,118729,2
2022-02-09,2호선,구로디지털단지,57693,57766,115459,2
2022-02-09,2호선,홍대입구,47562,48334,95896,2
2022-02-09,3호선,고속터미널,34197,32273,66470,2
2022-02-09,4호선,서울역,10314,14148,24462,2
2022-02-09,4호선,사당,23071,18893,41964,2
2022-02-09,7호선,고속터미널,13854,12228,26082,2
2022-02-09,7호선,가산디지털단지,45828,45986,91814,2
2022-02-09,8호선,잠실(송파구청),12994,14737,27731,2
2022-02-09,9호선,고속터미널,10703,13862,24565,2
2022-02-09,경부선,서울역,4833,1582,6415,2
2022-02-09,경부선,가산디지털단지,18108,20828,38936,2
2022-02-09,경의선,서울역,3974,5071,9045,2
2022-02-09,경의선,홍대입구,1541,1753,3294,2
2022-02-09,공항철도 1호선,서울역,6481,5892,12373,2
2022-02-09,공항철도 1호선,홍대입구,8545,8595,17140,2
2022-02-09,분당선,선릉,13323,19901,33224,2
2022-02-10,2호선,사당,34149,37006,71155,2
2022-02-10,2호선,신림,59971,58842,118813,2
2022-02-10,2호선,구로디지털단지,57568,57393,114961,2
2022-02-10,2호선,홍대입구,48587,49601,98188,2
2022-02-10,3호선,고속터미널,35373,33881,69254,2
2022-02-10,4호선,서울역,10352,14458,24810,2
2022-02-10,4호선,사당,22936,18752,41688,2
2022-02-10,7호선,고속터미널,14423,12341,26764,2
2022-02-10,7호선,가산디지털단지,45189,45586,90775,2
2022-02-10,8호선,잠실(송파구청),13058,15079,28137,2
2022-02-10,9호선,고속터미널,10856,14102,24958,2
2022-02-10,공항철도 1호선,홍대입구,8764,8731,17495,2
2022-02-10,분당선,선릉,13283,19651,32934,2
2022-02-10,경부선,서울역,5090,1697,6787,2
2022-02-10,경부선,가산디지털단지,18166,20646,38812,2
2022-02-10,경의선,서울역,3995,4993,8988,2
2022-02-10,경의선,홍대입구,1604,1748,3352,2
2022-02-10,공항철도 1호선,서울역,6590,6093,12683,2
2022-02-10,1호선,서울역,38849,36875,75724,2
2022-02-10,2호선,잠실(송파구청),62478,61855,124333,2
2022-02-10,2호선,선릉,55193,49160,104353,2
2022-02-10,2호선,강남,81452,79256,160708,2
2022-02-11,1호선,서울역,42390,40709,83099,2
2022-02-11,2호선,잠실(송파구청),64495,63428,127923,2
2022-02-11,2호선,선릉,54004,47922,101926,2
2022-02-11,2호선,강남,84950,82108,167058,2
2022-02-11,2호선,사당,36029,38715,74744,2
2022-02-11,2호선,신림,61018,59648,120666,2
2022-02-11,2호선,구로디지털단지,57367,57129,114496,2
2022-02-11,2호선,홍대입구,52112,53663,105775,2
2022-02-11,3호선,고속터미널,40286,40598,80884,2
2022-02-11,4호선,서울역,10222,15426,25648,2
2022-02-11,4호선,사당,24422,20062,44484,2
2022-02-11,7호선,고속터미널,15520,12987,28507,2
2022-02-11,7호선,가산디지털단지,44501,44232,88733,2
2022-02-11,8호선,잠실(송파구청),13823,15986,29809,2
2022-02-11,9호선,고속터미널,11800,15952,27752,2
2022-02-11,경부선,서울역,6679,2199,8878,2
2022-02-11,경부선,가산디지털단지,17523,20217,37740,2
2022-02-11,경의선,서울역,3986,4908,8894,2
2022-02-11,경의선,홍대입구,1644,1940,3584,2
2022-02-11,공항철도 1호선,서울역,8091,7482,15573,2
2022-02-11,공항철도 1호선,홍대입구,9648,9551,19199,2
2022-02-11,분당선,선릉,13050,19448,32498,2
2022-02-12,1호선,서울역,25027,25115,50142,2
2022-02-12,2호선,잠실(송파구청),54470,51844,106314,2
2022-02-12,2호선,선릉,21814,19482,41296,2
2022-02-12,2호선,강남,56473,55193,111666,2
2022-02-12,2호선,사당,27458,29598,57056,2
2022-02-12,2호선,신림,45930,44514,90444,2
2022-02-12,2호선,구로디지털단지,31094,30496,61590,2
2022-02-12,2호선,홍대입구,54688,57313,112001,2
2022-02-12,3호선,고속터미널,40908,40316,81224,2
2022-02-12,4호선,서울역,4896,10154,15050,2
2022-02-12,4호선,사당,18091,16036,34127,2
2022-02-12,7호선,고속터미널,12024,9659,21683,2
2022-02-12,7호선,가산디지털단지,12964,11781,24745,2
2022-02-12,8호선,잠실(송파구청),10971,12733,23704,2
2022-02-12,9호선,고속터미널,10135,14510,24645,2
2022-02-12,경부선,서울역,5309,1663,6972,2
2022-02-12,경부선,가산디지털단지,5732,7490,13222,2
2022-02-12,경의선,서울역,1012,1164,2176,2
2022-02-12,경의선,홍대입구,1636,2019,3655,2
2022-02-12,공항철도 1호선,서울역,6125,6014,12139,2
2022-02-12,공항철도 1호선,홍대입구,10652,10230,20882,2
2022-02-12,분당선,선릉,4423,6958,11381,2
2022-02-13,분당선,선릉,2503,3823,6326,2
2022-02-13,공항철도 1호선,홍대입구,8616,7870,16486,2
2022-02-13,공항철도 1호선,서울역,6022,5271,11293,2
2022-02-13,경의선,홍대입구,1343,1619,2962,2
2022-02-13,경의선,서울역,891,830,1721,2
2022-02-13,경부선,가산디지털단지,3900,5398,9298,2
2022-02-13,경부선,서울역,5501,1437,6938,2
2022-02-13,9호선,고속터미널,7901,10868,18769,2
2022-02-13,8호선,잠실(송파구청),8315,9247,17562,2
2022-02-13,7호선,가산디지털단지,8787,8224,17011,2
2022-02-13,7호선,고속터미널,9597,6754,16351,2
2022-02-13,4호선,사당,13105,12404,25509,2
2022-02-13,4호선,서울역,3583,7723,11306,2
2022-02-13,1호선,서울역,21053,19161,40214,2
2022-02-13,3호선,고속터미널,32390,30857,63247,2
2022-02-13,2호선,홍대입구,42621,42157,84778,2
2022-02-13,2호선,구로디지털단지,21156,20821,41977,2
2022-02-13,2호선,신림,34033,33376,67409,2
2022-02-13,2호선,사당,18728,20722,39450,2
2022-02-13,2호선,강남,31158,29861,61019,2
2022-02-13,2호선,선릉,11862,10287,22149,2
2022-02-13,2호선,잠실(송파구청),40336,37898,78234,2
2022-02-14,1호선,서울역,38551,37346,75897,2
2022-02-14,2호선,잠실(송파구청),60655,60024,120679,2
2022-02-14,2호선,선릉,54957,48573,103530,2
2022-02-14,2호선,강남,81670,79216,160886,2
2022-02-14,2호선,사당,32392,35436,67828,2
2022-02-14,2호선,신림,59025,58014,117039,2
2022-02-14,2호선,구로디지털단지,56942,56942,113884,2
2022-02-14,2호선,홍대입구,47712,47632,95344,2
2022-02-14,3호선,고속터미널,36180,34149,70329,2
2022-02-14,4호선,서울역,10281,14493,24774,2
2022-02-14,4호선,사당,22395,18018,40413,2
2022-02-14,7호선,고속터미널,14702,12045,26747,2
2022-02-14,7호선,가산디지털단지,45973,45137,91110,2
2022-02-14,8호선,잠실(송파구청),12997,14865,27862,2
2022-02-14,9호선,고속터미널,10697,13743,24440,2
2022-02-14,경부선,서울역,5458,1866,7324,2
2022-02-14,경부선,가산디지털단지,17782,20828,38610,2
2022-02-14,경의선,서울역,4011,4998,9009,2
2022-02-14,경의선,홍대입구,1370,1685,3055,2
2022-02-14,공항철도 1호선,서울역,6594,6232,12826,2
2022-02-14,공항철도 1호선,홍대입구,8463,8608,17071,2
2022-02-14,분당선,선릉,13277,19777,33054,2
2022-02-15,분당선,선릉,13124,19469,32593,2
2022-02-15,공항철도 1호선,홍대입구,8517,8350,16867,2
2022-02-15,공항철도 1호선,서울역,6531,5836,12367,2
2022-02-15,1호선,서울역,37878,35755,73633,2
2022-02-15,2호선,잠실(송파구청),60615,59665,120280,2
2022-02-15,2호선,선릉,54245,48213,102458,2
2022-02-15,2호선,강남,81470,79470,160940,2
2022-02-15,2호선,사당,33442,36121,69563,2
2022-02-15,2호선,신림,58894,57889,116783,2
2022-02-15,2호선,구로디지털단지,56791,56963,113754,2
2022-02-15,2호선,홍대입구,47219,47933,95152,2
2022-02-15,3호선,고속터미널,35307,33400,68707,2
2022-02-15,4호선,서울역,10264,14269,24533,2
2022-02-15,4호선,사당,22938,18619,41557,2
2022-02-15,7호선,고속터미널,14125,12304,26429,2
2022-02-15,7호선,가산디지털단지,45454,45182,90636,2
2022-02-15,8호선,잠실(송파구청),12747,14491,27238,2
2022-02-15,9호선,고속터미널,11002,14223,25225,2
2022-02-15,경부선,서울역,5031,1738,6769,2
2022-02-15,경부선,가산디지털단지,17456,20257,37713,2
2022-02-15,경의선,서울역,3874,4931,8805,2
2022-02-15,경의선,홍대입구,1415,1553,2968,2
2022-02-16,4호선,서울역,10086,14144,24230,2
2022-02-16,3호선,고속터미널,33970,32435,66405,2
2022-02-16,2호선,선릉,53404,47312,100716,2
2022-02-16,2호선,강남,79564,76984,156548,2
2022-02-16,2호선,사당,32536,35591,68127,2
2022-02-16,2호선,신림,58368,57528,115896,2
2022-02-16,2호선,구로디지털단지,55296,55366,110662,2
2022-02-16,2호선,홍대입구,47052,47373,94425,2
2022-02-16,4호선,사당,22322,18015,40337,2
2022-02-16,1호선,서울역,37631,35674,73305,2
2022-02-16,2호선,잠실(송파구청),60141,59357,119498,2
2022-02-16,7호선,고속터미널,13860,11724,25584,2
2022-02-16,7호선,가산디지털단지,44801,44509,89310,2
2022-02-16,8호선,잠실(송파구청),12749,14660,27409,2
2022-02-16,9호선,고속터미널,10268,13200,23468,2
2022-02-16,경부선,서울역,4984,1709,6693,2
2022-02-16,경부선,가산디지털단지,17053,19859,36912,2
2022-02-16,경의선,서울역,3769,4778,8547,2
2022-02-16,경의선,홍대입구,1377,1526,2903,2
2022-02-16,공항철도 1호선,서울역,6423,5892,12315,2
2022-02-16,공항철도 1호선,홍대입구,8247,8264,16511,2
2022-02-16,분당선,선릉,12944,19116,32060,2
2022-02-17,공항철도 1호선,홍대입구,8724,8710,17434,2
2022-02-17,공항철도 1호선,서울역,6530,6052,12582,2
2022-02-17,경의선,홍대입구,1452,1683,3135,2
2022-02-17,경의선,서울역,3897,4697,8594,2
2022-02-17,경부선,가산디지털단지,16651,19490,36141,2
2022-02-17,경부선,서울역,5220,1814,7034,2
2022-02-17,9호선,고속터미널,10698,14111,24809,2
2022-02-17,8호선,잠실(송파구청),12578,14230,26808,2
2022-02-17,7호선,가산디지털단지,43901,43706,87607,2
2022-02-17,7호선,고속터미널,13988,11786,25774,2
2022-02-17,4호선,사당,22092,18049,40141,2
2022-02-17,4호선,서울역,9891,14218,24109,2
2022-02-17,3호선,고속터미널,34501,33436,67937,2
2022-02-17,2호선,홍대입구,48272,49268,97540,2
2022-02-17,2호선,구로디지털단지,55250,55199,110449,2
2022-02-17,2호선,신림,57920,56944,114864,2
2022-02-17,2호선,사당,32389,34992,67381,2
2022-02-17,2호선,강남,78622,76462,155084,2
2022-02-17,2호선,선릉,52863,46596,99459,2
2022-02-17,2호선,잠실(송파구청),59181,58927,118108,2
2022-02-17,1호선,서울역,37548,35823,73371,2
2022-02-17,분당선,선릉,12883,18879,31762,2
2022-02-18,1호선,서울역,41323,39749,81072,2
2022-02-18,2호선,잠실(송파구청),61090,60243,121333,2
2022-02-18,2호선,선릉,52462,46359,98821,2
2022-02-18,2호선,강남,81098,78943,160041,2
2022-02-18,9호선,고속터미널,11240,15416,26656,2
2022-02-18,8호선,잠실(송파구청),12830,14847,27677,2
2022-02-18,7호선,가산디지털단지,42660,42256,84916,2
2022-02-18,7호선,고속터미널,15495,12599,28094,2
2022-02-18,4호선,사당,23318,19142,42460,2
2022-02-18,4호선,서울역,10095,15594,25689,2
2022-02-18,경부선,서울역,6866,2298,9164,2
2022-02-18,경부선,가산디지털단지,17015,19532,36547,2
2022-02-18,3호선,고속터미널,38217,39537,77754,2
2022-02-18,2호선,사당,33880,36512,70392,2
2022-02-18,2호선,신림,59778,58288,118066,2
2022-02-18,2호선,구로디지털단지,55548,55247,110795,2
2022-02-18,2호선,홍대입구,51581,53484,105065,2
2022-02-18,분당선,선릉,12584,18776,31360,2
2022-02-18,공항철도 1호선,홍대입구,9675,9806,19481,2
2022-02-18,공항철도 1호선,서울역,7862,7445,15307,2
2022-02-18,경의선,서울역,3911,5030,8941,2
2022-02-18,경의선,홍대입구,1635,1840,3475,2
2022-02-19,1호선,서울역,24632,25055,49687,2
2022-02-19,4호선,사당,17984,15397,33381,2
2022-02-19,4호선,서울역,4755,10265,15020,2
2022-02-19,2호선,홍대입구,56618,57933,114551,2
2022-02-19,2호선,구로디지털단지,30741,30162,60903,2
2022-02-19,2호선,신림,45906,44861,90767,2
2022-02-19,2호선,사당,26527,29203,55730,2
2022-02-19,2호선,강남,55961,54330,110291,2
2022-02-19,2호선,선릉,22045,19722,41767,2
2022-02-19,2호선,잠실(송파구청),51976,49839,101815,2
2022-02-19,3호선,고속터미널,39193,39028,78221,2
2022-02-19,분당선,선릉,4754,7400,12154,2
2022-02-19,공항철도 1호선,홍대입구,10320,10264,20584,2
2022-02-19,공항철도 1호선,서울역,6170,6026,12196,2
2022-02-19,경의선,홍대입구,1487,1983,3470,2
2022-02-19,경의선,서울역,975,1085,2060,2
2022-02-19,경부선,가산디지털단지,5354,7335,12689,2
2022-02-19,경부선,서울역,5545,1613,7158,2
2022-02-19,9호선,고속터미널,9526,13993,23519,2
2022-02-19,8호선,잠실(송파구청),11153,12641,23794,2
2022-02-19,7호선,가산디지털단지,12962,11635,24597,2
2022-02-19,7호선,고속터미널,12008,9188,21196,2
2022-02-20,분당선,선릉,2384,3797,6181,2
2022-02-20,공항철도 1호선,홍대입구,8405,7626,16031,2
2022-02-20,공항철도 1호선,서울역,5989,5078,11067,2
2022-02-20,4호선,서울역,3368,7824,11192,2
2022-02-20,4호선,사당,12535,11676,24211,2
2022-02-20,7호선,고속터미널,9251,6244,15495,2
2022-02-20,7호선,가산디지털단지,8379,7769,16148,2
2022-02-20,8호선,잠실(송파구청),8618,9601,18219,2
2022-02-20,9호선,고속터미널,7604,10545,18149,2
2022-02-20,경부선,서울역,6055,1472,7527,2
2022-02-20,경부선,가산디지털단지,3766,5189,8955,2
2022-02-20,경의선,홍대입구,1177,1466,2643,2
2022-02-20,경의선,서울역,760,772,1532,2
2022-02-20,3호선,고속터미널,31301,29308,60609,2
2022-02-20,2호선,홍대입구,42342,41503,83845,2
2022-02-20,2호선,구로디지털단지,20605,20291,40896,2
2022-02-20,2호선,신림,32588,32252,64840,2
2022-02-20,2호선,사당,18092,19807,37899,2
2022-02-20,2호선,강남,30478,28782,59260,2
2022-02-20,2호선,선릉,11645,9979,21624,2
2022-02-20,2호선,잠실(송파구청),39360,36497,75857,2
2022-02-20,1호선,서울역,21179,19303,40482,2
2022-02-21,경의선,홍대입구,1386,1688,3074,2
2022-02-21,경의선,서울역,3812,4764,8576,2
2022-02-21,4호선,서울역,9854,14002,23856,2
2022-02-21,4호선,사당,21432,17555,38987,2
2022-02-21,경부선,가산디지털단지,17362,20126,37488,2
2022-02-21,경부선,서울역,5605,1819,7424,2
2022-02-21,9호선,고속터미널,10216,13025,23241,2
2022-02-21,7호선,고속터미널,14185,11657,25842,2
2022-02-21,7호선,가산디지털단지,44242,44035,88277,2
2022-02-21,8호선,잠실(송파구청),12419,14192,26611,2
2022-02-21,분당선,선릉,12507,18872,31379,2
2022-02-21,공항철도 1호선,홍대입구,8381,8293,16674,2
2022-02-21,공항철도 1호선,서울역,6618,6152,12770,2
2022-02-21,3호선,고속터미널,33338,31632,64970,2
2022-02-21,2호선,홍대입구,46260,47146,93406,2
2022-02-21,2호선,구로디지털단지,55051,55122,110173,2
2022-02-21,2호선,신림,57564,56716,114280,2
2022-02-21,2호선,사당,31136,34118,65254,2
2022-02-21,2호선,강남,78182,76458,154640,2
2022-02-21,2호선,선릉,53178,46813,99991,2
2022-02-21,2호선,잠실(송파구청),57702,57424,115126,2
2022-02-21,1호선,서울역,37553,36039,73592,2
2022-02-22,2호선,구로디지털단지,55154,55393,110547,2
2022-02-22,2호선,홍대입구,46931,47679,94610,2
2022-02-22,3호선,고속터미널,33806,32433,66239,2
2022-02-22,4호선,서울역,10022,14205,24227,2
2022-02-22,4호선,사당,22514,18066,40580,2
2022-02-22,분당선,선릉,12881,18950,31831,2
2022-02-22,공항철도 1호선,홍대입구,8254,8293,16547,2
2022-02-22,공항철도 1호선,서울역,6419,5776,12195,2
2022-02-22,경의선,홍대입구,1421,1632,3053,2
2022-02-22,경의선,서울역,3680,4722,8402,2
2022-02-22,2호선,잠실(송파구청),59771,58955,118726,2
2022-02-22,2호선,선릉,52905,47135,100040,2
2022-02-22,2호선,강남,78965,77437,156402,2
2022-02-22,2호선,사당,32628,35529,68157,2
2022-02-22,2호선,신림,58060,56323,114383,2
2022-02-22,1호선,서울역,37054,35325,72379,2
2022-02-22,경부선,가산디지털단지,16827,19814,36641,2
2022-02-22,경부선,서울역,4957,1720,6677,2
2022-02-22,9호선,고속터미널,10374,13315,23689,2
2022-02-22,8호선,잠실(송파구청),12557,14308,26865,2
2022-02-22,7호선,가산디지털단지,44263,44012,88275,2
2022-02-22,7호선,고속터미널,13668,11529,25197,2
2022-02-23,분당선,선릉,12636,18793,31429,2
2022-02-23,공항철도 1호선,홍대입구,8317,8434,16751,2
2022-02-23,공항철도 1호선,서울역,6524,5994,12518,2
2022-02-23,경의선,홍대입구,1468,1615,3083,2
2022-02-23,경의선,서울역,3761,4753,8514,2
2022-02-23,경부선,가산디지털단지,16793,19594,36387,2
2022-02-23,경부선,서울역,5055,1614,6669,2
2022-02-23,9호선,고속터미널,10101,13060,23161,2
2022-02-23,8호선,잠실(송파구청),12328,14154,26482,2
2022-02-23,7호선,가산디지털단지,43450,43290,86740,2
2022-02-23,7호선,고속터미널,13379,11304,24683,2
2022-02-23,4호선,사당,21839,17950,39789,2
2022-02-23,4호선,서울역,10152,14360,24512,2
2022-02-23,3호선,고속터미널,32901,31693,64594,2
2022-02-23,2호선,홍대입구,47109,47872,94981,2
2022-02-23,2호선,구로디지털단지,54723,54510,109233,2
2022-02-23,2호선,신림,58008,56883,114891,2
2022-02-23,2호선,사당,32266,35367,67633,2
2022-02-23,2호선,강남,77492,74922,152414,2
2022-02-23,2호선,선릉,52741,46502,99243,2
2022-02-23,2호선,잠실(송파구청),58463,57745,116208,2
2022-02-23,1호선,서울역,37127,35236,72363,2
2022-02-24,분당선,선릉,12525,18608,31133,2
2022-02-24,공항철도 1호선,홍대입구,8801,8530,17331,2
2022-02-24,1호선,서울역,37837,35692,73529,2
2022-02-24,2호선,잠실(송파구청),58624,58158,116782,2
2022-02-24,2호선,선릉,52319,46189,98508,2
2022-02-24,2호선,강남,78049,75887,153936,2
2022-02-24,2호선,사당,32650,35319,67969,2
2022-02-24,2호선,신림,58164,57098,115262,2
2022-02-24,2호선,구로디지털단지,54452,54816,109268,2
2022-02-24,2호선,홍대입구,47853,49300,97153,2
2022-02-24,3호선,고속터미널,33755,32848,66603,2
2022-02-24,4호선,서울역,9927,14091,24018,2
2022-02-24,4호선,사당,21720,17985,39705,2
2022-02-24,공항철도 1호선,서울역,6478,5955,12433,2
2022-02-24,경의선,홍대입구,1459,1704,3163,2
2022-02-24,경의선,서울역,3706,4872,8578,2
2022-02-24,7호선,고속터미널,13729,11804,25533,2
2022-02-24,7호선,가산디지털단지,42963,43060,86023,2
2022-02-24,8호선,잠실(송파구청),12235,14151,26386,2
2022-02-24,9호선,고속터미널,10291,13409,23700,2
2022-02-24,경부선,서울역,5343,1775,7118,2
2022-02-24,경부선,가산디지털단지,16783,19393,36176,2
2022-02-25,1호선,서울역,41491,40496,81987,2
2022-02-25,2호선,잠실(송파구청),61029,60105,121134,2
2022-02-25,2호선,선릉,51910,45918,97828,2
2022-02-25,2호선,강남,81528,79636,161164,2
2022-02-25,2호선,사당,33974,36946,70920,2
2022-02-25,2호선,신림,60347,58809,119156,2
2022-02-25,2호선,구로디지털단지,55205,55226,110431,2
2022-02-25,2호선,홍대입구,52009,54886,106895,2
2022-02-25,3호선,고속터미널,38343,40062,78405,2
2022-02-25,4호선,서울역,10042,15864,25906,2
2022-02-25,4호선,사당,23278,19239,42517,2
2022-02-25,7호선,고속터미널,15363,12616,27979,2
2022-02-25,7호선,가산디지털단지,42415,41901,84316,2
2022-02-25,8호선,잠실(송파구청),12862,14837,27699,2
2022-02-25,9호선,고속터미널,11444,15732,27176,2
2022-02-25,경부선,서울역,7073,2446,9519,2
2022-02-25,경부선,가산디지털단지,17081,19473,36554,2
2022-02-25,경의선,서울역,3806,4971,8777,2
2022-02-25,경의선,홍대입구,1637,1916,3553,2
2022-02-25,공항철도 1호선,서울역,7901,7542,15443,2
2022-02-25,공항철도 1호선,홍대입구,9456,9620,19076,2
2022-02-25,분당선,선릉,12494,18497,30991,2
2022-02-26,4호선,서울역,4564,10430,14994,2
2022-02-26,4호선,사당,17491,15025,32516,2
2022-02-26,2호선,구로디지털단지,29237,28823,58060,2
2022-02-26,2호선,신림,44630,42885,87515,2
2022-02-26,2호선,사당,25301,27660,52961,2
2022-02-26,2호선,강남,53607,51737,105344,2
2022-02-26,2호선,선릉,21019,18497,39516,2
2022-02-26,2호선,잠실(송파구청),50751,48389,99140,2
2022-02-26,2호선,홍대입구,51026,52844,103870,2
2022-02-26,3호선,고속터미널,37745,38612,76357,2
2022-02-26,분당선,선릉,4447,6896,11343,2
2022-02-26,공항철도 1호선,홍대입구,9529,9338,18867,2
2022-02-26,공항철도 1호선,서울역,5998,6269,12267,2
2022-02-26,1호선,서울역,24750,25357,50107,2
2022-02-26,경의선,홍대입구,1452,1839,3291,2
2022-02-26,경의선,서울역,1007,1099,2106,2
2022-02-26,경부선,가산디지털단지,5360,6840,12200,2
2022-02-26,경부선,서울역,5273,1741,7014,2
2022-02-26,9호선,고속터미널,9594,14169,23763,2
2022-02-26,8호선,잠실(송파구청),10614,11934,22548,2
2022-02-26,7호선,가산디지털단지,12214,11223,23437,2
2022-02-26,7호선,고속터미널,11692,8780,20472,2
2022-02-27,2호선,선릉,11906,10200,22106,2
2022-02-27,2호선,강남,30527,29407,59934,2
2022-02-27,2호선,사당,18450,20369,38819,2
2022-02-27,2호선,신림,33965,33011,66976,2
2022-02-27,2호선,구로디지털단지,20228,19979,40207,2
2022-02-27,2호선,홍대입구,43505,43068,86573,2
2022-02-27,3호선,고속터미널,31987,30119,62106,2
2022-02-27,분당선,선릉,2457,3758,6215,2
2022-02-27,공항철도 1호선,홍대입구,8805,8148,16953,2
2022-02-27,공항철도 1호선,서울역,5997,5252,11249,2
2022-02-27,경의선,홍대입구,1376,1632,3008,2
2022-02-27,경의선,서울역,776,849,1625,2
2022-02-27,경부선,가산디지털단지,3984,5401,9385,2
2022-02-27,경부선,서울역,5754,1376,7130,2
2022-02-27,9호선,고속터미널,7870,10744,18614,2
2022-02-27,8호선,잠실(송파구청),8273,9431,17704,2
2022-02-27,7호선,가산디지털단지,8889,8042,16931,2
2022-02-27,7호선,고속터미널,9249,6512,15761,2
2022-02-27,4호선,사당,12723,11723,24446,2
2022-02-27,4호선,서울역,3634,8102,11736,2
2022-02-27,1호선,서울역,21220,19479,40699,2
2022-02-27,2호선,잠실(송파구청),40936,38328,79264,2
2022-02-28,3호선,고속터미널,35460,34105,69565,2
2022-02-28,1호선,서울역,37038,34360,71398,2
2022-02-28,2호선,잠실(송파구청),58643,57996,116639,2
2022-02-28,2호선,선릉,47826,42385,90211,2
2022-02-28,2호선,강남,75033,73663,148696,2
2022-02-28,2호선,사당,30262,34022,64284,2
2022-02-28,2호선,신림,56674,55484,112158,2
2022-02-28,2호선,구로디지털단지,51012,51081,102093,2
2022-02-28,4호선,서울역,9153,13347,22500,2
2022-02-28,4호선,사당,20580,17270,37850,2
2022-02-28,7호선,고속터미널,13962,11511,25473,2
2022-02-28,7호선,가산디지털단지,37320,37388,74708,2
2022-02-28,8호선,잠실(송파구청),11947,14031,25978,2
2022-02-28,9호선,고속터미널,10478,13604,24082,2
2022-02-28,경부선,서울역,5715,1701,7416,2
2022-02-28,경부선,가산디지털단지,15218,17670,32888,2
2022-02-28,경의선,서울역,3487,4655,8142,2
2022-02-28,경의선,홍대입구,1489,1715,3204,2
2022-02-28,공항철도 1호선,서울역,6580,5982,12562,2
2022-02-28,공항철도 1호선,홍대입구,8813,8694,17507,2
2022-02-28,분당선,선릉,11164,16901,28065,2
2022-02-28,2호선,홍대입구,48847,50982,99829,2
2022-03-01,9호선,고속터미널,7516,9974,17490,3
2022-03-01,8호선,잠실(송파구청),9265,10208,19473,3
2022-03-01,7호선,가산디지털단지,10716,9956,20672,3
2022-03-01,7호선,고속터미널,8026,5894,13920,3
2022-03-01,4호선,사당,12251,11388,23639,3
2022-03-01,4호선,서울역,3553,6516,10069,3
2022-03-01,3호선,고속터미널,30301,28148,58449,3
2022-03-01,2호선,홍대입구,42527,41933,84460,3
2022-03-01,2호선,구로디지털단지,23568,23549,47117,3
2022-03-01,2호선,신림,35239,34577,69816,3
2022-03-01,2호선,사당,18745,20100,38845,3
2022-03-01,2호선,강남,33706,32061,65767,3
2022-03-01,2호선,선릉,13795,12306,26101,3
2022-03-01,분당선,선릉,2849,4315,7164,3
2022-03-01,2호선,잠실(송파구청),40025,37905,77930,3
2022-03-01,1호선,서울역,20994,19468,40462,3
2022-03-01,경부선,서울역,4651,1010,5661,3
2022-03-01,경부선,가산디지털단지,4484,6051,10535,3
2022-03-01,경의선,서울역,1022,940,1962,3
2022-03-01,경의선,홍대입구,1265,1515,2780,3
2022-03-01,공항철도 1호선,서울역,5149,4512,9661,3
2022-03-01,공항철도 1호선,홍대입구,7856,7415,15271,3
2022-03-02,1호선,서울역,35974,34212,70186,3
2022-03-02,2호선,잠실(송파구청),56221,56212,112433,3
2022-03-02,2호선,선릉,52126,46172,98298,3
2022-03-02,2호선,강남,72534,70880,143414,3
2022-03-02,2호선,사당,31227,34395,65622,3
2022-03-02,2호선,신림,58677,57204,115881,3
2022-03-02,2호선,구로디지털단지,54471,54487,108958,3
2022-03-02,2호선,홍대입구,45184,46208,91392,3
2022-03-02,3호선,고속터미널,31943,29794,61737,3
2022-03-02,4호선,서울역,10016,13181,23197,3
2022-03-02,4호선,사당,21466,18076,39542,3
2022-03-02,7호선,고속터미널,13297,11386,24683,3
2022-03-02,7호선,가산디지털단지,43458,43317,86775,3
2022-03-02,8호선,잠실(송파구청),11955,13670,25625,3
2022-03-02,9호선,고속터미널,9913,12483,22396,3
2022-03-02,경부선,서울역,4541,1604,6145,3
2022-03-02,경부선,가산디지털단지,17280,19947,37227,3
2022-03-02,경의선,서울역,3951,5076,9027,3
2022-03-02,경의선,홍대입구,1459,1670,3129,3
2022-03-02,공항철도 1호선,서울역,5936,5607,11543,3
2022-03-02,공항철도 1호선,홍대입구,7776,7566,15342,3
2022-03-02,분당선,선릉,12480,18669,31149,3
2022-03-03,9호선,고속터미널,9975,12215,22190,3
2022-03-03,8호선,잠실(송파구청),11661,13480,25141,3
2022-03-03,7호선,가산디지털단지,43370,43263,86633,3
2022-03-03,7호선,고속터미널,13607,11807,25414,3
2022-03-03,4호선,사당,22036,18280,40316,3
2022-03-03,4호선,서울역,9782,13022,22804,3
2022-03-03,3호선,고속터미널,31939,30518,62457,3
2022-03-03,1호선,서울역,35847,34633,70480,3
2022-03-03,2호선,홍대입구,45627,46964,92591,3
2022-03-03,2호선,구로디지털단지,55097,55138,110235,3
2022-03-03,2호선,신림,58697,57185,115882,3
2022-03-03,2호선,사당,32221,35008,67229,3
2022-03-03,2호선,강남,72584,71204,143788,3
2022-03-03,2호선,선릉,51931,46305,98236,3
2022-03-03,2호선,잠실(송파구청),55247,55030,110277,3
2022-03-03,경부선,서울역,4411,1488,5899,3
2022-03-03,경부선,가산디지털단지,17562,20324,37886,3
2022-03-03,경의선,서울역,4021,5022,9043,3
2022-03-03,경의선,홍대입구,1516,1655,3171,3
2022-03-03,공항철도 1호선,서울역,6293,5557,11850,3
2022-03-03,공항철도 1호선,홍대입구,7940,7608,15548,3
2022-03-03,분당선,선릉,12477,18605,31082,3
2022-03-04,분당선,선릉,12347,18563,30910,3
2022-03-04,공항철도 1호선,홍대입구,8740,8408,17148,3
2022-03-04,공항철도 1호선,서울역,8091,6852,14943,3
2022-03-04,경의선,홍대입구,1577,1904,3481,3
2022-03-04,경의선,서울역,3984,5005,8989,3
2022-03-04,경부선,가산디지털단지,17221,19840,37061,3
2022-03-04,경부선,서울역,5972,2168,8140,3
2022-03-04,9호선,고속터미널,11046,14500,25546,3
2022-03-04,8호선,잠실(송파구청),12331,14146,26477,3
2022-03-04,7호선,가산디지털단지,42554,42136,84690,3
2022-03-04,7호선,고속터미널,15115,12392,27507,3
2022-03-04,4호선,사당,22912,18808,41720,3
2022-03-04,4호선,서울역,9723,14644,24367,3
2022-03-04,3호선,고속터미널,36618,37533,74151,3
2022-03-04,2호선,홍대입구,49339,52261,101600,3
2022-03-04,2호선,구로디지털단지,54687,54532,109219,3
2022-03-04,2호선,신림,59862,58228,118090,3
2022-03-04,2호선,사당,33602,36466,70068,3
2022-03-04,2호선,강남,78169,77067,155236,3
2022-03-04,2호선,선릉,51178,45268,96446,3
2022-03-04,2호선,잠실(송파구청),57734,57757,115491,3
2022-03-04,1호선,서울역,40023,38144,78167,3
2022-03-05,8호선,잠실(송파구청),10759,12490,23249,3
2022-03-05,분당선,선릉,4332,6823,11155,3
2022-03-05,공항철도 1호선,홍대입구,9352,9347,18699,3
2022-03-05,공항철도 1호선,서울역,5606,5457,11063,3
2022-03-05,경의선,홍대입구,1425,1828,3253,3
2022-03-05,경의선,서울역,951,1041,1992,3
2022-03-05,경부선,가산디지털단지,5071,6980,12051,3
2022-03-05,경부선,서울역,4392,1366,5758,3
2022-03-05,9호선,고속터미널,9486,13089,22575,3
2022-03-05,1호선,서울역,23365,23142,46507,3
2022-03-05,2호선,잠실(송파구청),51503,49476,100979,3
2022-03-05,2호선,선릉,20725,18423,39148,3
2022-03-05,2호선,강남,53278,52967,106245,3
2022-03-05,2호선,사당,25401,27849,53250,3
2022-03-05,2호선,신림,44359,43111,87470,3
2022-03-05,2호선,구로디지털단지,29229,28783,58012,3
2022-03-05,2호선,홍대입구,53670,57034,110704,3
2022-03-05,3호선,고속터미널,37456,36942,74398,3
2022-03-05,4호선,서울역,4586,8949,13535,3
2022-03-05,4호선,사당,17153,14734,31887,3
2022-03-05,7호선,고속터미널,11086,8794,19880,3
2022-03-05,7호선,가산디지털단지,12445,11410,23855,3
2022-03-06,경의선,홍대입구,1293,1342,2635,3
2022-03-06,경의선,서울역,775,773,1548,3
2022-03-06,경부선,가산디지털단지,3753,5128,8881,3
2022-03-06,경부선,서울역,5130,1271,6401,3
2022-03-06,9호선,고속터미널,7497,10661,18158,3
2022-03-06,8호선,잠실(송파구청),8233,8988,17221,3
2022-03-06,7호선,가산디지털단지,8552,7911,16463,3
2022-03-06,7호선,고속터미널,8976,6248,15224,3
2022-03-06,4호선,사당,12107,11503,23610,3
2022-03-06,4호선,서울역,3413,7020,10433,3
2022-03-06,3호선,고속터미널,30602,29341,59943,3
2022-03-06,2호선,홍대입구,39802,39020,78822,3
2022-03-06,2호선,구로디지털단지,19549,18991,38540,3
2022-03-06,2호선,신림,33020,32543,65563,3
2022-03-06,2호선,사당,17694,19713,37407,3
2022-03-06,2호선,강남,29068,28236,57304,3
2022-03-06,2호선,선릉,11300,9734,21034,3
2022-03-06,2호선,잠실(송파구청),37927,35542,73469,3
2022-03-06,1호선,서울역,19236,18236,37472,3
2022-03-06,공항철도 1호선,홍대입구,7422,6967,14389,3
2022-03-06,공항철도 1호선,서울역,5384,5119,10503,3
2022-03-06,분당선,선릉,2497,3667,6164,3
2022-03-07,7호선,고속터미널,13814,11728,25542,3
2022-03-07,4호선,사당,21236,17897,39133,3
2022-03-07,4호선,서울역,9615,12948,22563,3
2022-03-07,3호선,고속터미널,31899,30352,62251,3
2022-03-07,2호선,홍대입구,44148,45357,89505,3
2022-03-07,2호선,구로디지털단지,53756,53663,107419,3
2022-03-07,2호선,신림,56843,55397,112240,3
2022-03-07,2호선,사당,31000,34017,65017,3
2022-03-07,2호선,강남,72968,71746,144714,3
2022-03-07,2호선,선릉,51428,45627,97055,3
2022-03-07,2호선,잠실(송파구청),52184,51924,104108,3
2022-03-07,1호선,서울역,35599,34253,69852,3
2022-03-07,9호선,고속터미널,9815,12342,22157,3
2022-03-07,경부선,서울역,4837,1554,6391,3
2022-03-07,경부선,가산디지털단지,17380,19949,37329,3
2022-03-07,경의선,서울역,3969,4976,8945,3
2022-03-07,경의선,홍대입구,1337,1468,2805,3
2022-03-07,공항철도 1호선,서울역,6029,5700,11729,3
2022-03-07,공항철도 1호선,홍대입구,7323,7250,14573,3
2022-03-07,분당선,선릉,12215,18580,30795,3
2022-03-07,7호선,가산디지털단지,43253,43276,86529,3
2022-03-07,8호선,잠실(송파구청),11149,12785,23934,3
2022-03-08,분당선,선릉,12257,18626,30883,3
2022-03-08,공항철도 1호선,홍대입구,8032,8454,16486,3
2022-03-08,공항철도 1호선,서울역,6668,5859,12527,3
2022-03-08,경의선,홍대입구,1611,1737,3348,3
2022-03-08,경의선,서울역,3922,4981,8903,3
2022-03-08,경부선,가산디지털단지,17239,19942,37181,3
2022-03-08,경부선,서울역,4958,1643,6601,3
2022-03-08,1호선,서울역,37193,35485,72678,3
2022-03-08,2호선,잠실(송파구청),57042,56755,113797,3
2022-03-08,2호선,선릉,51626,45986,97612,3
2022-03-08,2호선,강남,76264,75532,151796,3
2022-03-08,2호선,사당,33285,36955,70240,3
2022-03-08,2호선,신림,58736,57181,115917,3
2022-03-08,2호선,구로디지털단지,55178,55399,110577,3
2022-03-08,2호선,홍대입구,48958,51747,100705,3
2022-03-08,3호선,고속터미널,33295,32389,65684,3
2022-03-08,4호선,서울역,9953,13872,23825,3
2022-03-08,4호선,사당,22857,19284,42141,3
2022-03-08,7호선,고속터미널,13642,11961,25603,3
2022-03-08,7호선,가산디지털단지,42501,43029,85530,3
2022-03-08,8호선,잠실(송파구청),11915,13849,25764,3
2022-03-08,9호선,고속터미널,10193,12779,22972,3
2022-03-09,1호선,서울역,17151,16519,33670,3
2022-03-09,분당선,선릉,3203,4876,8079,3
2022-03-09,공항철도 1호선,홍대입구,8059,7505,15564,3
2022-03-09,공항철도 1호선,서울역,4126,3883,8009,3
2022-03-09,경의선,홍대입구,1324,1535,2859,3
2022-03-09,경의선,서울역,866,769,1635,3
2022-03-09,8호선,잠실(송파구청),8965,9831,18796,3
2022-03-09,7호선,가산디지털단지,10950,10190,21140,3
2022-03-09,7호선,고속터미널,7377,6005,13382,3
2022-03-09,4호선,사당,13180,12044,25224,3
2022-03-09,4호선,서울역,3553,6006,9559,3
2022-03-09,3호선,고속터미널,28527,26957,55484,3
2022-03-09,2호선,홍대입구,44230,44611,88841,3
2022-03-09,2호선,구로디지털단지,23835,23578,47413,3
2022-03-09,2호선,신림,37109,36490,73599,3
2022-03-09,2호선,사당,20341,21568,41909,3
2022-03-09,2호선,강남,36809,35716,72525,3
2022-03-09,2호선,선릉,15325,13660,28985,3
2022-03-09,2호선,잠실(송파구청),41635,39020,80655,3
2022-03-09,9호선,고속터미널,7589,10055,17644,3
2022-03-09,경부선,서울역,2980,877,3857,3
2022-03-09,경부선,가산디지털단지,4574,5965,10539,3
2022-03-10,경의선,홍대입구,1472,1620,3092,3
2022-03-10,경의선,서울역,3873,4847,8720,3
2022-03-10,경부선,가산디지털단지,16913,19495,36408,3
2022-03-10,경부선,서울역,4958,1654,6612,3
2022-03-10,9호선,고속터미널,10296,12878,23174,3
2022-03-10,8호선,잠실(송파구청),11168,13284,24452,3
2022-03-10,7호선,가산디지털단지,41606,41978,83584,3
2022-03-10,7호선,고속터미널,13591,11387,24978,3
2022-03-10,4호선,사당,21748,18059,39807,3
2022-03-10,4호선,서울역,9755,13229,22984,3
2022-03-10,3호선,고속터미널,32445,30256,62701,3
2022-03-10,2호선,홍대입구,44199,45487,89686,3
2022-03-10,2호선,구로디지털단지,53493,53393,106886,3
2022-03-10,2호선,신림,57375,55712,113087,3
2022-03-10,2호선,사당,31384,35042,66426,3
2022-03-10,2호선,강남,72596,71082,143678,3
2022-03-10,1호선,서울역,35453,34369,69822,3
2022-03-10,2호선,잠실(송파구청),58332,57823,116155,3
2022-03-10,2호선,선릉,50957,45451,96408,3
2022-03-10,분당선,선릉,12179,18058,30237,3
2022-03-10,공항철도 1호선,홍대입구,7769,7816,15585,3
2022-03-10,공항철도 1호선,서울역,6412,5753,12165,3
2022-03-11,분당선,선릉,12063,17950,30013,3
2022-03-11,공항철도 1호선,홍대입구,9076,9199,18275,3
2022-03-11,공항철도 1호선,서울역,7926,6942,14868,3
2022-03-11,경의선,홍대입구,1636,1826,3462,3
2022-03-11,경의선,서울역,4037,5062,9099,3
2022-03-11,경부선,가산디지털단지,16982,19469,36451,3
2022-03-11,경부선,서울역,6299,2171,8470,3
2022-03-11,9호선,고속터미널,11730,15190,26920,3
2022-03-11,8호선,잠실(송파구청),12135,14396,26531,3
2022-03-11,7호선,가산디지털단지,41232,41372,82604,3
2022-03-11,7호선,고속터미널,15334,12388,27722,3
2022-03-11,4호선,사당,22959,19560,42519,3
2022-03-11,4호선,서울역,9695,14807,24502,3
2022-03-11,3호선,고속터미널,37793,38573,76366,3
2022-03-11,2호선,홍대입구,50764,54827,105591,3
2022-03-11,2호선,구로디지털단지,53981,53923,107904,3
2022-03-11,2호선,신림,59125,57517,116642,3
2022-03-11,2호선,사당,33851,37200,71051,3
2022-03-11,2호선,강남,76815,76546,153361,3
2022-03-11,2호선,선릉,50874,45522,96396,3
2022-03-11,2호선,잠실(송파구청),59513,59605,119118,3
2022-03-11,1호선,서울역,39094,37789,76883,3
2022-03-12,분당선,선릉,4486,7054,11540,3
2022-03-12,공항철도 1호선,홍대입구,10207,9873,20080,3
2022-03-12,공항철도 1호선,서울역,5682,5759,11441,3
2022-03-12,경의선,홍대입구,1667,2093,3760,3
2022-03-12,경의선,서울역,1091,1080,2171,3
2022-03-12,경부선,가산디지털단지,5652,7514,13166,3
2022-03-12,경부선,서울역,5039,1441,6480,3
2022-03-12,9호선,고속터미널,10231,14534,24765,3
2022-03-12,1호선,서울역,23802,23666,47468,3
2022-03-12,8호선,잠실(송파구청),10990,12758,23748,3
2022-03-12,7호선,가산디지털단지,13250,12025,25275,3
2022-03-12,7호선,고속터미널,11677,8880,20557,3
2022-03-12,4호선,사당,18042,15414,33456,3
2022-03-12,4호선,서울역,4544,9569,14113,3
2022-03-12,3호선,고속터미널,39037,38442,77479,3
2022-03-12,2호선,홍대입구,56036,59447,115483,3
2022-03-12,2호선,구로디지털단지,29662,29334,58996,3
2022-03-12,2호선,신림,44440,42740,87180,3
2022-03-12,2호선,사당,26590,28963,55553,3
2022-03-12,2호선,강남,53990,53385,107375,3
2022-03-12,2호선,선릉,21517,18966,40483,3
2022-03-12,2호선,잠실(송파구청),57715,55148,112863,3
2022-03-13,분당선,선릉,2280,3521,5801,3
2022-03-13,공항철도 1호선,홍대입구,7190,6692,13882,3
2022-03-13,공항철도 1호선,서울역,5563,5228,10791,3
2022-03-13,경의선,홍대입구,1254,1456,2710,3
2022-03-13,경의선,서울역,790,703,1493,3
2022-03-13,경부선,가산디지털단지,3668,5025,8693,3
2022-03-13,경부선,서울역,5476,1341,6817,3
2022-03-13,9호선,고속터미널,7539,10986,18525,3
2022-03-13,8호선,잠실(송파구청),7696,8798,16494,3
2022-03-13,7호선,가산디지털단지,8107,7558,15665,3
2022-03-13,7호선,고속터미널,9146,6267,15413,3
2022-03-13,4호선,사당,11102,10312,21414,3
2022-03-13,4호선,서울역,3159,7026,10185,3
2022-03-13,3호선,고속터미널,30023,29525,59548,3
2022-03-13,2호선,홍대입구,36287,35864,72151,3
2022-03-13,2호선,구로디지털단지,18327,17857,36184,3
2022-03-13,2호선,신림,30308,29724,60032,3
2022-03-13,2호선,사당,15911,17879,33790,3
2022-03-13,2호선,강남,27954,26977,54931,3
2022-03-13,2호선,선릉,11581,9840,21421,3
2022-03-13,2호선,잠실(송파구청),38772,36676,75448,3
2022-03-13,1호선,서울역,19062,17541,36603,3
2022-03-14,3호선,고속터미널,31515,30225,61740,3
2022-03-14,4호선,서울역,9224,12607,21831,3
2022-03-14,4호선,사당,20728,17163,37891,3
2022-03-14,7호선,고속터미널,13272,11270,24542,3
2022-03-14,7호선,가산디지털단지,42023,41805,83828,3
2022-03-14,8호선,잠실(송파구청),11230,12942,24172,3
2022-03-14,9호선,고속터미널,9561,11949,21510,3
2022-03-14,경부선,서울역,4847,1699,6546,3
2022-03-14,경부선,가산디지털단지,16638,19177,35815,3
2022-03-14,경의선,서울역,3833,4746,8579,3
2022-03-14,경의선,홍대입구,1236,1403,2639,3
2022-03-14,공항철도 1호선,서울역,6014,5925,11939,3
2022-03-14,공항철도 1호선,홍대입구,7119,7240,14359,3
2022-03-14,분당선,선릉,11711,17793,29504,3
2022-03-14,1호선,서울역,34426,33042,67468,3
2022-03-14,2호선,잠실(송파구청),52060,52009,104069,3
2022-03-14,2호선,선릉,50108,44582,94690,3
2022-03-14,2호선,강남,70027,68675,138702,3
2022-03-14,2호선,사당,29571,32700,62271,3
2022-03-14,2호선,신림,54904,53723,108627,3
2022-03-14,2호선,구로디지털단지,52032,52064,104096,3
2022-03-14,2호선,홍대입구,41040,42160,83200,3
2022-03-15,1호선,서울역,34864,33272,68136,3
2022-03-15,2호선,홍대입구,44582,45758,90340,3
2022-03-15,3호선,고속터미널,31037,29692,60729,3
2022-03-15,4호선,서울역,9433,12555,21988,3
2022-03-15,4호선,사당,21649,17945,39594,3
2022-03-15,7호선,고속터미널,12850,11232,24082,3
2022-03-15,7호선,가산디지털단지,42021,42100,84121,3
2022-03-15,8호선,잠실(송파구청),11369,13072,24441,3
2022-03-15,9호선,고속터미널,9781,12016,21797,3
2022-03-15,경부선,서울역,4185,1481,5666,3
2022-03-15,경부선,가산디지털단지,16957,19518,36475,3
2022-03-15,경의선,서울역,3889,4986,8875,3
2022-03-15,경의선,홍대입구,1434,1577,3011,3
2022-03-15,공항철도 1호선,서울역,6051,5344,11395,3
2022-03-15,공항철도 1호선,홍대입구,7628,7742,15370,3
2022-03-15,분당선,선릉,12107,17967,30074,3
2022-03-15,2호선,잠실(송파구청),54671,54444,109115,3
2022-03-15,2호선,선릉,51149,45519,96668,3
2022-03-15,2호선,강남,72143,70514,142657,3
2022-03-15,2호선,사당,31500,34645,66145,3
2022-03-15,2호선,신림,56546,55274,111820,3
2022-03-15,2호선,구로디지털단지,53458,53276,106734,3
2022-03-16,4호선,사당,21550,18042,39592,3
2022-03-16,1호선,서울역,35130,33573,68703,3
2022-03-16,2호선,잠실(송파구청),56105,55314,111419,3
2022-03-16,2호선,선릉,50169,44512,94681,3
2022-03-16,2호선,강남,71378,69801,141179,3
2022-03-16,2호선,사당,31409,34539,65948,3
2022-03-16,2호선,신림,56908,55617,112525,3
2022-03-16,2호선,구로디지털단지,52719,52979,105698,3
2022-03-16,2호선,홍대입구,44533,46081,90614,3
2022-03-16,3호선,고속터미널,31214,29780,60994,3
2022-03-16,4호선,서울역,9569,13036,22605,3
2022-03-16,7호선,고속터미널,12596,11123,23719,3
2022-03-16,7호선,가산디지털단지,41229,41579,82808,3
2022-03-16,8호선,잠실(송파구청),11600,13366,24966,3
2022-03-16,9호선,고속터미널,10105,12362,22467,3
2022-03-16,경부선,서울역,4237,1486,5723,3
2022-03-16,경부선,가산디지털단지,16841,19260,36101,3
2022-03-16,경의선,서울역,3882,4947,8829,3
2022-03-16,경의선,홍대입구,1469,1624,3093,3
2022-03-16,공항철도 1호선,서울역,6031,5425,11456,3
2022-03-16,공항철도 1호선,홍대입구,7907,7760,15667,3
2022-03-16,분당선,선릉,11997,17878,29875,3
2022-03-17,1호선,서울역,35000,33191,68191,3
2022-03-17,2호선,잠실(송파구청),54150,54104,108254,3
2022-03-17,2호선,선릉,49977,44555,94532,3
2022-03-17,2호선,강남,71541,70061,141602,3
2022-03-17,2호선,사당,31298,34220,65518,3
2022-03-17,2호선,신림,56693,54964,111657,3
2022-03-17,2호선,구로디지털단지,52654,52454,105108,3
2022-03-17,2호선,홍대입구,45126,46404,91530,3
2022-03-17,3호선,고속터미널,31145,29889,61034,3
2022-03-17,4호선,서울역,9295,12764,22059,3
2022-03-17,4호선,사당,21643,17933,39576,3
2022-03-17,7호선,고속터미널,12988,10958,23946,3
2022-03-17,7호선,가산디지털단지,41169,41454,82623,3
2022-03-17,8호선,잠실(송파구청),11422,13052,24474,3
2022-03-17,경의선,서울역,3903,4870,8773,3
2022-03-17,경의선,홍대입구,1461,1653,3114,3
2022-03-17,9호선,고속터미널,9799,12017,21816,3
2022-03-17,공항철도 1호선,서울역,6352,5632,11984,3
2022-03-17,공항철도 1호선,홍대입구,7733,7699,15432,3
2022-03-17,분당선,선릉,11848,17685,29533,3
2022-03-17,경부선,서울역,4507,1557,6064,3
2022-03-17,경부선,가산디지털단지,16745,19064,35809,3
2022-03-18,9호선,고속터미널,11145,14415,25560,3
2022-03-18,1호선,서울역,38907,38083,76990,3
2022-03-18,8호선,잠실(송파구청),12044,13901,25945,3
2022-03-18,7호선,가산디지털단지,40265,39968,80233,3
2022-03-18,7호선,고속터미널,14675,11963,26638,3
2022-03-18,4호선,사당,22894,19027,41921,3
2022-03-18,4호선,서울역,9464,14573,24037,3
2022-03-18,3호선,고속터미널,37200,38152,75352,3
2022-03-18,2호선,홍대입구,51666,55207,106873,3
2022-03-18,2호선,구로디지털단지,53165,52680,105845,3
2022-03-18,2호선,신림,58419,56552,114971,3
2022-03-18,2호선,사당,32500,36174,68674,3
2022-03-18,2호선,강남,76775,76005,152780,3
2022-03-18,2호선,선릉,49494,43647,93141,3
2022-03-18,2호선,잠실(송파구청),57407,57338,114745,3
2022-03-18,분당선,선릉,11469,17584,29053,3
2022-03-18,공항철도 1호선,홍대입구,9121,9157,18278,3
2022-03-18,공항철도 1호선,서울역,7918,7077,14995,3
2022-03-18,경의선,홍대입구,1530,1760,3290,3
2022-03-18,경의선,서울역,3873,4993,8866,3
2022-03-18,경부선,가산디지털단지,16369,18739,35108,3
2022-03-18,경부선,서울역,6354,2323,8677,3
2022-03-19,분당선,선릉,4351,6754,11105,3
2022-03-19,공항철도 1호선,홍대입구,9375,9193,18568,3
2022-03-19,공항철도 1호선,서울역,5514,5593,11107,3
2022-03-19,경의선,홍대입구,1455,1785,3240,3
2022-03-19,경의선,서울역,913,970,1883,3
2022-03-19,경부선,가산디지털단지,4903,6439,11342,3
2022-03-19,경부선,서울역,4874,1558,6432,3
2022-03-19,9호선,고속터미널,9330,13078,22408,3
2022-03-19,8호선,잠실(송파구청),10181,11662,21843,3
2022-03-19,7호선,가산디지털단지,11338,10427,21765,3
2022-03-19,7호선,고속터미널,10910,8099,19009,3
2022-03-19,4호선,사당,16094,13901,29995,3
2022-03-19,4호선,서울역,4443,9288,13731,3
2022-03-19,3호선,고속터미널,37079,36866,73945,3
2022-03-19,2호선,홍대입구,51712,55494,107206,3
2022-03-19,2호선,구로디지털단지,27608,27153,54761,3
2022-03-19,2호선,신림,41725,40009,81734,3
2022-03-19,2호선,사당,23776,26059,49835,3
2022-03-19,2호선,강남,51456,51069,102525,3
2022-03-19,2호선,선릉,20316,18025,38341,3
2022-03-19,2호선,잠실(송파구청),47749,45808,93557,3
2022-03-19,1호선,서울역,22028,22382,44410,3
2022-03-20,분당선,선릉,2490,3756,6246,3
2022-03-20,공항철도 1호선,홍대입구,8507,8003,16510,3
2022-03-20,공항철도 1호선,서울역,5897,5523,11420,3
2022-03-20,경의선,홍대입구,1403,1589,2992,3
2022-03-20,경의선,서울역,853,818,1671,3
2022-03-20,경부선,가산디지털단지,3843,5177,9020,3
2022-03-20,1호선,서울역,20940,19549,40489,3
2022-03-20,경부선,서울역,5900,1429,7329,3
2022-03-20,9호선,고속터미널,8096,11433,19529,3
2022-03-20,8호선,잠실(송파구청),8648,9260,17908,3
2022-03-20,7호선,가산디지털단지,8797,8127,16924,3
2022-03-20,7호선,고속터미널,9698,6473,16171,3
2022-03-20,4호선,사당,13233,12233,25466,3
2022-03-20,4호선,서울역,3539,7726,11265,3
2022-03-20,3호선,고속터미널,32572,31444,64016,3
2022-03-20,2호선,홍대입구,44661,43639,88300,3
2022-03-20,2호선,구로디지털단지,19742,19533,39275,3
2022-03-20,2호선,신림,32810,31972,64782,3
2022-03-20,2호선,사당,18164,20177,38341,3
2022-03-20,2호선,강남,30600,29282,59882,3
2022-03-20,2호선,선릉,11736,10127,21863,3
2022-03-20,2호선,잠실(송파구청),39566,37286,76852,3
2022-03-21,경부선,서울역,5156,1630,6786,3
2022-03-21,경부선,가산디지털단지,17032,19555,36587,3
2022-03-21,경의선,서울역,4003,5120,9123,3
2022-03-21,경의선,홍대입구,1405,1571,2976,3
2022-03-21,공항철도 1호선,서울역,6307,5959,12266,3
2022-03-21,공항철도 1호선,홍대입구,7508,7541,15049,3
2022-03-21,분당선,선릉,12130,18211,30341,3
2022-03-21,1호선,서울역,35748,34264,70012,3
2022-03-21,2호선,잠실(송파구청),53445,52993,106438,3
2022-03-21,2호선,선릉,51000,45375,96375,3
2022-03-21,2호선,강남,72064,70949,143013,3
2022-03-21,2호선,사당,30822,34222,65044,3
2022-03-21,2호선,신림,56168,54767,110935,3
2022-03-21,2호선,구로디지털단지,53424,53498,106922,3
2022-03-21,2호선,홍대입구,43170,44302,87472,3
2022-03-21,3호선,고속터미널,27857,26587,54444,3
2022-03-21,4호선,서울역,9379,12997,22376,3
2022-03-21,4호선,사당,21346,17926,39272,3
2022-03-21,7호선,고속터미널,13547,11138,24685,3
2022-03-21,7호선,가산디지털단지,42273,42134,84407,3
2022-03-21,8호선,잠실(송파구청),11385,13006,24391,3
2022-03-21,9호선,고속터미널,9385,11757,21142,3
2022-03-22,9호선,고속터미널,9902,12057,21959,3
2022-03-22,경부선,서울역,4317,1445,5762,3
2022-03-22,경부선,가산디지털단지,17180,19847,37027,3
2022-03-22,경의선,서울역,3866,5014,8880,3
2022-03-22,경의선,홍대입구,1469,1613,3082,3
2022-03-22,공항철도 1호선,서울역,6028,5390,11418,3
2022-03-22,공항철도 1호선,홍대입구,7884,7889,15773,3
2022-03-22,분당선,선릉,12111,18485,30596,3
2022-03-22,1호선,서울역,35208,33766,68974,3
2022-03-22,2호선,잠실(송파구청),54837,54409,109246,3
2022-03-22,2호선,선릉,51614,45922,97536,3
2022-03-22,2호선,강남,73302,72034,145336,3
2022-03-22,2호선,사당,32341,35488,67829,3
2022-03-22,2호선,신림,57645,56030,113675,3
2022-03-22,2호선,구로디지털단지,53804,54151,107955,3
2022-03-22,2호선,홍대입구,45130,46584,91714,3
2022-03-22,3호선,고속터미널,31875,30388,62263,3
2022-03-22,4호선,서울역,9661,12866,22527,3
2022-03-22,4호선,사당,22048,18477,40525,3
2022-03-22,7호선,고속터미널,12931,11371,24302,3
2022-03-22,7호선,가산디지털단지,42180,42377,84557,3
2022-03-22,8호선,잠실(송파구청),11502,13369,24871,3
2022-03-23,1호선,서울역,34841,33672,68513,3
2022-03-23,2호선,잠실(송파구청),55099,55033,110132,3
2022-03-23,2호선,선릉,51125,45390,96515,3
2022-03-23,2호선,강남,72149,70760,142909,3
2022-03-23,2호선,사당,32291,35124,67415,3
2022-03-23,2호선,신림,57585,56145,113730,3
2022-03-23,2호선,구로디지털단지,53406,53667,107073,3
2022-03-23,2호선,홍대입구,45464,46984,92448,3
2022-03-23,3호선,고속터미널,31718,30482,62200,3
2022-03-23,4호선,서울역,9709,12998,22707,3
2022-03-23,4호선,사당,22132,18673,40805,3
2022-03-23,7호선,고속터미널,12879,11254,24133,3
2022-03-23,7호선,가산디지털단지,41980,42031,84011,3
2022-03-23,8호선,잠실(송파구청),11628,13434,25062,3
2022-03-23,9호선,고속터미널,10044,12189,22233,3
2022-03-23,경부선,서울역,4292,1517,5809,3
2022-03-23,경부선,가산디지털단지,17048,19486,36534,3
2022-03-23,경의선,서울역,3971,4897,8868,3
2022-03-23,경의선,홍대입구,1455,1667,3122,3
2022-03-23,공항철도 1호선,서울역,6047,5492,11539,3
2022-03-23,공항철도 1호선,홍대입구,7980,8036,16016,3
2022-03-23,분당선,선릉,12098,18185,30283,3
2022-03-24,경부선,가산디지털단지,17288,19690,36978,3
2022-03-24,경부선,서울역,4870,1644,6514,3
2022-03-24,9호선,고속터미널,10532,12635,23167,3
2022-03-24,8호선,잠실(송파구청),11521,13562,25083,3
2022-03-24,7호선,가산디지털단지,41496,41874,83370,3
2022-03-24,7호선,고속터미널,13452,11360,24812,3
2022-03-24,1호선,서울역,36679,35202,71881,3
2022-03-24,2호선,잠실(송파구청),56068,55525,111593,3
2022-03-24,2호선,선릉,51085,47864,98949,3
2022-03-24,2호선,강남,71870,73760,145630,3
2022-03-24,2호선,사당,32509,36446,68955,3
2022-03-24,2호선,신림,58126,53908,112034,3
2022-03-24,2호선,구로디지털단지,53717,54371,108088,3
2022-03-24,2호선,홍대입구,46287,47123,93410,3
2022-03-24,3호선,고속터미널,33015,31772,64787,3
2022-03-24,4호선,서울역,9913,13711,23624,3
2022-03-24,4호선,사당,22696,19517,42213,3
2022-03-24,분당선,선릉,12940,18700,31640,3
2022-03-24,공항철도 1호선,홍대입구,8074,8295,16369,3
2022-03-24,공항철도 1호선,서울역,7067,6430,13497,3
2022-03-24,경의선,홍대입구,1488,1713,3201,3
2022-03-24,경의선,서울역,4215,5163,9378,3
2022-03-25,경부선,가산디지털단지,16942,19348,36290,3
2022-03-25,경부선,서울역,6882,2357,9239,3
2022-03-25,9호선,고속터미널,11790,15363,27153,3
2022-03-25,7호선,가산디지털단지,41248,41002,82250,3
2022-03-25,7호선,고속터미널,15629,12496,28125,3
2022-03-25,4호선,사당,24658,20379,45037,3
2022-03-25,4호선,서울역,9879,15816,25695,3
2022-03-25,1호선,서울역,41104,41346,82450,3
2022-03-25,2호선,잠실(송파구청),60768,60406,121174,3
2022-03-25,2호선,선릉,50766,45247,96013,3
2022-03-25,2호선,강남,80279,78816,159095,3
2022-03-25,2호선,사당,35355,38246,73601,3
2022-03-25,2호선,신림,60744,58861,119605,3
2022-03-25,2호선,구로디지털단지,55056,54903,109959,3
2022-03-25,2호선,홍대입구,54450,57269,111719,3
2022-03-25,3호선,고속터미널,39498,41154,80652,3
2022-03-25,분당선,선릉,12248,18336,30584,3
2022-03-25,8호선,잠실(송파구청),12702,14715,27417,3
2022-03-25,공항철도 1호선,홍대입구,9496,9691,19187,3
2022-03-25,공항철도 1호선,서울역,8289,7668,15957,3
2022-03-25,경의선,홍대입구,1617,1989,3606,3
2022-03-25,경의선,서울역,4001,5017,9018,3
2022-03-26,공항철도 1호선,홍대입구,10385,10286,20671,3
2022-03-26,공항철도 1호선,서울역,6038,6387,12425,3
2022-03-26,경의선,홍대입구,1649,1991,3640,3
2022-03-26,경의선,서울역,1011,1183,2194,3
2022-03-26,9호선,고속터미널,10266,14124,24390,3
2022-03-26,7호선,가산디지털단지,12312,11293,23605,3
2022-03-26,2호선,잠실(송파구청),53685,51650,105335,3
2022-03-26,1호선,서울역,24604,25433,50037,3
2022-03-26,7호선,고속터미널,11804,9124,20928,3
2022-03-26,4호선,사당,17347,14832,32179,3
2022-03-26,4호선,서울역,4628,10370,14998,3
2022-03-26,3호선,고속터미널,39104,38984,78088,3
2022-03-26,2호선,홍대입구,56581,61315,117896,3
2022-03-26,경부선,가산디지털단지,5397,6987,12384,3
2022-03-26,경부선,서울역,5649,1701,7350,3
2022-03-26,8호선,잠실(송파구청),10679,12300,22979,3
2022-03-26,2호선,구로디지털단지,29395,28665,58060,3
2022-03-26,2호선,신림,44704,42513,87217,3
2022-03-26,2호선,사당,25178,28126,53304,3
2022-03-26,2호선,강남,53819,53565,107384,3
2022-03-26,2호선,선릉,20846,18155,39001,3
2022-03-26,분당선,선릉,4346,6903,11249,3
2022-03-27,9호선,고속터미널,8947,12490,21437,3
2022-03-27,8호선,잠실(송파구청),9119,9806,18925,3
2022-03-27,7호선,가산디지털단지,9620,8839,18459,3
2022-03-27,7호선,고속터미널,10557,6904,17461,3
2022-03-27,4호선,사당,13958,12961,26919,3
2022-03-27,4호선,서울역,3919,8544,12463,3
2022-03-27,3호선,고속터미널,34862,33662,68524,3
2022-03-27,2호선,홍대입구,46954,46210,93164,3
2022-03-27,2호선,구로디지털단지,20900,20580,41480,3
2022-03-27,2호선,신림,35161,34614,69775,3
2022-03-27,2호선,사당,19636,21920,41556,3
2022-03-27,2호선,강남,32676,31380,64056,3
2022-03-27,2호선,선릉,12401,10788,23189,3
2022-03-27,2호선,잠실(송파구청),44477,41398,85875,3
2022-03-27,1호선,서울역,23514,21481,44995,3
2022-03-27,경부선,서울역,7068,1580,8648,3
2022-03-27,경부선,가산디지털단지,4140,5739,9879,3
2022-03-27,경의선,서울역,921,879,1800,3
2022-03-27,경의선,홍대입구,1421,1766,3187,3
2022-03-27,공항철도 1호선,서울역,6642,6121,12763,3
2022-03-27,공항철도 1호선,홍대입구,9158,8418,17576,3
2022-03-27,분당선,선릉,2710,3992,6702,3
2022-03-28,9호선,고속터미널,10408,12785,23193,3
2022-03-28,경부선,서울역,5498,1707,7205,3
2022-03-28,경부선,가산디지털단지,17597,20015,37612,3
2022-03-28,경의선,서울역,4074,5265,9339,3
2022-03-28,경의선,홍대입구,1454,1584,3038,3
2022-03-28,공항철도 1호선,서울역,6639,6242,12881,3
2022-03-28,공항철도 1호선,홍대입구,7943,7718,15661,3
2022-03-28,분당선,선릉,12312,18551,30863,3
2022-03-28,1호선,서울역,37708,36335,74043,3
2022-03-28,2호선,잠실(송파구청),57078,56431,113509,3
2022-03-28,2호선,선릉,51426,46077,97503,3
2022-03-28,2호선,강남,73404,72103,145507,3
2022-03-28,2호선,사당,31941,35350,67291,3
2022-03-28,2호선,신림,58089,56425,114514,3
2022-03-28,2호선,구로디지털단지,54682,54346,109028,3
2022-03-28,2호선,홍대입구,44086,45537,89623,3
2022-03-28,3호선,고속터미널,33291,31945,65236,3
2022-03-28,4호선,서울역,9729,13367,23096,3
2022-03-28,4호선,사당,21952,18435,40387,3
2022-03-28,7호선,고속터미널,14085,11651,25736,3
2022-03-28,7호선,가산디지털단지,42471,43001,85472,3
2022-03-28,8호선,잠실(송파구청),11731,13576,25307,3
2022-03-29,경부선,서울역,4688,1497,6185,3
2022-03-29,경부선,가산디지털단지,17472,20134,37606,3
2022-03-29,경의선,서울역,4020,5030,9050,3
2022-03-29,경의선,홍대입구,1598,1677,3275,3
2022-03-29,공항철도 1호선,서울역,6578,5951,12529,3
2022-03-29,공항철도 1호선,홍대입구,8129,8221,16350,3
2022-03-29,분당선,선릉,12469,18905,31374,3
2022-03-29,1호선,서울역,36740,35596,72336,3
2022-03-29,2호선,잠실(송파구청),58832,57966,116798,3
2022-03-29,2호선,선릉,52522,46651,99173,3
2022-03-29,2호선,강남,74681,73497,148178,3
2022-03-29,2호선,사당,33541,36612,70153,3
2022-03-29,2호선,신림,58758,56951,115709,3
2022-03-29,2호선,구로디지털단지,55195,55368,110563,3
2022-03-29,2호선,홍대입구,45877,46805,92682,3
2022-03-29,3호선,고속터미널,32684,31025,63709,3
2022-03-29,4호선,서울역,10004,13486,23490,3
2022-03-29,4호선,사당,22941,19012,41953,3
2022-03-29,7호선,고속터미널,12938,11359,24297,3
2022-03-29,7호선,가산디지털단지,42815,43394,86209,3
2022-03-29,8호선,잠실(송파구청),12228,14146,26374,3
2022-03-29,9호선,고속터미널,10420,12562,22982,3
2022-03-30,경부선,서울역,4533,1517,6050,3
2022-03-30,경부선,가산디지털단지,17467,19916,37383,3
2022-03-30,경의선,서울역,3986,4931,8917,3
2022-03-30,경의선,홍대입구,1487,1644,3131,3
2022-03-30,공항철도 1호선,서울역,6280,5657,11937,3
2022-03-30,공항철도 1호선,홍대입구,7829,8003,15832,3
2022-03-30,분당선,선릉,12322,18633,30955,3
2022-03-30,9호선,고속터미널,10200,12493,22693,3
2022-03-30,1호선,서울역,36714,35489,72203,3
2022-03-30,2호선,잠실(송파구청),57338,56733,114071,3
2022-03-30,2호선,선릉,51653,46002,97655,3
2022-03-30,2호선,강남,73914,72356,146270,3
2022-03-30,2호선,사당,32988,36198,69186,3
2022-03-30,2호선,신림,58619,56965,115584,3
2022-03-30,2호선,구로디지털단지,54636,54715,109351,3
2022-03-30,2호선,홍대입구,45257,46976,92233,3
2022-03-30,3호선,고속터미널,31744,30283,62027,3
2022-03-30,4호선,서울역,9955,13439,23394,3
2022-03-30,4호선,사당,22688,18966,41654,3
2022-03-30,7호선,고속터미널,13175,11414,24589,3
2022-03-30,7호선,가산디지털단지,42625,43013,85638,3
2022-03-30,8호선,잠실(송파구청),11837,13947,25784,3
2022-03-31,9호선,고속터미널,10958,13301,24259,3
2022-03-31,경부선,서울역,5024,1731,6755,3
2022-03-31,경부선,가산디지털단지,17755,20457,38212,3
2022-03-31,분당선,선릉,12494,18662,31156,3
2022-03-31,공항철도 1호선,홍대입구,8384,8361,16745,3
2022-03-31,공항철도 1호선,서울역,6762,5967,12729,3
2022-03-31,경의선,홍대입구,1556,1772,3328,3
2022-03-31,경의선,서울역,4065,5131,9196,3
2022-03-31,1호선,서울역,37698,36841,74539,3
2022-03-31,2호선,잠실(송파구청),59884,59654,119538,3
2022-03-31,2호선,선릉,52012,46673,98685,3
2022-03-31,2호선,강남,75290,73710,149000,3
2022-03-31,2호선,사당,33532,37019,70551,3
2022-03-31,2호선,신림,60054,57534,117588,3
2022-03-31,2호선,구로디지털단지,55550,55199,110749,3
2022-03-31,2호선,홍대입구,48076,50160,98236,3
2022-03-31,3호선,고속터미널,33892,32410,66302,3
2022-03-31,4호선,서울역,10108,14262,24370,3
2022-03-31,4호선,사당,22930,19156,42086,3
2022-03-31,7호선,고속터미널,13507,11582,25089,3
2022-03-31,7호선,가산디지털단지,42750,43531,86281,3
2022-03-31,8호선,잠실(송파구청),12476,14353,26829,3
2022-04-01,2호선,잠실(송파구청),69024,69044,138068,4
2022-04-01,2호선,선릉,51279,45602,96881,4
2022-04-01,2호선,강남,81663,80892,162555,4
2022-04-01,2호선,사당,36112,40286,76398,4
2022-04-01,2호선,신림,62771,60285,123056,4
2022-04-01,2호선,구로디지털단지,56725,56240,112965,4
2022-04-01,2호선,홍대입구,56121,60931,117052,4
2022-04-01,3호선,고속터미널,42055,43793,85848,4
2022-04-01,4호선,서울역,10455,17206,27661,4
2022-04-01,4호선,사당,25061,21399,46460,4
2022-04-01,7호선,고속터미널,16198,13299,29497,4
2022-04-01,7호선,가산디지털단지,42305,42277,84582,4
2022-04-01,8호선,잠실(송파구청),14090,16426,30516,4
2022-04-01,9호선,고속터미널,12707,16803,29510,4
2022-04-01,경부선,서울역,6849,2493,9342,4
2022-04-01,경부선,가산디지털단지,17501,20000,37501,4
2022-04-01,경의선,서울역,4240,5480,9720,4
2022-04-01,경의선,홍대입구,1735,2142,3877,4
2022-04-01,공항철도 1호선,서울역,8782,8426,17208,4
2022-04-01,공항철도 1호선,홍대입구,10102,10273,20375,4
2022-04-01,분당선,선릉,12334,18434,30768,4
2022-04-01,1호선,서울역,43089,43731,86820,4
2022-04-02,분당선,선릉,4885,7304,12189,4
2022-04-02,공항철도 1호선,홍대입구,11466,11414,22880,4
2022-04-02,공항철도 1호선,서울역,6922,7541,14463,4
2022-04-02,경의선,홍대입구,1832,2384,4216,4
2022-04-02,경의선,서울역,1194,1372,2566,4
2022-04-02,경부선,가산디지털단지,5995,7834,13829,4
2022-04-02,경부선,서울역,6385,1779,8164,4
2022-04-02,9호선,고속터미널,12321,17514,29835,4
2022-04-02,8호선,잠실(송파구청),14450,16018,30468,4
2022-04-02,7호선,가산디지털단지,13770,12474,26244,4
2022-04-02,7호선,고속터미널,13318,10068,23386,4
2022-04-02,4호선,사당,20155,17237,37392,4
2022-04-02,4호선,서울역,5275,12014,17289,4
2022-04-02,3호선,고속터미널,45336,45686,91022,4
2022-04-02,2호선,홍대입구,63406,67291,130697,4
2022-04-02,2호선,구로디지털단지,32307,31415,63722,4
2022-04-02,2호선,신림,49280,46809,96089,4
2022-04-02,2호선,사당,28587,31886,60473,4
2022-04-02,2호선,강남,57229,57273,114502,4
2022-04-02,2호선,선릉,22459,19670,42129,4
2022-04-02,2호선,잠실(송파구청),75696,73365,149061,4
2022-04-02,1호선,서울역,28867,30246,59113,4
2022-04-03,4호선,사당,14465,12985,27450,4
2022-04-03,4호선,서울역,4043,9384,13427,4
2022-04-03,3호선,고속터미널,38338,36068,74406,4
2022-04-03,2호선,홍대입구,46727,45690,92417,4
2022-04-03,2호선,구로디지털단지,22390,21986,44376,4
2022-04-03,2호선,신림,35450,35340,70790,4
2022-04-03,2호선,사당,20116,22898,43014,4
2022-04-03,2호선,강남,31960,31026,62986,4
2022-04-03,2호선,선릉,12535,10762,23297,4
2022-04-03,2호선,잠실(송파구청),58223,54111,112334,4
2022-04-03,1호선,서울역,26207,23197,49404,4
2022-04-03,공항철도 1호선,서울역,7530,6816,14346,4
2022-04-03,공항철도 1호선,홍대입구,9530,8840,18370,4
2022-04-03,분당선,선릉,2702,4055,6757,4
2022-04-03,7호선,고속터미널,11918,7373,19291,4
2022-04-03,7호선,가산디지털단지,9827,9178,19005,4
2022-04-03,8호선,잠실(송파구청),11559,12496,24055,4
2022-04-03,9호선,고속터미널,10245,13877,24122,4
2022-04-03,경부선,서울역,7751,1591,9342,4
2022-04-03,경부선,가산디지털단지,4375,6123,10498,4
2022-04-03,경의선,서울역,982,913,1895,4
2022-04-03,경의선,홍대입구,1505,1820,3325,4
2022-04-04,공항철도 1호선,서울역,6896,6660,13556,4
2022-04-04,공항철도 1호선,홍대입구,8069,8194,16263,4
2022-04-04,분당선,선릉,12590,19159,31749,4
2022-04-04,1호선,서울역,39136,37312,76448,4
2022-04-04,2호선,잠실(송파구청),64255,64016,128271,4
2022-04-04,2호선,선릉,53179,47567,100746,4
2022-04-04,2호선,강남,76003,75307,151310,4
2022-04-04,2호선,사당,32692,36801,69493,4
2022-04-04,2호선,신림,59587,57535,117122,4
2022-04-04,2호선,구로디지털단지,55868,56060,111928,4
2022-04-04,2호선,홍대입구,45432,47362,92794,4
2022-04-04,3호선,고속터미널,34856,33253,68109,4
2022-04-04,4호선,서울역,10093,14145,24238,4
2022-04-04,4호선,사당,22913,18951,41864,4
2022-04-04,7호선,고속터미널,14740,11974,26714,4
2022-04-04,7호선,가산디지털단지,44134,44589,88723,4
2022-04-04,8호선,잠실(송파구청),13207,15393,28600,4
2022-04-04,9호선,고속터미널,11038,13566,24604,4
2022-04-04,경부선,서울역,5911,1848,7759,4
2022-04-04,경부선,가산디지털단지,18195,21001,39196,4
2022-04-04,경의선,서울역,4197,5419,9616,4
2022-04-04,경의선,홍대입구,1511,1639,3150,4
2022-04-05,7호선,고속터미널,13820,12013,25833,4
2022-04-05,7호선,가산디지털단지,44203,44959,89162,4
2022-04-05,1호선,서울역,38512,37425,75937,4
2022-04-05,2호선,잠실(송파구청),67590,67230,134820,4
2022-04-05,2호선,선릉,54240,48365,102605,4
2022-04-05,2호선,강남,77221,76703,153924,4
2022-04-05,2호선,사당,34634,38544,73178,4
2022-04-05,분당선,선릉,12863,19562,32425,4
2022-04-05,공항철도 1호선,홍대입구,8342,8493,16835,4
2022-04-05,공항철도 1호선,서울역,6734,6219,12953,4
2022-04-05,경의선,홍대입구,1552,1696,3248,4
2022-04-05,경의선,서울역,4273,5440,9713,4
2022-04-05,경부선,가산디지털단지,18282,21099,39381,4
2022-04-05,경부선,서울역,4939,1630,6569,4
2022-04-05,9호선,고속터미널,10885,13324,24209,4
2022-04-05,8호선,잠실(송파구청),13821,16050,29871,4
2022-04-05,2호선,구로디지털단지,56798,56856,113654,4
2022-04-05,2호선,신림,60713,58617,119330,4
2022-04-05,2호선,홍대입구,46307,48735,95042,4
2022-04-05,3호선,고속터미널,34412,32897,67309,4
2022-04-05,4호선,서울역,10470,14314,24784,4
2022-04-05,4호선,사당,23835,19968,43803,4
2022-04-06,4호선,사당,24108,20061,44169,4
2022-04-06,4호선,서울역,10511,14687,25198,4
2022-04-06,3호선,고속터미널,34523,33086,67609,4
2022-04-06,2호선,홍대입구,48396,50874,99270,4
2022-04-06,2호선,구로디지털단지,56841,57080,113921,4
2022-04-06,2호선,신림,61277,59160,120437,4
2022-04-06,2호선,사당,35073,38984,74057,4
2022-04-06,2호선,강남,77317,76566,153883,4
2022-04-06,2호선,선릉,54844,48990,103834,4
2022-04-06,2호선,잠실(송파구청),73160,73639,146799,4
2022-04-06,1호선,서울역,38934,37846,76780,4
2022-04-06,분당선,선릉,13149,19600,32749,4
2022-04-06,공항철도 1호선,홍대입구,8819,8663,17482,4
2022-04-06,공항철도 1호선,서울역,6873,6352,13225,4
2022-04-06,경의선,홍대입구,1640,1829,3469,4
2022-04-06,경의선,서울역,4389,5488,9877,4
2022-04-06,경부선,가산디지털단지,18438,20977,39415,4
2022-04-06,경부선,서울역,4840,1684,6524,4
2022-04-06,9호선,고속터미널,11326,13586,24912,4
2022-04-06,8호선,잠실(송파구청),14609,17192,31801,4
2022-04-06,7호선,가산디지털단지,44227,44819,89046,4
2022-04-06,7호선,고속터미널,13969,12322,26291,4
2022-04-07,4호선,사당,24602,20573,45175,4
2022-04-07,4호선,서울역,10508,15645,26153,4
2022-04-07,3호선,고속터미널,36420,34962,71382,4
2022-04-07,2호선,홍대입구,49511,52103,101614,4
2022-04-07,2호선,구로디지털단지,57775,57444,115219,4
2022-04-07,2호선,신림,61825,59321,121146,4
2022-04-07,2호선,사당,35235,38986,74221,4
2022-04-07,2호선,강남,78855,78015,156870,4
2022-04-07,2호선,선릉,54623,48919,103542,4
2022-04-07,2호선,잠실(송파구청),76368,76338,152706,4
2022-04-07,1호선,서울역,40672,39178,79850,4
2022-04-07,분당선,선릉,12903,19661,32564,4
2022-04-07,공항철도 1호선,홍대입구,8899,8937,17836,4
2022-04-07,공항철도 1호선,서울역,7411,6949,14360,4
2022-04-07,경의선,홍대입구,1616,1767,3383,4
2022-04-07,경의선,서울역,4396,5660,10056,4
2022-04-07,경부선,가산디지털단지,18374,21295,39669,4
2022-04-07,경부선,서울역,5566,1815,7381,4
2022-04-07,9호선,고속터미널,11635,14271,25906,4
2022-04-07,8호선,잠실(송파구청),15854,18069,33923,4
2022-04-07,7호선,가산디지털단지,44240,44974,89214,4
2022-04-07,7호선,고속터미널,14467,12371,26838,4
2022-04-08,2호선,사당,37739,42287,80026,4
2022-04-08,2호선,신림,64711,61479,126190,4
2022-04-08,2호선,구로디지털단지,58027,57515,115542,4
2022-04-08,2호선,홍대입구,55998,62878,118876,4
2022-04-08,3호선,고속터미널,44494,46343,90837,4
2022-04-08,4호선,서울역,10413,17572,27985,4
2022-04-08,4호선,사당,26582,22104,48686,4
2022-04-08,7호선,고속터미널,17327,14065,31392,4
2022-04-08,7호선,가산디지털단지,43670,44136,87806,4
2022-04-08,8호선,잠실(송파구청),18383,21756,40139,4
2022-04-08,9호선,고속터미널,13996,18186,32182,4
2022-04-08,경부선,서울역,7676,2591,10267,4
2022-04-08,경부선,가산디지털단지,18846,21362,40208,4
2022-04-08,경의선,서울역,4364,5695,10059,4
2022-04-08,경의선,홍대입구,1805,2149,3954,4
2022-04-08,공항철도 1호선,서울역,9202,8764,17966,4
2022-04-08,공항철도 1호선,홍대입구,10478,11081,21559,4
2022-04-08,분당선,선릉,12753,19588,32341,4
2022-04-08,1호선,서울역,45182,45468,90650,4
2022-04-08,2호선,잠실(송파구청),95304,95925,191229,4
2022-04-08,2호선,선릉,54454,48460,102914,4
2022-04-08,2호선,강남,84552,86323,170875,4
2022-04-09,분당선,선릉,5191,7916,13107,4
2022-04-09,공항철도 1호선,홍대입구,12186,12135,24321,4
2022-04-09,공항철도 1호선,서울역,7740,8208,15948,4
2022-04-09,경의선,홍대입구,1959,2543,4502,4
2022-04-09,경의선,서울역,1339,1466,2805,4
2022-04-09,경부선,가산디지털단지,6856,8709,15565,4
2022-04-09,경부선,서울역,7409,1909,9318,4
2022-04-09,9호선,고속터미널,14946,20085,35031,4
2022-04-09,8호선,잠실(송파구청),22933,26129,49062,4
2022-04-09,7호선,가산디지털단지,14870,13621,28491,4
2022-04-09,7호선,고속터미널,14561,11045,25606,4
2022-04-09,4호선,사당,22445,19041,41486,4
2022-04-09,4호선,서울역,5808,13626,19434,4
2022-04-09,3호선,고속터미널,49165,48018,97183,4
2022-04-09,2호선,홍대입구,61157,68056,129213,4
2022-04-09,2호선,구로디지털단지,33760,32943,66703,4
2022-04-09,2호선,신림,51066,47976,99042,4
2022-04-09,2호선,사당,31337,35302,66639,4
2022-04-09,2호선,강남,58449,61047,119496,4
2022-04-09,2호선,선릉,23688,21111,44799,4
2022-04-09,2호선,잠실(송파구청),122543,118237,240780,4
2022-04-09,1호선,서울역,32255,33153,65408,4
2022-04-10,경의선,서울역,1178,1049,2227,4
2022-04-10,경의선,홍대입구,1653,1922,3575,4
2022-04-10,공항철도 1호선,서울역,8253,7612,15865,4
2022-04-10,공항철도 1호선,홍대입구,10167,9287,19454,4
2022-04-10,분당선,선릉,2939,4461,7400,4
2022-04-10,4호선,사당,16920,15420,32340,4
2022-04-10,1호선,서울역,28853,26107,54960,4
2022-04-10,2호선,잠실(송파구청),92633,87117,179750,4
2022-04-10,2호선,선릉,13451,11720,25171,4
2022-04-10,2호선,강남,34410,34315,68725,4
2022-04-10,2호선,사당,22494,25577,48071,4
2022-04-10,2호선,신림,39124,37834,76958,4
2022-04-10,2호선,구로디지털단지,24251,23579,47830,4
2022-04-10,2호선,홍대입구,46801,47730,94531,4
2022-04-10,3호선,고속터미널,41890,39321,81211,4
2022-04-10,4호선,서울역,4531,10871,15402,4
2022-04-10,7호선,고속터미널,13700,8577,22277,4
2022-04-10,7호선,가산디지털단지,11517,10517,22034,4
2022-04-10,8호선,잠실(송파구청),17985,19454,37439,4
2022-04-10,9호선,고속터미널,12062,16279,28341,4
2022-04-10,경부선,서울역,8234,1841,10075,4
2022-04-10,경부선,가산디지털단지,5255,7043,12298,4
2022-04-11,7호선,고속터미널,15428,12774,28202,4
2022-04-11,3호선,고속터미널,37321,35812,73133,4
2022-04-11,2호선,구로디지털단지,57947,57844,115791,4
2022-04-11,2호선,신림,61145,59054,120199,4
2022-04-11,2호선,사당,34295,38415,72710,4
2022-04-11,2호선,강남,77999,77552,155551,4
2022-04-11,2호선,선릉,55569,49564,105133,4
2022-04-11,2호선,잠실(송파구청),80428,80550,160978,4
2022-04-11,1호선,서울역,40811,39414,80225,4
2022-04-11,2호선,홍대입구,46880,48722,95602,4
2022-04-11,경의선,서울역,4410,5624,10034,4
2022-04-11,경의선,홍대입구,1579,1750,3329,4
2022-04-11,분당선,선릉,13083,19891,32974,4
2022-04-11,공항철도 1호선,홍대입구,8546,8763,17309,4
2022-04-11,공항철도 1호선,서울역,7338,7050,14388,4
2022-04-11,경부선,가산디지털단지,18908,21660,40568,4
2022-04-11,경부선,서울역,6164,1919,8083,4
2022-04-11,9호선,고속터미널,12080,14567,26647,4
2022-04-11,4호선,서울역,10676,15197,25873,4
2022-04-11,4호선,사당,24166,20003,44169,4
2022-04-11,8호선,잠실(송파구청),15614,18408,34022,4
2022-04-11,7호선,가산디지털단지,44955,45619,90574,4
2022-04-12,2호선,잠실(송파구청),71244,70497,141741,4
2022-04-12,2호선,선릉,56317,50218,106535,4
2022-04-12,2호선,강남,79450,78812,158262,4
2022-04-12,2호선,사당,35964,39855,75819,4
2022-04-12,2호선,신림,61910,59997,121907,4
2022-04-12,2호선,구로디지털단지,58408,58564,116972,4
2022-04-12,2호선,홍대입구,48148,49970,98118,4
2022-04-12,4호선,서울역,10928,14977,25905,4
2022-04-12,7호선,가산디지털단지,45445,45855,91300,4
2022-04-12,8호선,잠실(송파구청),14257,16661,30918,4
2022-04-12,9호선,고속터미널,11639,14186,25825,4
2022-04-12,경부선,서울역,5200,1684,6884,4
2022-04-12,경부선,가산디지털단지,18873,21821,40694,4
2022-04-12,경의선,서울역,4239,5632,9871,4
2022-04-12,경의선,홍대입구,1576,1724,3300,4
2022-04-12,공항철도 1호선,서울역,7168,6705,13873,4
2022-04-12,공항철도 1호선,홍대입구,8361,8599,16960,4
2022-04-12,분당선,선릉,13356,20320,33676,4
2022-04-12,4호선,사당,25024,20847,45871,4
2022-04-12,3호선,고속터미널,35703,34148,69851,4
2022-04-12,7호선,고속터미널,14429,12593,27022,4
2022-04-12,1호선,서울역,40094,38562,78656,4
2022-04-13,분당선,선릉,13252,20146,33398,4
2022-04-13,공항철도 1호선,홍대입구,8482,8582,17064,4
2022-04-13,공항철도 1호선,서울역,7082,6498,13580,4
2022-04-13,경의선,홍대입구,1497,1706,3203,4
2022-04-13,경의선,서울역,4239,5460,9699,4
2022-04-13,경부선,가산디지털단지,18443,21376,39819,4
2022-04-13,경부선,서울역,5063,1743,6806,4
2022-04-13,9호선,고속터미널,11188,13428,24616,4
2022-04-13,8호선,잠실(송파구청),13247,15532,28779,4
2022-04-13,7호선,가산디지털단지,44950,45477,90427,4
2022-04-13,7호선,고속터미널,14081,12170,26251,4
2022-04-13,4호선,사당,24560,20349,44909,4
2022-04-13,4호선,서울역,11017,15219,26236,4
2022-04-13,3호선,고속터미널,34773,33891,68664,4
2022-04-13,2호선,홍대입구,47728,50183,97911,4
2022-04-13,2호선,구로디지털단지,58064,57855,115919,4
2022-04-13,2호선,신림,61868,59781,121649,4
2022-04-13,2호선,사당,35564,39196,74760,4
2022-04-13,2호선,강남,78530,77989,156519,4
2022-04-13,2호선,선릉,55720,49602,105322,4
2022-04-13,2호선,잠실(송파구청),64205,63976,128181,4
2022-04-13,1호선,서울역,40496,39098,79594,4
2022-04-14,4호선,사당,25389,21127,46516,4
2022-04-14,4호선,서울역,11008,16079,27087,4
2022-04-14,3호선,고속터미널,36598,35533,72131,4
2022-04-14,2호선,홍대입구,49852,53134,102986,4
2022-04-14,2호선,구로디지털단지,58675,58651,117326,4
2022-04-14,2호선,신림,62847,60371,123218,4
2022-04-14,2호선,사당,36506,40493,76999,4
2022-04-14,2호선,강남,80995,80315,161310,4
2022-04-14,2호선,선릉,56141,50416,106557,4
2022-04-14,2호선,잠실(송파구청),67134,67254,134388,4
2022-04-14,1호선,서울역,41503,40369,81872,4
2022-04-14,7호선,고속터미널,14738,12594,27332,4
2022-04-14,7호선,가산디지털단지,44881,45485,90366,4
2022-04-14,8호선,잠실(송파구청),13441,15954,29395,4
2022-04-14,9호선,고속터미널,11822,14167,25989,4
2022-04-14,경부선,서울역,5553,1859,7412,4
2022-04-14,경부선,가산디지털단지,18689,21688,40377,4
2022-04-14,경의선,서울역,4492,5502,9994,4
2022-04-14,경의선,홍대입구,1634,1841,3475,4
2022-04-14,공항철도 1호선,서울역,7483,7007,14490,4
2022-04-14,공항철도 1호선,홍대입구,8858,8935,17793,4
2022-04-14,분당선,선릉,13314,20154,33468,4
2022-04-15,공항철도 1호선,서울역,9394,8992,18386,4
2022-04-15,공항철도 1호선,홍대입구,10870,11117,21987,4
2022-04-15,분당선,선릉,13347,20205,33552,4
2022-04-15,1호선,서울역,46888,46616,93504,4
2022-04-15,2호선,홍대입구,55882,63024,118906,4
2022-04-15,경의선,홍대입구,1798,2082,3880,4
2022-04-15,경의선,서울역,4386,5742,10128,4
2022-04-15,경부선,가산디지털단지,18736,21475,40211,4
2022-04-15,경부선,서울역,7726,2650,10376,4
2022-04-15,2호선,선릉,55703,49972,105675,4
2022-04-15,2호선,잠실(송파구청),73845,73401,147246,4
2022-04-15,9호선,고속터미널,13772,18511,32283,4
2022-04-15,8호선,잠실(송파구청),14707,17697,32404,4
2022-04-15,7호선,가산디지털단지,44716,44660,89376,4
2022-04-15,7호선,고속터미널,17022,14337,31359,4
2022-04-15,2호선,강남,85967,87465,173432,4
2022-04-15,2호선,사당,38455,43858,82313,4
2022-04-15,2호선,신림,65833,62556,128389,4
2022-04-15,2호선,구로디지털단지,59248,58871,118119,4
2022-04-15,3호선,고속터미널,44806,47217,92023,4
2022-04-15,4호선,서울역,11008,18531,29539,4
2022-04-15,4호선,사당,27286,23039,50325,4
2022-04-16,분당선,선릉,4985,7784,12769,4
2022-04-16,공항철도 1호선,홍대입구,11819,11948,23767,4
2022-04-16,공항철도 1호선,서울역,7717,8156,15873,4
2022-04-16,경의선,홍대입구,1982,2455,4437,4
2022-04-16,경의선,서울역,1342,1480,2822,4
2022-04-16,경부선,가산디지털단지,6533,8515,15048,4
2022-04-16,경부선,서울역,6718,1963,8681,4
2022-04-16,9호선,고속터미널,13897,18946,32843,4
2022-04-16,8호선,잠실(송파구청),13818,16025,29843,4
2022-04-16,7호선,가산디지털단지,14930,13438,28368,4
2022-04-16,7호선,고속터미널,13836,11085,24921,4
2022-04-16,4호선,사당,22796,18998,41794,4
2022-04-16,4호선,서울역,5917,13888,19805,4
2022-04-16,3호선,고속터미널,49558,49422,98980,4
2022-04-16,2호선,홍대입구,61990,68143,130133,4
2022-04-16,2호선,구로디지털단지,33675,32986,66661,4
2022-04-16,2호선,신림,51216,48522,99738,4
2022-04-16,2호선,사당,31354,35447,66801,4
2022-04-16,2호선,강남,58294,59470,117764,4
2022-04-16,2호선,선릉,23554,20968,44522,4
2022-04-16,2호선,잠실(송파구청),73717,70943,144660,4
2022-04-16,1호선,서울역,32648,32937,65585,4
2022-04-17,경의선,서울역,1147,974,2121,4
2022-04-17,경의선,홍대입구,1572,1694,3266,4
2022-04-17,공항철도 1호선,서울역,8054,7105,15159,4
2022-04-17,공항철도 1호선,홍대입구,9643,8760,18403,4
2022-04-17,7호선,고속터미널,12860,8130,20990,4
2022-04-17,7호선,가산디지털단지,10755,9905,20660,4
2022-04-17,8호선,잠실(송파구청),10205,11447,21652,4
2022-04-17,9호선,고속터미널,10971,14669,25640,4
2022-04-17,경부선,서울역,7922,1678,9600,4
2022-04-17,경부선,가산디지털단지,4868,6711,11579,4
2022-04-17,4호선,사당,15990,14669,30659,4
2022-04-17,4호선,서울역,4529,10764,15293,4
2022-04-17,분당선,선릉,2933,4498,7431,4
2022-04-17,1호선,서울역,29339,26393,55732,4
2022-04-17,2호선,잠실(송파구청),52780,49710,102490,4
2022-04-17,2호선,선릉,13240,11460,24700,4
2022-04-17,2호선,강남,32852,32236,65088,4
2022-04-17,2호선,사당,21695,24328,46023,4
2022-04-17,2호선,신림,37848,37077,74925,4
2022-04-17,2호선,구로디지털단지,23829,23208,47037,4
2022-04-17,2호선,홍대입구,45108,45558,90666,4
2022-04-17,3호선,고속터미널,41041,37809,78850,4
2022-04-18,3호선,고속터미널,32889,31069,63958,4
2022-04-18,공항철도 1호선,서울역,7555,7235,14790,4
2022-04-18,공항철도 1호선,홍대입구,8359,8532,16891,4
2022-04-18,분당선,선릉,13294,20639,33933,4
2022-04-18,경부선,가산디지털단지,19157,21989,41146,4
2022-04-18,경부선,서울역,6206,1881,8087,4
2022-04-18,1호선,서울역,42230,40071,82301,4
2022-04-18,2호선,잠실(송파구청),60452,59940,120392,4
2022-04-18,2호선,선릉,56965,51009,107974,4
2022-04-18,2호선,강남,79500,79576,159076,4
2022-04-18,2호선,사당,35471,39471,74942,4
2022-04-18,2호선,신림,61807,59870,121677,4
2022-04-18,2호선,구로디지털단지,58492,58647,117139,4
2022-04-18,2호선,홍대입구,47050,49823,96873,4
2022-04-18,9호선,고속터미널,11477,13921,25398,4
2022-04-18,경의선,서울역,4581,5779,10360,4
2022-04-18,경의선,홍대입구,1578,1696,3274,4
2022-04-18,8호선,잠실(송파구청),12609,14993,27602,4
2022-04-18,7호선,가산디지털단지,46112,46587,92699,4
2022-04-18,7호선,고속터미널,15260,12326,27586,4
2022-04-18,4호선,사당,24675,20849,45524,4
2022-04-18,4호선,서울역,11026,15477,26503,4
2022-04-19,4호선,사당,25400,21537,46937,4
2022-04-19,분당선,선릉,13925,21118,35043,4
2022-04-19,공항철도 1호선,홍대입구,8545,8766,17311,4
2022-04-19,공항철도 1호선,서울역,7426,6708,14134,4
2022-04-19,경의선,홍대입구,1584,1733,3317,4
2022-04-19,4호선,서울역,11287,15627,26914,4
2022-04-19,2호선,선릉,58455,52251,110706,4
2022-04-19,1호선,서울역,41853,40525,82378,4
2022-04-19,경의선,서울역,4516,5831,10347,4
2022-04-19,3호선,고속터미널,37686,36288,73974,4
2022-04-19,2호선,홍대입구,48324,50891,99215,4
2022-04-19,2호선,구로디지털단지,59950,60205,120155,4
2022-04-19,2호선,신림,63524,61282,124806,4
2022-04-19,2호선,사당,37564,41204,78768,4
2022-04-19,2호선,강남,82201,81612,163813,4
2022-04-19,2호선,잠실(송파구청),66283,65401,131684,4
2022-04-19,7호선,고속터미널,14879,13087,27966,4
2022-04-19,7호선,가산디지털단지,46573,46979,93552,4
2022-04-19,8호선,잠실(송파구청),13418,15969,29387,4
2022-04-19,9호선,고속터미널,11977,14332,26309,4
2022-04-19,경부선,서울역,5335,1698,7033,4
2022-04-19,경부선,가산디지털단지,19330,22301,41631,4
2022-04-20,1호선,서울역,42565,41248,83813,4
2022-04-20,2호선,잠실(송파구청),67986,65927,133913,4
2022-04-20,2호선,선릉,58841,52629,111470,4
2022-04-20,2호선,강남,81919,81775,163694,4
2022-04-20,2호선,사당,37600,42060,79660,4
2022-04-20,2호선,신림,64679,62511,127190,4
2022-04-20,2호선,구로디지털단지,60592,60955,121547,4
2022-04-20,2호선,홍대입구,49164,52251,101415,4
2022-04-20,3호선,고속터미널,37711,36176,73887,4
2022-04-20,4호선,서울역,11526,16413,27939,4
2022-04-20,4호선,사당,25747,21601,47348,4
2022-04-20,7호선,고속터미널,15071,13270,28341,4
2022-04-20,7호선,가산디지털단지,46618,46994,93612,4
2022-04-20,8호선,잠실(송파구청),13474,16234,29708,4
2022-04-20,9호선,고속터미널,12424,14937,27361,4
2022-04-20,경부선,서울역,5341,1809,7150,4
2022-04-20,경부선,가산디지털단지,19379,22567,41946,4
2022-04-20,경의선,서울역,4608,5794,10402,4
2022-04-20,경의선,홍대입구,1635,1802,3437,4
2022-04-20,공항철도 1호선,서울역,7536,6932,14468,4
2022-04-20,공항철도 1호선,홍대입구,8941,9159,18100,4
2022-04-20,분당선,선릉,14034,21283,35317,4
2022-04-21,분당선,선릉,14243,22304,36547,4
2022-04-21,공항철도 1호선,홍대입구,9063,9169,18232,4
2022-04-21,공항철도 1호선,서울역,8151,7611,15762,4
2022-04-21,경의선,홍대입구,1640,1856,3496,4
2022-04-21,경의선,서울역,4688,6209,10897,4
2022-04-21,경부선,가산디지털단지,19102,22154,41256,4
2022-04-21,경부선,서울역,5721,1921,7642,4
2022-04-21,9호선,고속터미널,13235,16578,29813,4
2022-04-21,8호선,잠실(송파구청),13648,16574,30222,4
2022-04-21,7호선,가산디지털단지,46202,46644,92846,4
2022-04-21,7호선,고속터미널,15787,13970,29757,4
2022-04-21,4호선,사당,30559,24873,55432,4
2022-04-21,4호선,서울역,11734,15708,27442,4
2022-04-21,3호선,고속터미널,39236,40445,79681,4
2022-04-21,2호선,홍대입구,50588,54715,105303,4
2022-04-21,2호선,구로디지털단지,59825,58286,118111,4
2022-04-21,2호선,신림,64024,62046,126070,4
2022-04-21,2호선,사당,40766,44813,85579,4
2022-04-21,2호선,강남,82304,79989,162293,4
2022-04-21,2호선,선릉,58287,52072,110359,4
2022-04-21,2호선,잠실(송파구청),67895,67116,135011,4
2022-04-21,1호선,서울역,44195,43114,87309,4
2022-04-22,분당선,선릉,13535,21341,34876,4
2022-04-22,공항철도 1호선,홍대입구,10069,10835,20904,4
2022-04-22,공항철도 1호선,서울역,9774,9520,19294,4
2022-04-22,경의선,홍대입구,1699,2146,3845,4
2022-04-22,경의선,서울역,4711,6311,11022,4
2022-04-22,경부선,가산디지털단지,19021,21945,40966,4
2022-04-22,경부선,서울역,8196,2695,10891,4
2022-04-22,9호선,고속터미널,13978,18466,32444,4
2022-04-22,8호선,잠실(송파구청),13800,17051,30851,4
2022-04-22,7호선,가산디지털단지,45478,45349,90827,4
2022-04-22,7호선,고속터미널,17890,14721,32611,4
2022-04-22,4호선,사당,27603,23585,51188,4
2022-04-22,4호선,서울역,11663,19074,30737,4
2022-04-22,3호선,고속터미널,44586,47531,92117,4
2022-04-22,2호선,홍대입구,54677,64145,118822,4
2022-04-22,2호선,구로디지털단지,60010,59552,119562,4
2022-04-22,2호선,신림,65620,62957,128577,4
2022-04-22,2호선,사당,39595,44814,84409,4
2022-04-22,2호선,강남,87011,89702,176713,4
2022-04-22,2호선,선릉,57035,50427,107462,4
2022-04-22,2호선,잠실(송파구청),71988,70984,142972,4
2022-04-22,1호선,서울역,48821,48438,97259,4
2022-04-23,분당선,선릉,5076,8162,13238,4
2022-04-23,공항철도 1호선,홍대입구,11941,12367,24308,4
2022-04-23,공항철도 1호선,서울역,8284,8459,16743,4
2022-04-23,경의선,홍대입구,1851,2346,4197,4
2022-04-23,경의선,서울역,1480,1610,3090,4
2022-04-23,경부선,가산디지털단지,6698,8723,15421,4
2022-04-23,경부선,서울역,7565,1956,9521,4
2022-04-23,9호선,고속터미널,14340,19788,34128,4
2022-04-23,8호선,잠실(송파구청),12799,15208,28007,4
2022-04-23,7호선,가산디지털단지,15334,13729,29063,4
2022-04-23,7호선,고속터미널,15070,11600,26670,4
2022-04-23,4호선,사당,22589,20082,42671,4
2022-04-23,4호선,서울역,6046,14150,20196,4
2022-04-23,3호선,고속터미널,50781,50391,101172,4
2022-04-23,2호선,홍대입구,61636,71134,132770,4
2022-04-23,2호선,구로디지털단지,34814,33815,68629,4
2022-04-23,2호선,신림,52100,48679,100779,4
2022-04-23,2호선,사당,32535,36175,68710,4
2022-04-23,2호선,강남,59767,61884,121651,4
2022-04-23,2호선,선릉,24083,21248,45331,4
2022-04-23,2호선,잠실(송파구청),70676,67442,138118,4
2022-04-23,1호선,서울역,33471,33971,67442,4
2022-04-24,3호선,고속터미널,41725,38752,80477,4
2022-04-24,4호선,서울역,4439,10698,15137,4
2022-04-24,4호선,사당,16138,14924,31062,4
2022-04-24,7호선,고속터미널,13288,8526,21814,4
2022-04-24,7호선,가산디지털단지,10909,10268,21177,4
2022-04-24,8호선,잠실(송파구청),9864,10979,20843,4
2022-04-24,9호선,고속터미널,10998,15074,26072,4
2022-04-24,경부선,서울역,8430,1857,10287,4
2022-04-24,경부선,가산디지털단지,5114,6844,11958,4
2022-04-24,경의선,홍대입구,1538,1780,3318,4
2022-04-24,경의선,서울역,1177,1033,2210,4
2022-04-24,분당선,선릉,2787,4466,7253,4
2022-04-24,공항철도 1호선,홍대입구,9704,8533,18237,4
2022-04-24,공항철도 1호선,서울역,8233,7633,15866,4
2022-04-24,2호선,잠실(송파구청),50924,47258,98182,4
2022-04-24,1호선,서울역,28573,25426,53999,4
2022-04-24,2호선,선릉,13405,11371,24776,4
2022-04-24,2호선,강남,33739,33002,66741,4
2022-04-24,2호선,사당,22223,24834,47057,4
2022-04-24,2호선,신림,37877,37384,75261,4
2022-04-24,2호선,구로디지털단지,23770,23285,47055,4
2022-04-24,2호선,홍대입구,45983,44710,90693,4
2022-04-25,1호선,서울역,43225,41194,84419,4
2022-04-25,2호선,잠실(송파구청),62971,63238,126209,4
2022-04-25,2호선,선릉,57856,51601,109457,4
2022-04-25,2호선,강남,80426,79937,160363,4
2022-04-25,2호선,사당,36084,40077,76161,4
2022-04-25,2호선,신림,62752,60758,123510,4
2022-04-25,2호선,구로디지털단지,59322,59394,118716,4
2022-04-25,2호선,홍대입구,48174,49775,97949,4
2022-04-25,3호선,고속터미널,37499,35634,73133,4
2022-04-25,4호선,서울역,11174,15926,27100,4
2022-04-25,4호선,사당,25162,21058,46220,4
2022-04-25,7호선,고속터미널,15797,13196,28993,4
2022-04-25,7호선,가산디지털단지,46960,47168,94128,4
2022-04-25,8호선,잠실(송파구청),12907,15130,28037,4
2022-04-25,9호선,고속터미널,11936,14628,26564,4
2022-04-25,경부선,서울역,6371,1944,8315,4
2022-04-25,경부선,가산디지털단지,19120,22087,41207,4
2022-04-25,경의선,서울역,4625,5998,10623,4
2022-04-25,경의선,홍대입구,1602,1825,3427,4
2022-04-25,공항철도 1호선,서울역,7808,7468,15276,4
2022-04-25,공항철도 1호선,홍대입구,8313,8597,16910,4
2022-04-25,분당선,선릉,13863,21307,35170,4
2022-04-26,분당선,선릉,14073,21803,35876,4
2022-04-26,공항철도 1호선,홍대입구,9316,9449,18765,4
2022-04-26,공항철도 1호선,서울역,7613,7141,14754,4
2022-04-26,경의선,홍대입구,1656,1962,3618,4
2022-04-26,경의선,서울역,4585,5919,10504,4
2022-04-26,경부선,가산디지털단지,19433,22488,41921,4
2022-04-26,경부선,서울역,5399,1800,7199,4
2022-04-26,9호선,고속터미널,12548,14937,27485,4
2022-04-26,8호선,잠실(송파구청),13691,16561,30252,4
2022-04-26,7호선,가산디지털단지,46895,47589,94484,4
2022-04-26,7호선,고속터미널,14956,13184,28140,4
2022-04-26,4호선,사당,26472,22262,48734,4
2022-04-26,4호선,서울역,11556,16230,27786,4
2022-04-26,3호선,고속터미널,38306,36627,74933,4
2022-04-26,2호선,홍대입구,52163,55069,107232,4
2022-04-26,2호선,구로디지털단지,60739,60861,121600,4
2022-04-26,2호선,신림,64286,61804,126090,4
2022-04-26,2호선,사당,37910,42348,80258,4
2022-04-26,2호선,강남,83830,83960,167790,4
2022-04-26,2호선,선릉,59363,52993,112356,4
2022-04-26,2호선,잠실(송파구청),70006,69398,139404,4
2022-04-26,1호선,서울역,42381,41142,83523,4
2022-04-27,1호선,서울역,44113,42814,86927,4
2022-04-27,2호선,잠실(송파구청),72175,71475,143650,4
2022-04-27,2호선,선릉,59987,53229,113216,4
2022-04-27,2호선,강남,85042,85309,170351,4
2022-04-27,2호선,사당,39488,44126,83614,4
2022-04-27,2호선,신림,65895,63348,129243,4
2022-04-27,2호선,구로디지털단지,61253,61282,122535,4
2022-04-27,2호선,홍대입구,54610,58262,112872,4
2022-04-27,3호선,고속터미널,40516,38697,79213,4
2022-04-27,4호선,서울역,11852,17312,29164,4
2022-04-27,4호선,사당,27920,22932,50852,4
2022-04-27,7호선,고속터미널,15264,13593,28857,4
2022-04-27,7호선,가산디지털단지,47189,47901,95090,4
2022-04-27,8호선,잠실(송파구청),13821,17007,30828,4
2022-04-27,9호선,고속터미널,12904,15895,28799,4
2022-04-27,경부선,서울역,5603,1890,7493,4
2022-04-27,경부선,가산디지털단지,19594,22545,42139,4
2022-04-27,경의선,서울역,4759,6189,10948,4
2022-04-27,경의선,홍대입구,1810,2090,3900,4
2022-04-27,공항철도 1호선,서울역,7901,7244,15145,4
2022-04-27,공항철도 1호선,홍대입구,9870,9868,19738,4
2022-04-27,분당선,선릉,14094,21892,35986,4
2022-04-28,1호선,서울역,46191,44495,90686,4
2022-04-28,2호선,잠실(송파구청),73908,73750,147658,4
2022-04-28,2호선,선릉,59741,53553,113294,4
2022-04-28,2호선,강남,86507,86984,173491,4
2022-04-28,2호선,사당,40336,44412,84748,4
2022-04-28,2호선,신림,65915,63203,129118,4
2022-04-28,2호선,구로디지털단지,61709,61722,123431,4
2022-04-28,2호선,홍대입구,57427,61400,118827,4
2022-04-28,3호선,고속터미널,42286,40000,82286,4
2022-04-28,4호선,서울역,12038,17891,29929,4
2022-04-28,4호선,사당,27575,23168,50743,4
2022-04-28,7호선,고속터미널,16068,13591,29659,4
2022-04-28,7호선,가산디지털단지,46675,47429,94104,4
2022-04-28,8호선,잠실(송파구청),14173,17223,31396,4
2022-04-28,9호선,고속터미널,13323,16441,29764,4
2022-04-28,경부선,서울역,6371,2084,8455,4
2022-04-28,경부선,가산디지털단지,19539,22771,42310,4
2022-04-28,경의선,서울역,4828,6227,11055,4
2022-04-28,경의선,홍대입구,1856,2352,4208,4
2022-04-28,공항철도 1호선,서울역,8749,7986,16735,4
2022-04-28,공항철도 1호선,홍대입구,10264,10412,20676,4
2022-04-28,분당선,선릉,14117,21997,36114,4
2022-04-29,9호선,고속터미널,15577,20148,35725,4
2022-04-29,1호선,서울역,52299,51354,103653,4
2022-04-29,2호선,잠실(송파구청),83090,83175,166265,4
2022-04-29,2호선,선릉,59219,53172,112391,4
2022-04-29,2호선,강남,93091,96321,189412,4
2022-04-29,2호선,사당,41945,47761,89706,4
2022-04-29,2호선,신림,68950,65322,134272,4
2022-04-29,2호선,구로디지털단지,62347,61931,124278,4
2022-04-29,2호선,홍대입구,64651,74522,139173,4
2022-04-29,3호선,고속터미널,50671,52510,103181,4
2022-04-29,4호선,서울역,12223,20558,32781,4
2022-04-29,4호선,사당,29595,24844,54439,4
2022-04-29,7호선,고속터미널,19559,15335,34894,4
2022-04-29,7호선,가산디지털단지,46231,46574,92805,4
2022-04-29,8호선,잠실(송파구청),15176,19286,34462,4
2022-04-29,경부선,서울역,9290,2984,12274,4
2022-04-29,경부선,가산디지털단지,19205,22240,41445,4
2022-04-29,경의선,서울역,4857,6481,11338,4
2022-04-29,경의선,홍대입구,2093,2799,4892,4
2022-04-29,공항철도 1호선,서울역,10526,9857,20383,4
2022-04-29,공항철도 1호선,홍대입구,11955,12822,24777,4
2022-04-29,분당선,선릉,13966,21936,35902,4
2022-04-30,1호선,서울역,38627,38918,77545,4
2022-04-30,2호선,잠실(송파구청),85814,81830,167644,4
2022-04-30,2호선,선릉,25669,22986,48655,4
2022-04-30,2호선,강남,66438,69086,135524,4
2022-04-30,2호선,사당,33689,38925,72614,4
2022-04-30,2호선,신림,53593,50901,104494,4
2022-04-30,2호선,구로디지털단지,36372,35338,71710,4
2022-04-30,2호선,홍대입구,76902,86985,163887,4
2022-04-30,3호선,고속터미널,57031,57063,114094,4
2022-04-30,4호선,서울역,6969,16286,23255,4
2022-04-30,4호선,사당,24972,21031,46003,4
2022-04-30,7호선,고속터미널,17098,12753,29851,4
2022-04-30,7호선,가산디지털단지,15867,14244,30111,4
2022-04-30,8호선,잠실(송파구청),14219,17507,31726,4
2022-04-30,9호선,고속터미널,15611,22499,38110,4
2022-04-30,경부선,서울역,9068,2357,11425,4
2022-04-30,경부선,가산디지털단지,6907,9190,16097,4
2022-04-30,경의선,서울역,1631,1709,3340,4
2022-04-30,경의선,홍대입구,2373,3081,5454,4
2022-04-30,공항철도 1호선,서울역,8962,9292,18254,4
2022-04-30,공항철도 1호선,홍대입구,14017,14877,28894,4
2022-04-30,분당선,선릉,5336,8630,13966,4
2022-05-01,7호선,가산디지털단지,11663,10814,22477,5
2022-05-01,8호선,잠실(송파구청),10802,12451,23253,5
2022-05-01,9호선,고속터미널,12979,18275,31254,5
2022-05-01,경부선,서울역,9183,2158,11341,5
2022-05-01,경부선,가산디지털단지,5362,7168,12530,5
2022-05-01,경의선,서울역,1396,1189,2585,5
2022-05-01,경의선,홍대입구,1817,2346,4163,5
2022-05-01,2호선,홍대입구,57854,55945,113799,5
2022-05-01,3호선,고속터미널,47617,44736,92353,5
2022-05-01,4호선,서울역,5352,12778,18130,5
2022-05-01,4호선,사당,17727,16043,33770,5
2022-05-01,7호선,고속터미널,15699,9196,24895,5
2022-05-01,1호선,서울역,33748,31073,64821,5
2022-05-01,2호선,잠실(송파구청),59365,54817,114182,5
2022-05-01,2호선,선릉,14314,12418,26732,5
2022-05-01,2호선,강남,38056,36569,74625,5
2022-05-01,2호선,사당,23673,26878,50551,5
2022-05-01,2호선,신림,39818,39446,79264,5
2022-05-01,2호선,구로디지털단지,25245,24996,50241,5
2022-05-01,분당선,선릉,3042,4714,7756,5
2022-05-01,공항철도 1호선,홍대입구,11641,10604,22245,5
2022-05-01,공항철도 1호선,서울역,8982,8743,17725,5
2022-05-02,1호선,서울역,45673,43758,89431,5
2022-05-02,분당선,선릉,14087,21845,35932,5
2022-05-02,공항철도 1호선,홍대입구,9418,9507,18925,5
2022-05-02,공항철도 1호선,서울역,7919,7837,15756,5
2022-05-02,경의선,홍대입구,1761,2052,3813,5
2022-05-02,경의선,서울역,4883,6358,11241,5
2022-05-02,경부선,가산디지털단지,19659,22744,42403,5
2022-05-02,경부선,서울역,6963,2105,9068,5
2022-05-02,9호선,고속터미널,12893,16168,29061,5
2022-05-02,8호선,잠실(송파구청),13864,16577,30441,5
2022-05-02,7호선,가산디지털단지,47794,48108,95902,5
2022-05-02,7호선,고속터미널,16532,13743,30275,5
2022-05-02,4호선,사당,26638,21942,48580,5
2022-05-02,4호선,서울역,11835,17148,28983,5
2022-05-02,3호선,고속터미널,40678,39063,79741,5
2022-05-02,2호선,홍대입구,53960,56177,110137,5
2022-05-02,2호선,구로디지털단지,62297,62595,124892,5
2022-05-02,2호선,신림,64672,62554,127226,5
2022-05-02,2호선,사당,37312,42186,79498,5
2022-05-02,2호선,강남,85393,85295,170688,5
2022-05-02,2호선,선릉,59566,53209,112775,5
2022-05-02,2호선,잠실(송파구청),68721,68507,137228,5
2022-05-03,1호선,서울역,45870,44727,90597,5
2022-05-03,2호선,잠실(송파구청),75014,74545,149559,5
2022-05-03,2호선,선릉,61813,55197,117010,5
2022-05-03,2호선,강남,89088,88707,177795,5
2022-05-03,2호선,사당,39709,44972,84681,5
2022-05-03,2호선,신림,66239,63909,130148,5
2022-05-03,2호선,구로디지털단지,64059,63795,127854,5
2022-05-03,2호선,홍대입구,57602,60311,117913,5
2022-05-03,3호선,고속터미널,41179,39470,80649,5
2022-05-03,4호선,서울역,11900,17304,29204,5
2022-05-03,4호선,사당,27975,23626,51601,5
2022-05-03,7호선,고속터미널,16032,13840,29872,5
2022-05-03,7호선,가산디지털단지,47871,48686,96557,5
2022-05-03,8호선,잠실(송파구청),14184,17385,31569,5
2022-05-03,9호선,고속터미널,13331,16138,29469,5
2022-05-03,경부선,서울역,6039,2073,8112,5
2022-05-03,경부선,가산디지털단지,19964,22908,42872,5
2022-05-03,경의선,서울역,4793,6354,11147,5
2022-05-03,경의선,홍대입구,1875,2108,3983,5
2022-05-03,공항철도 1호선,서울역,8096,7653,15749,5
2022-05-03,공항철도 1호선,홍대입구,10003,9838,19841,5
2022-05-03,분당선,선릉,14493,22756,37249,5
2022-05-04,1호선,서울역,52571,53277,105848,5
2022-05-04,2호선,잠실(송파구청),89416,88746,178162,5
2022-05-04,2호선,선릉,62292,55563,117855,5
2022-05-04,2호선,강남,92790,96266,189056,5
2022-05-04,2호선,사당,42733,48600,91333,5
2022-05-04,2호선,신림,70417,67157,137574,5
2022-05-04,2호선,구로디지털단지,65587,65275,130862,5
2022-05-04,2호선,홍대입구,64057,73255,137312,5
2022-05-04,3호선,고속터미널,50211,54701,104912,5
2022-05-04,4호선,서울역,12991,21562,34553,5
2022-05-04,4호선,사당,30185,26472,56657,5
2022-05-04,7호선,고속터미널,18902,16020,34922,5
2022-05-04,7호선,가산디지털단지,48803,49217,98020,5
2022-05-04,8호선,잠실(송파구청),16210,20896,37106,5
2022-05-04,9호선,고속터미널,16179,22042,38221,5
2022-05-04,경부선,서울역,8460,3087,11547,5
2022-05-04,경부선,가산디지털단지,20774,23558,44332,5
2022-05-04,경의선,서울역,5117,6976,12093,5
2022-05-04,경의선,홍대입구,2135,2792,4927,5
2022-05-04,공항철도 1호선,서울역,10310,9666,19976,5
2022-05-04,공항철도 1호선,홍대입구,11673,12357,24030,5
2022-05-04,분당선,선릉,14701,22749,37450,5
2022-05-05,1호선,서울역,30025,33845,63870,5
2022-05-05,4호선,사당,19545,16729,36274,5
2022-05-05,4호선,서울역,5295,13504,18799,5
2022-05-05,3호선,고속터미널,49069,50519,99588,5
2022-05-05,2호선,홍대입구,74028,78388,152416,5
2022-05-05,2호선,잠실(송파구청),63053,61565,124618,5
2022-05-05,2호선,선릉,17092,14839,31931,5
2022-05-05,2호선,강남,42209,41967,84176,5
2022-05-05,2호선,사당,25763,28714,54477,5
2022-05-05,2호선,신림,45124,42941,88065,5
2022-05-05,2호선,구로디지털단지,29179,28181,57360,5
2022-05-05,7호선,가산디지털단지,13551,12431,25982,5
2022-05-05,8호선,잠실(송파구청),13254,15228,28482,5
2022-05-05,9호선,고속터미널,14246,20604,34850,5
2022-05-05,경부선,서울역,7148,2203,9351,5
2022-05-05,경부선,가산디지털단지,5842,7423,13265,5
2022-05-05,경의선,서울역,1514,1514,3028,5
2022-05-05,경의선,홍대입구,2504,3105,5609,5
2022-05-05,공항철도 1호선,서울역,7702,8862,16564,5
2022-05-05,공항철도 1호선,홍대입구,14645,14071,28716,5
2022-05-05,분당선,선릉,3421,5388,8809,5
2022-05-05,7호선,고속터미널,12595,9784,22379,5
2022-05-06,3호선,고속터미널,55473,59848,115321,5
2022-05-06,4호선,서울역,10566,20249,30815,5
2022-05-06,4호선,사당,27143,22819,49962,5
2022-05-06,경의선,서울역,4241,5880,10121,5
2022-05-06,경의선,홍대입구,2521,3310,5831,5
2022-05-06,공항철도 1호선,서울역,9752,10099,19851,5
2022-05-06,공항철도 1호선,홍대입구,14443,14153,28596,5
2022-05-06,분당선,선릉,11441,17668,29109,5
2022-05-06,7호선,고속터미널,19146,15054,34200,5
2022-05-06,7호선,가산디지털단지,36084,35425,71509,5
2022-05-06,8호선,잠실(송파구청),15891,20512,36403,5
2022-05-06,9호선,고속터미널,16847,23636,40483,5
2022-05-06,경부선,서울역,8787,2901,11688,5
2022-05-06,경부선,가산디지털단지,14773,17562,32335,5
2022-05-06,1호선,서울역,46752,49960,96712,5
2022-05-06,2호선,잠실(송파구청),97288,95576,192864,5
2022-05-06,2호선,선릉,49472,43978,93450,5
2022-05-06,2호선,강남,83589,86126,169715,5
2022-05-06,2호선,사당,37182,43002,80184,5
2022-05-06,2호선,신림,64454,61364,125818,5
2022-05-06,2호선,구로디지털단지,54011,52957,106968,5
2022-05-06,2호선,홍대입구,75514,83336,158850,5
2022-05-07,1호선,서울역,37322,37087,74409,5
2022-05-07,2호선,잠실(송파구청),68485,65849,134334,5
2022-05-07,2호선,선릉,22728,19809,42537,5
2022-05-07,2호선,강남,57070,58990,116060,5
2022-05-07,2호선,사당,29462,33549,63011,5
2022-05-07,2호선,신림,50317,46971,97288,5
2022-05-07,2호선,구로디지털단지,32793,31876,64669,5
2022-05-07,2호선,홍대입구,67876,76048,143924,5
2022-05-07,3호선,고속터미널,55663,58892,114555,5
2022-05-07,4호선,서울역,5887,15318,21205,5
2022-05-07,4호선,사당,21579,18722,40301,5
2022-05-07,7호선,고속터미널,16852,12313,29165,5
2022-05-07,7호선,가산디지털단지,14462,13037,27499,5
2022-05-07,8호선,잠실(송파구청),12525,15407,27932,5
2022-05-07,9호선,고속터미널,15704,22561,38265,5
2022-05-07,경부선,서울역,9801,2244,12045,5
2022-05-07,경부선,가산디지털단지,6395,8497,14892,5
2022-05-07,경의선,서울역,1608,1619,3227,5
2022-05-07,경의선,홍대입구,2105,2747,4852,5
2022-05-07,공항철도 1호선,서울역,9881,9520,19401,5
2022-05-07,공항철도 1호선,홍대입구,13502,12814,26316,5
2022-05-07,분당선,선릉,4849,7312,12161,5
2022-05-08,분당선,선릉,2667,4036,6703,5
2022-05-08,공항철도 1호선,홍대입구,9142,8702,17844,5
2022-05-08,공항철도 1호선,서울역,10529,8703,19232,5
2022-05-08,경의선,홍대입구,1475,1817,3292,5
2022-05-08,경의선,서울역,1354,1203,2557,5
2022-05-08,경부선,가산디지털단지,4762,7100,11862,5
2022-05-08,경부선,서울역,10371,2212,12583,5
2022-05-08,9호선,고속터미널,13328,16315,29643,5
2022-05-08,8호선,잠실(송파구청),9941,10725,20666,5
2022-05-08,7호선,가산디지털단지,10205,9793,19998,5
2022-05-08,7호선,고속터미널,19482,8335,27817,5
2022-05-08,4호선,사당,15379,14210,29589,5
2022-05-08,4호선,서울역,4455,11432,15887,5
2022-05-08,3호선,고속터미널,53797,43248,97045,5
2022-05-08,2호선,홍대입구,46577,45177,91754,5
2022-05-08,2호선,구로디지털단지,23076,23436,46512,5
2022-05-08,2호선,신림,36601,38308,74909,5
2022-05-08,2호선,사당,20289,22860,43149,5
2022-05-08,2호선,강남,30625,29556,60181,5
2022-05-08,2호선,선릉,12118,10529,22647,5
2022-05-08,2호선,잠실(송파구청),48619,44639,93258,5
2022-05-08,1호선,서울역,33122,28886,62008,5
2022-05-09,1호선,서울역,49727,44700,94427,5
2022-05-09,2호선,잠실(송파구청),69671,69438,139109,5
2022-05-09,2호선,선릉,59743,53654,113397,5
2022-05-09,2호선,강남,85160,85124,170284,5
2022-05-09,2호선,사당,38307,42562,80869,5
2022-05-09,2호선,신림,65102,63476,128578,5
2022-05-09,2호선,구로디지털단지,61683,62005,123688,5
2022-05-09,2호선,홍대입구,54109,57113,111222,5
2022-05-09,3호선,고속터미널,43935,39263,83198,5
2022-05-09,4호선,서울역,11927,17205,29132,5
2022-05-09,4호선,사당,26695,22575,49270,5
2022-05-09,7호선,고속터미널,18523,14135,32658,5
2022-05-09,7호선,가산디지털단지,47705,48044,95749,5
2022-05-09,8호선,잠실(송파구청),13402,16420,29822,5
2022-05-09,9호선,고속터미널,13766,16295,30061,5
2022-05-09,경부선,서울역,9424,2152,11576,5
2022-05-09,경부선,가산디지털단지,19980,23063,43043,5
2022-05-09,경의선,서울역,5085,6493,11578,5
2022-05-09,경의선,홍대입구,1766,2039,3805,5
2022-05-09,공항철도 1호선,서울역,9469,8195,17664,5
2022-05-09,공항철도 1호선,홍대입구,9586,9863,19449,5
2022-05-09,분당선,선릉,14194,22064,36258,5
2022-05-10,분당선,선릉,14923,23038,37961,5
2022-05-10,공항철도 1호선,홍대입구,10109,10417,20526,5
2022-05-10,공항철도 1호선,서울역,8760,7781,16541,5
2022-05-10,경의선,홍대입구,1799,2141,3940,5
2022-05-10,경의선,서울역,4956,6526,11482,5
2022-05-10,경부선,가산디지털단지,20145,23169,43314,5
2022-05-10,경부선,서울역,6532,1935,8467,5
2022-05-10,9호선,고속터미널,13644,16406,30050,5
2022-05-10,8호선,잠실(송파구청),13803,16857,30660,5
2022-05-10,7호선,가산디지털단지,48553,48963,97516,5
2022-05-10,7호선,고속터미널,16391,14175,30566,5
2022-05-10,4호선,사당,28265,23747,52012,5
2022-05-10,4호선,서울역,12657,18416,31073,5
2022-05-10,3호선,고속터미널,41378,38980,80358,5
2022-05-10,2호선,홍대입구,56509,59369,115878,5
2022-05-10,2호선,구로디지털단지,63675,63944,127619,5
2022-05-10,2호선,신림,66885,64838,131723,5
2022-05-10,2호선,사당,40351,44976,85327,5
2022-05-10,2호선,강남,88221,88430,176651,5
2022-05-10,2호선,선릉,62600,55994,118594,5
2022-05-10,2호선,잠실(송파구청),70874,70460,141334,5
2022-05-10,1호선,서울역,48574,46887,95461,5
2022-05-11,4호선,사당,28543,24164,52707,5
2022-05-11,4호선,서울역,12539,18231,30770,5
2022-05-11,1호선,서울역,47203,45505,92708,5
2022-05-11,3호선,고속터미널,41975,39582,81557,5
2022-05-11,2호선,홍대입구,57766,61402,119168,5
2022-05-11,2호선,구로디지털단지,63856,63572,127428,5
2022-05-11,2호선,신림,68116,65609,133725,5
2022-05-11,2호선,사당,41518,45744,87262,5
2022-05-11,2호선,강남,88738,88348,177086,5
2022-05-11,2호선,선릉,61834,54903,116737,5
2022-05-11,2호선,잠실(송파구청),72020,71627,143647,5
2022-05-11,분당선,선릉,14599,22811,37410,5
2022-05-11,공항철도 1호선,홍대입구,10363,10559,20922,5
2022-05-11,공항철도 1호선,서울역,8522,7732,16254,5
2022-05-11,경의선,홍대입구,1867,2255,4122,5
2022-05-11,경의선,서울역,4917,6510,11427,5
2022-05-11,경부선,가산디지털단지,20286,23316,43602,5
2022-05-11,경부선,서울역,6347,2068,8415,5
2022-05-11,9호선,고속터미널,13578,16428,30006,5
2022-05-11,8호선,잠실(송파구청),14106,17560,31666,5
2022-05-11,7호선,가산디지털단지,48308,48771,97079,5
2022-05-11,7호선,고속터미널,16123,14221,30344,5
2022-05-12,2호선,선릉,61530,54859,116389,5
2022-05-12,2호선,강남,88571,88898,177469,5
2022-05-12,2호선,사당,40758,45877,86635,5
2022-05-12,2호선,신림,67276,64523,131799,5
2022-05-12,2호선,구로디지털단지,63751,63712,127463,5
2022-05-12,2호선,홍대입구,57925,62274,120199,5
2022-05-12,3호선,고속터미널,43918,41867,85785,5
2022-05-12,분당선,선릉,14415,22495,36910,5
2022-05-12,공항철도 1호선,홍대입구,10490,10697,21187,5
2022-05-12,공항철도 1호선,서울역,9019,8129,17148,5
2022-05-12,경의선,홍대입구,1884,2314,4198,5
2022-05-12,경의선,서울역,5103,6563,11666,5
2022-05-12,경부선,가산디지털단지,19999,23258,43257,5
2022-05-12,경부선,서울역,6964,2194,9158,5
2022-05-12,9호선,고속터미널,14036,16923,30959,5
2022-05-12,8호선,잠실(송파구청),14261,17235,31496,5
2022-05-12,7호선,가산디지털단지,48152,48705,96857,5
2022-05-12,7호선,고속터미널,16655,14337,30992,5
2022-05-12,4호선,사당,29445,24442,53887,5
2022-05-12,4호선,서울역,12783,19266,32049,5
2022-05-12,1호선,서울역,49050,47408,96458,5
2022-05-12,2호선,잠실(송파구청),73355,73150,146505,5
2022-05-13,7호선,가산디지털단지,47798,47469,95267,5
2022-05-13,7호선,고속터미널,19407,15581,34988,5
2022-05-13,4호선,사당,31678,27837,59515,5
2022-05-13,4호선,서울역,12854,22527,35381,5
2022-05-13,3호선,고속터미널,53290,53660,106950,5
2022-05-13,2호선,홍대입구,65087,74675,139762,5
2022-05-13,2호선,구로디지털단지,64918,64005,128923,5
2022-05-13,경의선,홍대입구,2211,2737,4948,5
2022-05-13,경의선,서울역,5068,6887,11955,5
2022-05-13,경부선,가산디지털단지,19956,22988,42944,5
2022-05-13,경부선,서울역,9942,3122,13064,5
2022-05-13,9호선,고속터미널,16942,21915,38857,5
2022-05-13,2호선,신림,71101,68299,139400,5
2022-05-13,2호선,사당,44928,50867,95795,5
2022-05-13,2호선,강남,95342,98137,193479,5
2022-05-13,2호선,선릉,61482,54954,116436,5
2022-05-13,2호선,잠실(송파구청),81273,80248,161521,5
2022-05-13,8호선,잠실(송파구청),15566,19779,35345,5
2022-05-13,1호선,서울역,54795,54091,108886,5
2022-05-13,분당선,선릉,14386,22597,36983,5
2022-05-13,공항철도 1호선,홍대입구,12234,13005,25239,5
2022-05-13,공항철도 1호선,서울역,11207,10559,21766,5
2022-05-14,공항철도 1호선,서울역,10024,10306,20330,5
2022-05-14,공항철도 1호선,홍대입구,15190,15899,31089,5
2022-05-14,분당선,선릉,6050,9496,15546,5
2022-05-14,1호선,서울역,41604,41135,82739,5
2022-05-14,2호선,잠실(송파구청),76870,73746,150616,5
2022-05-14,2호선,선릉,28053,24739,52792,5
2022-05-14,2호선,강남,69464,71428,140892,5
2022-05-14,2호선,사당,37850,43019,80869,5
2022-05-14,2호선,신림,56729,54171,110900,5
2022-05-14,2호선,구로디지털단지,37956,36873,74829,5
2022-05-14,2호선,홍대입구,79716,89438,169154,5
2022-05-14,3호선,고속터미널,61703,60529,122232,5
2022-05-14,4호선,서울역,6979,17651,24630,5
2022-05-14,4호선,사당,26381,23328,49709,5
2022-05-14,7호선,고속터미널,18122,13466,31588,5
2022-05-14,7호선,가산디지털단지,16448,15029,31477,5
2022-05-14,8호선,잠실(송파구청),14160,16835,30995,5
2022-05-14,9호선,고속터미널,17602,24653,42255,5
2022-05-14,경부선,서울역,9956,2640,12596,5
2022-05-14,경부선,가산디지털단지,7325,9449,16774,5
2022-05-14,경의선,서울역,1766,1815,3581,5
2022-05-14,경의선,홍대입구,2470,3327,5797,5
2022-05-15,분당선,선릉,3316,4926,8242,5
2022-05-15,공항철도 1호선,홍대입구,12658,11193,23851,5
2022-05-15,공항철도 1호선,서울역,9681,9323,19004,5
2022-05-15,경의선,홍대입구,2024,2533,4557,5
2022-05-15,경의선,서울역,1338,1274,2612,5
2022-05-15,경부선,가산디지털단지,5349,7510,12859,5
2022-05-15,경부선,서울역,10010,2244,12254,5
2022-05-15,9호선,고속터미널,14207,19418,33625,5
2022-05-15,8호선,잠실(송파구청),10836,12658,23494,5
2022-05-15,7호선,가산디지털단지,12036,10962,22998,5
2022-05-15,7호선,고속터미널,15851,9870,25721,5
2022-05-15,4호선,사당,19232,17552,36784,5
2022-05-15,4호선,서울역,5227,14358,19585,5
2022-05-15,3호선,고속터미널,51747,48046,99793,5
2022-05-15,2호선,홍대입구,61588,60042,121630,5
2022-05-15,2호선,구로디지털단지,26822,26267,53089,5
2022-05-15,2호선,신림,42036,41066,83102,5
2022-05-15,2호선,사당,26470,29678,56148,5
2022-05-15,2호선,강남,40551,39350,79901,5
2022-05-15,2호선,선릉,15372,13013,28385,5
2022-05-15,2호선,잠실(송파구청),57308,52377,109685,5
2022-05-15,1호선,서울역,34298,32629,66927,5
2022-05-16,1호선,서울역,48277,46482,94759,5
2022-05-16,2호선,잠실(송파구청),69088,69289,138377,5
2022-05-16,2호선,선릉,60858,54254,115112,5
2022-05-16,2호선,강남,85811,85928,171739,5
2022-05-16,2호선,사당,39592,43532,83124,5
2022-05-16,2호선,신림,66090,63775,129865,5
2022-05-16,2호선,구로디지털단지,62615,62738,125353,5
2022-05-16,2호선,홍대입구,55746,57996,113742,5
2022-05-16,3호선,고속터미널,36967,35862,72829,5
2022-05-16,4호선,서울역,12254,18202,30456,5
2022-05-16,4호선,사당,27265,23146,50411,5
2022-05-16,7호선,고속터미널,17118,14008,31126,5
2022-05-16,7호선,가산디지털단지,48386,48602,96988,5
2022-05-16,8호선,잠실(송파구청),13965,16717,30682,5
2022-05-16,9호선,고속터미널,13135,16151,29286,5
2022-05-16,경부선,서울역,7539,2297,9836,5
2022-05-16,경부선,가산디지털단지,20172,23159,43331,5
2022-05-16,경의선,서울역,4979,6558,11537,5
2022-05-16,경의선,홍대입구,1758,2081,3839,5
2022-05-16,공항철도 1호선,서울역,8737,8234,16971,5
2022-05-16,공항철도 1호선,홍대입구,10068,10247,20315,5
2022-05-16,분당선,선릉,14383,22413,36796,5
2022-05-17,1호선,서울역,47179,45823,93002,5
2022-05-17,2호선,잠실(송파구청),71882,71635,143517,5
2022-05-17,2호선,선릉,62343,55604,117947,5
2022-05-17,2호선,강남,88303,88202,176505,5
2022-05-17,2호선,사당,41212,45344,86556,5
2022-05-17,2호선,신림,66735,64527,131262,5
2022-05-17,2호선,구로디지털단지,63928,64152,128080,5
2022-05-17,2호선,홍대입구,55921,58779,114700,5
2022-05-17,3호선,고속터미널,42076,40063,82139,5
2022-05-17,4호선,서울역,12671,18282,30953,5
2022-05-17,4호선,사당,28085,24152,52237,5
2022-05-17,7호선,고속터미널,16278,14250,30528,5
2022-05-17,7호선,가산디지털단지,48454,48795,97249,5
2022-05-17,8호선,잠실(송파구청),13791,17011,30802,5
2022-05-17,9호선,고속터미널,13707,16566,30273,5
2022-05-17,경부선,서울역,6363,2065,8428,5
2022-05-17,경부선,가산디지털단지,20184,23278,43462,5
2022-05-17,경의선,서울역,4958,6668,11626,5
2022-05-17,경의선,홍대입구,1838,2101,3939,5
2022-05-17,공항철도 1호선,서울역,8466,7674,16140,5
2022-05-17,공항철도 1호선,홍대입구,10126,10137,20263,5
2022-05-17,분당선,선릉,14616,22844,37460,5
2022-05-18,공항철도 1호선,서울역,8515,7828,16343,5
2022-05-18,공항철도 1호선,홍대입구,10209,10323,20532,5
2022-05-18,분당선,선릉,14677,22962,37639,5
2022-05-18,7호선,고속터미널,16065,14136,30201,5
2022-05-18,7호선,가산디지털단지,48001,48770,96771,5
2022-05-18,8호선,잠실(송파구청),13974,16956,30930,5
2022-05-18,9호선,고속터미널,13293,16391,29684,5
2022-05-18,경부선,서울역,6331,2177,8508,5
2022-05-18,경부선,가산디지털단지,20122,22668,42790,5
2022-05-18,경의선,서울역,4942,6523,11465,5
2022-05-18,경의선,홍대입구,1909,2164,4073,5
2022-05-18,4호선,사당,28030,23899,51929,5
2022-05-18,4호선,서울역,12727,18384,31111,5
2022-05-18,3호선,고속터미널,41451,39466,80917,5
2022-05-18,2호선,홍대입구,56039,59495,115534,5
2022-05-18,2호선,구로디지털단지,63303,63270,126573,5
2022-05-18,2호선,신림,68145,65335,133480,5
2022-05-18,2호선,사당,40948,45794,86742,5
2022-05-18,2호선,강남,87386,87842,175228,5
2022-05-18,2호선,선릉,61677,54670,116347,5
2022-05-18,2호선,잠실(송파구청),70347,70359,140706,5
2022-05-18,1호선,서울역,47049,45696,92745,5
2022-05-19,1호선,서울역,49283,48314,97597,5
2022-05-19,3호선,고속터미널,43155,41202,84357,5
2022-05-19,4호선,서울역,12855,19041,31896,5
2022-05-19,4호선,사당,28442,24894,53336,5
2022-05-19,7호선,고속터미널,16527,14039,30566,5
2022-05-19,7호선,가산디지털단지,47718,48310,96028,5
2022-05-19,8호선,잠실(송파구청),14574,17558,32132,5
2022-05-19,9호선,고속터미널,14192,17073,31265,5
2022-05-19,경부선,서울역,7114,2214,9328,5
2022-05-19,경부선,가산디지털단지,20155,23499,43654,5
2022-05-19,경의선,서울역,5179,6690,11869,5
2022-05-19,경의선,홍대입구,1906,2280,4186,5
2022-05-19,공항철도 1호선,서울역,9292,8427,17719,5
2022-05-19,공항철도 1호선,홍대입구,10718,10808,21526,5
2022-05-19,분당선,선릉,14703,22886,37589,5
2022-05-19,2호선,홍대입구,57447,61992,119439,5
2022-05-19,2호선,구로디지털단지,63666,63502,127168,5
2022-05-19,2호선,신림,68188,65433,133621,5
2022-05-19,2호선,사당,42834,47396,90230,5
2022-05-19,2호선,강남,88291,88726,177017,5
2022-05-19,2호선,선릉,62852,55892,118744,5
2022-05-19,2호선,잠실(송파구청),72667,73015,145682,5
2022-05-20,1호선,서울역,55250,54967,110217,5
2022-05-20,2호선,잠실(송파구청),83341,83730,167071,5
2022-05-20,2호선,선릉,61514,55016,116530,5
2022-05-20,2호선,강남,95179,98286,193465,5
2022-05-20,2호선,사당,45373,50762,96135,5
2022-05-20,2호선,신림,70661,67353,138014,5
2022-05-20,2호선,구로디지털단지,64353,63778,128131,5
2022-05-20,2호선,홍대입구,64144,74950,139094,5
2022-05-20,3호선,고속터미널,54268,54292,108560,5
2022-05-20,4호선,서울역,12847,22516,35363,5
2022-05-20,4호선,사당,30589,26588,57177,5
2022-05-20,7호선,고속터미널,20110,16014,36124,5
2022-05-20,7호선,가산디지털단지,46932,47075,94007,5
2022-05-20,8호선,잠실(송파구청),15745,20197,35942,5
2022-05-20,9호선,고속터미널,16782,21832,38614,5
2022-05-20,경부선,서울역,10230,3291,13521,5
2022-05-20,경부선,가산디지털단지,19947,22856,42803,5
2022-05-20,경의선,서울역,5163,6796,11959,5
2022-05-20,경의선,홍대입구,2244,2760,5004,5
2022-05-20,공항철도 1호선,서울역,11465,10569,22034,5
2022-05-20,공항철도 1호선,홍대입구,12488,13107,25595,5
2022-05-20,분당선,선릉,14499,22559,37058,5
2022-05-21,1호선,서울역,41094,40983,82077,5
2022-05-21,경부선,가산디지털단지,7147,9438,16585,5
2022-05-21,2호선,잠실(송파구청),75959,72960,148919,5
2022-05-21,2호선,선릉,26911,23615,50526,5
2022-05-21,2호선,강남,66742,68983,135725,5
2022-05-21,2호선,사당,38219,42759,80978,5
2022-05-21,2호선,신림,56721,53379,110100,5
2022-05-21,2호선,구로디지털단지,38013,36715,74728,5
2022-05-21,2호선,홍대입구,75077,84773,159850,5
2022-05-21,3호선,고속터미널,60824,59526,120350,5
2022-05-21,4호선,서울역,6922,17057,23979,5
2022-05-21,4호선,사당,26063,23123,49186,5
2022-05-21,7호선,고속터미널,17839,13350,31189,5
2022-05-21,7호선,가산디지털단지,15868,14444,30312,5
2022-05-21,8호선,잠실(송파구청),14369,17482,31851,5
2022-05-21,9호선,고속터미널,17294,24327,41621,5
2022-05-21,경부선,서울역,10808,2494,13302,5
2022-05-21,분당선,선릉,5802,8832,14634,5
2022-05-21,공항철도 1호선,홍대입구,14566,14771,29337,5
2022-05-21,공항철도 1호선,서울역,10131,10217,20348,5
2022-05-21,경의선,홍대입구,2395,3231,5626,5
2022-05-21,경의선,서울역,1816,1867,3683,5
2022-05-22,경의선,서울역,1386,1317,2703,5
2022-05-22,경부선,가산디지털단지,5491,7349,12840,5
2022-05-22,1호선,서울역,33518,32027,65545,5
2022-05-22,2호선,잠실(송파구청),55344,51154,106498,5
2022-05-22,2호선,선릉,14775,12524,27299,5
2022-05-22,2호선,강남,38536,37549,76085,5
2022-05-22,2호선,사당,25895,28478,54373,5
2022-05-22,2호선,신림,40954,40320,81274,5
2022-05-22,2호선,구로디지털단지,26312,25616,51928,5
2022-05-22,2호선,홍대입구,56315,55215,111530,5
2022-05-22,3호선,고속터미널,49821,46475,96296,5
2022-05-22,4호선,서울역,5235,14126,19361,5
2022-05-22,4호선,사당,18169,16821,34990,5
2022-05-22,7호선,고속터미널,15523,9795,25318,5
2022-05-22,7호선,가산디지털단지,11839,11167,23006,5
2022-05-22,8호선,잠실(송파구청),10975,12821,23796,5
2022-05-22,9호선,고속터미널,14254,19454,33708,5
2022-05-22,경부선,서울역,9966,2244,12210,5
2022-05-22,분당선,선릉,3062,4661,7723,5
2022-05-22,공항철도 1호선,홍대입구,12080,10722,22802,5
2022-05-22,공항철도 1호선,서울역,9699,9539,19238,5
2022-05-22,경의선,홍대입구,1936,2426,4362,5
2022-05-23,경의선,서울역,5088,6560,11648,5
2022-05-23,경부선,서울역,7772,2362,10134,5
2022-05-23,9호선,고속터미널,13324,16651,29975,5
2022-05-23,8호선,잠실(송파구청),13591,16147,29738,5
2022-05-23,7호선,가산디지털단지,47890,48313,96203,5
2022-05-23,7호선,고속터미널,16628,13924,30552,5
2022-05-23,4호선,사당,26537,22516,49053,5
2022-05-23,4호선,서울역,12144,18085,30229,5
2022-05-23,3호선,고속터미널,41803,40538,82341,5
2022-05-23,2호선,홍대입구,53965,56363,110328,5
2022-05-23,2호선,구로디지털단지,61623,61844,123467,5
2022-05-23,2호선,신림,64971,62918,127889,5
2022-05-23,2호선,사당,38492,42829,81321,5
2022-05-23,2호선,강남,85230,84987,170217,5
2022-05-23,2호선,선릉,60734,54179,114913,5
2022-05-23,2호선,잠실(송파구청),66255,66923,133178,5
2022-05-23,1호선,서울역,47889,46597,94486,5
2022-05-23,경부선,가산디지털단지,19940,22999,42939,5
2022-05-23,분당선,선릉,14304,22187,36491,5
2022-05-23,공항철도 1호선,홍대입구,9860,9912,19772,5
2022-05-23,공항철도 1호선,서울역,8784,8623,17407,5
2022-05-23,경의선,홍대입구,1749,2018,3767,5
2022-05-24,경부선,가산디지털단지,19839,22989,42828,5
2022-05-24,경부선,서울역,6444,1997,8441,5
2022-05-24,9호선,고속터미널,13980,16568,30548,5
2022-05-24,8호선,잠실(송파구청),14165,17079,31244,5
2022-05-24,7호선,가산디지털단지,48266,48605,96871,5
2022-05-24,7호선,고속터미널,16253,14305,30558,5
2022-05-24,4호선,사당,27850,23695,51545,5
2022-05-24,4호선,서울역,12490,18228,30718,5
2022-05-24,3호선,고속터미널,41685,40364,82049,5
2022-05-24,2호선,홍대입구,54959,58375,113334,5
2022-05-24,2호선,구로디지털단지,63395,63538,126933,5
2022-05-24,2호선,신림,67076,64397,131473,5
2022-05-24,2호선,사당,41132,44853,85985,5
2022-05-24,2호선,강남,89918,88877,178795,5
2022-05-24,2호선,선릉,62527,55704,118231,5
2022-05-24,2호선,잠실(송파구청),70621,70909,141530,5
2022-05-24,1호선,서울역,47761,45919,93680,5
2022-05-24,분당선,선릉,14956,23089,38045,5
2022-05-24,공항철도 1호선,홍대입구,9951,10152,20103,5
2022-05-24,공항철도 1호선,서울역,8699,7895,16594,5
2022-05-24,경의선,홍대입구,1942,2039,3981,5
2022-05-24,경의선,서울역,5032,6617,11649,5
2022-05-25,분당선,선릉,14856,22836,37692,5
2022-05-25,공항철도 1호선,홍대입구,10206,10516,20722,5
2022-05-25,공항철도 1호선,서울역,8729,7870,16599,5
2022-05-25,경의선,홍대입구,1876,2247,4123,5
2022-05-25,경의선,서울역,5012,6659,11671,5
2022-05-25,경부선,가산디지털단지,20120,23408,43528,5
2022-05-25,경부선,서울역,6755,2158,8913,5
2022-05-25,9호선,고속터미널,13254,16292,29546,5
2022-05-25,8호선,잠실(송파구청),15060,17320,32380,5
2022-05-25,7호선,가산디지털단지,48759,48403,97162,5
2022-05-25,7호선,고속터미널,16313,14208,30521,5
2022-05-25,4호선,사당,28437,23767,52204,5
2022-05-25,4호선,서울역,12808,18745,31553,5
2022-05-25,3호선,고속터미널,42259,39811,82070,5
2022-05-25,2호선,홍대입구,56927,59744,116671,5
2022-05-25,2호선,구로디지털단지,63791,63206,126997,5
2022-05-25,2호선,신림,67827,65634,133461,5
2022-05-25,2호선,사당,41492,45780,87272,5
2022-05-25,2호선,강남,88971,88075,177046,5
2022-05-25,2호선,선릉,62611,55464,118075,5
2022-05-25,2호선,잠실(송파구청),72268,71721,143989,5
2022-05-25,1호선,서울역,48790,47082,95872,5
2022-05-26,7호선,고속터미널,16682,14156,30838,5
2022-05-26,7호선,가산디지털단지,47544,48424,95968,5
2022-05-26,8호선,잠실(송파구청),14452,17125,31577,5
2022-05-26,9호선,고속터미널,14020,17044,31064,5
2022-05-26,경부선,서울역,7350,2228,9578,5
2022-05-26,경부선,가산디지털단지,19940,22934,42874,5
2022-05-26,경의선,서울역,5107,6622,11729,5
2022-05-26,경의선,홍대입구,1911,2234,4145,5
2022-05-26,공항철도 1호선,서울역,9553,8637,18190,5
2022-05-26,공항철도 1호선,홍대입구,10523,10706,21229,5
2022-05-26,분당선,선릉,15099,22943,38042,5
2022-05-26,4호선,서울역,12811,19295,32106,5
2022-05-26,4호선,사당,28597,24311,52908,5
2022-05-26,2호선,강남,88506,89312,177818,5
2022-05-26,1호선,서울역,50053,48046,98099,5
2022-05-26,2호선,잠실(송파구청),72430,72623,145053,5
2022-05-26,2호선,선릉,62900,56441,119341,5
2022-05-26,2호선,사당,41839,46457,88296,5
2022-05-26,2호선,신림,67577,65272,132849,5
2022-05-26,2호선,구로디지털단지,63590,63592,127182,5
2022-05-26,2호선,홍대입구,57768,62125,119893,5
2022-05-26,3호선,고속터미널,43961,41317,85278,5
2022-05-27,분당선,선릉,14604,22637,37241,5
2022-05-27,공항철도 1호선,홍대입구,11941,12628,24569,5
2022-05-27,공항철도 1호선,서울역,11364,10697,22061,5
2022-05-27,경의선,홍대입구,2002,2650,4652,5
2022-05-27,경의선,서울역,5171,6949,12120,5
2022-05-27,경부선,가산디지털단지,20061,22874,42935,5
2022-05-27,경부선,서울역,10435,3104,13539,5
2022-05-27,9호선,고속터미널,16689,21852,38541,5
2022-05-27,8호선,잠실(송파구청),15403,19215,34618,5
2022-05-27,7호선,가산디지털단지,47185,47215,94400,5
2022-05-27,7호선,고속터미널,20013,15972,35985,5
2022-05-27,4호선,사당,30705,27025,57730,5
2022-05-27,4호선,서울역,13111,22601,35712,5
2022-05-27,3호선,고속터미널,53135,53586,106721,5
2022-05-27,2호선,홍대입구,62353,71942,134295,5
2022-05-27,2호선,구로디지털단지,64279,63294,127573,5
2022-05-27,2호선,신림,70257,66880,137137,5
2022-05-27,2호선,사당,44941,51050,95991,5
2022-05-27,2호선,강남,94765,97836,192601,5
2022-05-27,2호선,선릉,61926,55187,117113,5
2022-05-27,2호선,잠실(송파구청),81962,81233,163195,5
2022-05-27,1호선,서울역,57079,55250,112329,5
2022-05-28,신림선,신림,2310,2526,4836,5
2022-05-28,1호선,서울역,42409,42588,84997,5
2022-05-28,2호선,잠실(송파구청),74749,71128,145877,5
2022-05-28,2호선,선릉,27113,23951,51064,5
2022-05-28,2호선,강남,62981,64548,127529,5
2022-05-28,2호선,사당,37309,42455,79764,5
2022-05-28,2호선,신림,54367,51871,106238,5
2022-05-28,2호선,구로디지털단지,37197,36436,73633,5
2022-05-28,2호선,홍대입구,70970,81235,152205,5
2022-05-28,3호선,고속터미널,57998,57665,115663,5
2022-05-28,4호선,서울역,7146,18150,25296,5
2022-05-28,4호선,사당,25576,22838,48414,5
2022-05-28,7호선,고속터미널,17457,13264,30721,5
2022-05-28,7호선,가산디지털단지,15959,14264,30223,5
2022-05-28,8호선,잠실(송파구청),13998,17034,31032,5
2022-05-28,9호선,고속터미널,16941,24199,41140,5
2022-05-28,경부선,서울역,10001,2638,12639,5
2022-05-28,경부선,가산디지털단지,7018,9285,16303,5
2022-05-28,경의선,서울역,1656,1887,3543,5
2022-05-28,경의선,홍대입구,2335,2932,5267,5
2022-05-28,공항철도 1호선,서울역,10020,10247,20267,5
2022-05-28,공항철도 1호선,홍대입구,13840,14226,28066,5
2022-05-28,분당선,선릉,5842,8962,14804,5
2022-05-29,분당선,선릉,3177,4727,7904,5
2022-05-29,공항철도 1호선,홍대입구,11277,10328,21605,5
2022-05-29,공항철도 1호선,서울역,9579,8952,18531,5
2022-05-29,경의선,홍대입구,1996,2305,4301,5
2022-05-29,경의선,서울역,1383,1224,2607,5
2022-05-29,경부선,가산디지털단지,5243,7049,12292,5
2022-05-29,경부선,서울역,9775,2219,11994,5
2022-05-29,9호선,고속터미널,13143,18631,31774,5
2022-05-29,8호선,잠실(송파구청),10715,12089,22804,5
2022-05-29,7호선,가산디지털단지,11504,10576,22080,5
2022-05-29,7호선,고속터미널,15215,9531,24746,5
2022-05-29,4호선,사당,17475,15854,33329,5
2022-05-29,4호선,서울역,4884,13431,18315,5
2022-05-29,3호선,고속터미널,45792,43881,89673,5
2022-05-29,2호선,홍대입구,54094,53239,107333,5
2022-05-29,2호선,구로디지털단지,26094,25551,51645,5
2022-05-29,2호선,신림,40219,39103,79322,5
2022-05-29,2호선,사당,25512,27657,53169,5
2022-05-29,2호선,강남,36487,34860,71347,5
2022-05-29,2호선,선릉,14487,12236,26723,5
2022-05-29,2호선,잠실(송파구청),53641,49950,103591,5
2022-05-29,1호선,서울역,32758,31999,64757,5
2022-05-29,신림선,신림,1850,2160,4010,5
2022-05-30,신림선,신림,1724,1980,3704,5
2022-05-30,분당선,선릉,14473,22252,36725,5
2022-05-30,공항철도 1호선,홍대입구,9876,9805,19681,5
2022-05-30,공항철도 1호선,서울역,8729,8244,16973,5
2022-05-30,경의선,홍대입구,1744,1985,3729,5
2022-05-30,경의선,서울역,5079,6643,11722,5
2022-05-30,경부선,가산디지털단지,19805,22854,42659,5
2022-05-30,경부선,서울역,7501,2385,9886,5
2022-05-30,9호선,고속터미널,12991,16340,29331,5
2022-05-30,8호선,잠실(송파구청),13553,16164,29717,5
2022-05-30,7호선,가산디지털단지,48126,48335,96461,5
2022-05-30,7호선,고속터미널,16958,14147,31105,5
2022-05-30,4호선,사당,26449,22342,48791,5
2022-05-30,4호선,서울역,12235,18053,30288,5
2022-05-30,3호선,고속터미널,39870,38862,78732,5
2022-05-30,2호선,홍대입구,52407,55030,107437,5
2022-05-30,2호선,구로디지털단지,61793,62098,123891,5
2022-05-30,2호선,신림,61563,58270,119833,5
2022-05-30,2호선,사당,38431,42400,80831,5
2022-05-30,2호선,강남,81745,81075,162820,5
2022-05-30,2호선,선릉,60747,54349,115096,5
2022-05-30,2호선,잠실(송파구청),66283,66612,132895,5
2022-05-30,1호선,서울역,48112,46166,94278,5
2022-05-31,신림선,신림,1960,2432,4392,5
2022-05-31,분당선,선릉,15144,23301,38445,5
2022-05-31,공항철도 1호선,홍대입구,10677,11267,21944,5
2022-05-31,공항철도 1호선,서울역,9283,8481,17764,5
2022-05-31,경의선,홍대입구,1945,2410,4355,5
2022-05-31,경의선,서울역,5229,6885,12114,5
2022-05-31,경부선,가산디지털단지,20785,23623,44408,5
2022-05-31,경부선,서울역,7311,2374,9685,5
2022-05-31,9호선,고속터미널,14682,18028,32710,5
2022-05-31,8호선,잠실(송파구청),14883,18226,33109,5
2022-05-31,7호선,가산디지털단지,48446,49475,97921,5
2022-05-31,7호선,고속터미널,17174,14707,31881,5
2022-05-31,4호선,사당,29204,25557,54761,5
2022-05-31,4호선,서울역,12837,19617,32454,5
2022-05-31,3호선,고속터미널,44361,43326,87687,5
2022-05-31,2호선,홍대입구,57653,65304,122957,5
2022-05-31,2호선,구로디지털단지,65726,65734,131460,5
2022-05-31,2호선,신림,65330,62047,127377,5
2022-05-31,2호선,사당,43427,48238,91665,5
2022-05-31,2호선,강남,87761,89575,177336,5
2022-05-31,2호선,선릉,63117,56809,119926,5
2022-05-31,2호선,잠실(송파구청),76926,76647,153573,5
2022-05-31,1호선,서울역,49864,48244,98108,5
2022-06-01,분당선,선릉,3950,5728,9678,6
2022-06-01,공항철도 1호선,홍대입구,11083,10624,21707,6
2022-06-01,공항철도 1호선,서울역,6589,6259,12848,6
2022-06-01,경의선,홍대입구,1830,2296,4126,6
2022-06-01,경의선,서울역,1301,1324,2625,6
2022-06-01,경부선,가산디지털단지,5746,7539,13285,6
2022-06-01,경부선,서울역,5160,1354,6514,6
2022-06-01,9호선,고속터미널,12284,16345,28629,6
2022-06-01,8호선,잠실(송파구청),11722,13646,25368,6
2022-06-01,7호선,가산디지털단지,13626,12630,26256,6
2022-06-01,7호선,고속터미널,10419,8386,18805,6
2022-06-01,4호선,사당,17718,15944,33662,6
2022-06-01,4호선,서울역,4832,10015,14847,6
2022-06-01,3호선,고속터미널,41681,39292,80973,6
2022-06-01,2호선,홍대입구,57367,58856,116223,6
2022-06-01,2호선,구로디지털단지,29179,28743,57922,6
2022-06-01,2호선,신림,43633,42089,85722,6
2022-06-01,2호선,사당,27020,28918,55938,6
2022-06-01,2호선,강남,42601,41039,83640,6
2022-06-01,2호선,선릉,18868,16367,35235,6
2022-06-01,2호선,잠실(송파구청),54843,52553,107396,6
2022-06-01,1호선,서울역,26040,25835,51875,6
2022-06-01,신림선,신림,1912,2260,4172,6
2022-06-02,분당선,선릉,14561,22182,36743,6
2022-06-02,공항철도 1호선,홍대입구,10323,10828,21151,6
2022-06-02,공항철도 1호선,서울역,9535,8880,18415,6
2022-06-02,경부선,가산디지털단지,19597,22568,42165,6
2022-06-02,경부선,서울역,7127,2215,9342,6
2022-06-02,9호선,고속터미널,13756,17116,30872,6
2022-06-02,8호선,잠실(송파구청),13942,16772,30714,6
2022-06-02,7호선,가산디지털단지,46949,47300,94249,6
2022-06-02,7호선,고속터미널,16738,14147,30885,6
2022-06-02,4호선,사당,27523,23588,51111,6
2022-06-02,4호선,서울역,12505,18754,31259,6
2022-06-02,3호선,고속터미널,42714,40578,83292,6
2022-06-02,2호선,홍대입구,57085,61122,118207,6
2022-06-02,2호선,구로디지털단지,62805,62428,125233,6
2022-06-02,2호선,신림,62167,58899,121066,6
2022-06-02,2호선,사당,40153,44282,84435,6
2022-06-02,2호선,강남,83414,82740,166154,6
2022-06-02,2호선,선릉,60909,54151,115060,6
2022-06-02,2호선,잠실(송파구청),72605,72806,145411,6
2022-06-02,1호선,서울역,47618,46920,94538,6
2022-06-02,신림선,신림,1710,2112,3822,6
2022-06-02,경의선,서울역,5213,6671,11884,6
2022-06-02,경의선,홍대입구,1895,2188,4083,6
2022-06-03,2호선,구로디지털단지,63057,62315,125372,6
2022-06-03,2호선,신림,63823,59941,123764,6
2022-06-03,2호선,사당,42690,47773,90463,6
2022-06-03,2호선,강남,88110,89125,177235,6
2022-06-03,2호선,선릉,59891,53153,113044,6
2022-06-03,2호선,잠실(송파구청),78280,78001,156281,6
2022-06-03,1호선,서울역,53042,55340,108382,6
2022-06-03,분당선,선릉,14122,21596,35718,6
2022-06-03,경의선,홍대입구,2030,2534,4564,6
2022-06-03,경의선,서울역,5122,6886,12008,6
2022-06-03,8호선,잠실(송파구청),14994,18429,33423,6
2022-06-03,7호선,가산디지털단지,46090,45967,92057,6
2022-06-03,4호선,사당,29104,25437,54541,6
2022-06-03,4호선,서울역,12514,22404,34918,6
2022-06-03,공항철도 1호선,서울역,10902,10907,21809,6
2022-06-03,공항철도 1호선,홍대입구,11633,12271,23904,6
2022-06-03,7호선,고속터미널,19494,16538,36032,6
2022-06-03,3호선,고속터미널,51160,57772,108932,6
2022-06-03,경부선,가산디지털단지,19423,22094,41517,6
2022-06-03,경부선,서울역,9611,3275,12886,6
2022-06-03,신림선,신림,1835,2293,4128,6
2022-06-03,9호선,고속터미널,16072,23075,39147,6
2022-06-03,2호선,홍대입구,60049,68627,128676,6
2022-06-04,공항철도 1호선,서울역,9919,10522,20441,6
2022-06-04,3호선,고속터미널,55319,62061,117380,6
2022-06-04,2호선,홍대입구,66346,75640,141986,6
2022-06-04,2호선,구로디지털단지,34617,33315,67932,6
2022-06-04,2호선,신림,49762,46421,96183,6
2022-06-04,2호선,사당,32922,36527,69449,6
2022-06-04,2호선,강남,56964,57369,114333,6
2022-06-04,2호선,선릉,24156,21215,45371,6
2022-06-04,2호선,잠실(송파구청),67922,65763,133685,6
2022-06-04,1호선,서울역,40297,41895,82192,6
2022-06-04,경의선,홍대입구,2219,2713,4932,6
2022-06-04,경의선,서울역,1603,1874,3477,6
2022-06-04,공항철도 1호선,홍대입구,13385,13944,27329,6
2022-06-04,경부선,가산디지털단지,6699,8716,15415,6
2022-06-04,경부선,서울역,10011,2752,12763,6
2022-06-04,9호선,고속터미널,16055,24854,40909,6
2022-06-04,8호선,잠실(송파구청),12907,15812,28719,6
2022-06-04,7호선,가산디지털단지,14973,13511,28484,6
2022-06-04,7호선,고속터미널,17230,13628,30858,6
2022-06-04,4호선,사당,23276,20547,43823,6
2022-06-04,4호선,서울역,6668,17313,23981,6
2022-06-04,분당선,선릉,5154,8021,13175,6
2022-06-04,신림선,신림,1783,2017,3800,6
2022-06-05,1호선,서울역,32569,29929,62498,6
2022-06-05,분당선,선릉,2809,4405,7214,6
2022-06-05,공항철도 1호선,홍대입구,11578,11363,22941,6
2022-06-05,공항철도 1호선,서울역,8963,8076,17039,6
2022-06-05,경의선,홍대입구,1890,2409,4299,6
2022-06-05,경의선,서울역,1215,1171,2386,6
2022-06-05,경부선,가산디지털단지,5241,6830,12071,6
2022-06-05,경부선,서울역,8767,1834,10601,6
2022-06-05,9호선,고속터미널,11654,16426,28080,6
2022-06-05,8호선,잠실(송파구청),10647,12246,22893,6
2022-06-05,7호선,가산디지털단지,11244,10322,21566,6
2022-06-05,7호선,고속터미널,12864,8313,21177,6
2022-06-05,신림선,신림,1424,1754,3178,6
2022-06-05,4호선,사당,16779,15239,32018,6
2022-06-05,4호선,서울역,4905,12511,17416,6
2022-06-05,3호선,고속터미널,41690,40691,82381,6
2022-06-05,2호선,홍대입구,55306,59679,114985,6
2022-06-05,2호선,구로디지털단지,25524,25040,50564,6
2022-06-05,2호선,신림,38197,37566,75763,6
2022-06-05,2호선,사당,24115,26342,50457,6
2022-06-05,2호선,강남,33353,33720,67073,6
2022-06-05,2호선,선릉,13412,11247,24659,6
2022-06-05,2호선,잠실(송파구청),56214,52284,108498,6
2022-06-06,경부선,가산디지털단지,5023,6838,11861,6
2022-06-06,분당선,선릉,2998,4824,7822,6
2022-06-06,공항철도 1호선,홍대입구,10244,9666,19910,6
2022-06-06,공항철도 1호선,서울역,9853,8599,18452,6
2022-06-06,경의선,홍대입구,1621,1933,3554,6
2022-06-06,경의선,서울역,1474,1227,2701,6
2022-06-06,1호선,서울역,33562,30937,64499,6
2022-06-06,경부선,서울역,9932,1959,11891,6
2022-06-06,9호선,고속터미널,13753,17312,31065,6
2022-06-06,8호선,잠실(송파구청),10618,11643,22261,6
2022-06-06,7호선,가산디지털단지,11303,10814,22117,6
2022-06-06,7호선,고속터미널,17820,8647,26467,6
2022-06-06,4호선,사당,14796,13970,28766,6
2022-06-06,4호선,서울역,4610,11913,16523,6
2022-06-06,3호선,고속터미널,50878,41565,92443,6
2022-06-06,2호선,홍대입구,49738,48952,98690,6
2022-06-06,2호선,구로디지털단지,24885,25272,50157,6
2022-06-06,2호선,신림,34950,35120,70070,6
2022-06-06,2호선,사당,21475,22960,44435,6
2022-06-06,2호선,강남,31780,31026,62806,6
2022-06-06,2호선,선릉,14940,13340,28280,6
2022-06-06,2호선,잠실(송파구청),47964,44514,92478,6
2022-06-06,신림선,신림,1339,1708,3047,6
2022-06-07,경부선,서울역,8202,2248,10450,6
2022-06-07,경부선,가산디지털단지,20450,23586,44036,6
2022-06-07,분당선,선릉,14695,22730,37425,6
2022-06-07,신림선,신림,1649,2066,3715,6
2022-06-07,공항철도 1호선,서울역,9426,8097,17523,6
2022-06-07,공항철도 1호선,홍대입구,9738,9917,19655,6
2022-06-07,경의선,서울역,5224,6674,11898,6
2022-06-07,7호선,고속터미널,17617,14387,32004,6
2022-06-07,경의선,홍대입구,1738,2048,3786,6
2022-06-07,7호선,가산디지털단지,48478,48893,97371,6
2022-06-07,8호선,잠실(송파구청),14000,16724,30724,6
2022-06-07,9호선,고속터미널,13523,16372,29895,6
2022-06-07,1호선,서울역,50399,46486,96885,6
2022-06-07,2호선,잠실(송파구청),69909,69501,139410,6
2022-06-07,2호선,선릉,62733,56055,118788,6
2022-06-07,2호선,강남,84682,83378,168060,6
2022-06-07,2호선,사당,39751,43818,83569,6
2022-06-07,2호선,신림,61311,59126,120437,6
2022-06-07,2호선,구로디지털단지,63291,63548,126839,6
2022-06-07,2호선,홍대입구,53227,55998,109225,6
2022-06-07,3호선,고속터미널,41439,38816,80255,6
2022-06-07,4호선,서울역,12340,17810,30150,6
2022-06-07,4호선,사당,27144,22927,50071,6
2022-06-08,공항철도 1호선,홍대입구,9929,10135,20064,6
2022-06-08,분당선,선릉,14985,22941,37926,6
2022-06-08,신림선,신림,1598,2162,3760,6
2022-06-08,1호선,서울역,47442,45883,93325,6
2022-06-08,2호선,잠실(송파구청),70627,69628,140255,6
2022-06-08,2호선,선릉,63503,56319,119822,6
2022-06-08,2호선,강남,86199,84091,170290,6
2022-06-08,2호선,사당,41495,45226,86721,6
2022-06-08,2호선,신림,62806,60509,123315,6
2022-06-08,2호선,구로디지털단지,64445,64875,129320,6
2022-06-08,2호선,홍대입구,54769,58081,112850,6
2022-06-08,3호선,고속터미널,40270,38415,78685,6
2022-06-08,4호선,서울역,12716,18401,31117,6
2022-06-08,4호선,사당,27395,23307,50702,6
2022-06-08,7호선,고속터미널,16241,14298,30539,6
2022-06-08,7호선,가산디지털단지,48935,49400,98335,6
2022-06-08,8호선,잠실(송파구청),14412,17289,31701,6
2022-06-08,9호선,고속터미널,13328,16206,29534,6
2022-06-08,경부선,서울역,6513,2094,8607,6
2022-06-08,경부선,가산디지털단지,20230,23411,43641,6
2022-06-08,경의선,서울역,4959,6522,11481,6
2022-06-08,경의선,홍대입구,1884,2193,4077,6
2022-06-08,공항철도 1호선,서울역,8660,7796,16456,6
2022-06-09,4호선,사당,28231,23748,51979,6
2022-06-09,4호선,서울역,12680,18574,31254,6
2022-06-09,3호선,고속터미널,41230,39215,80445,6
2022-06-09,2호선,홍대입구,55188,58485,113673,6
2022-06-09,2호선,구로디지털단지,63709,63916,127625,6
2022-06-09,2호선,신림,62092,59368,121460,6
2022-06-09,2호선,사당,41122,45537,86659,6
2022-06-09,2호선,강남,86403,84553,170956,6
2022-06-09,2호선,선릉,62948,55976,118924,6
2022-06-09,2호선,잠실(송파구청),71786,70941,142727,6
2022-06-09,신림선,신림,1621,2032,3653,6
2022-06-09,분당선,선릉,14857,22859,37716,6
2022-06-09,공항철도 1호선,홍대입구,9939,10248,20187,6
2022-06-09,공항철도 1호선,서울역,9156,8043,17199,6
2022-06-09,경의선,홍대입구,1732,2033,3765,6
2022-06-09,경의선,서울역,5021,6498,11519,6
2022-06-09,경부선,가산디지털단지,20266,23417,43683,6
2022-06-09,경부선,서울역,6949,2150,9099,6
2022-06-09,9호선,고속터미널,13576,16581,30157,6
2022-06-09,8호선,잠실(송파구청),14315,17384,31699,6
2022-06-09,7호선,가산디지털단지,48435,49265,97700,6
2022-06-09,7호선,고속터미널,16486,14300,30786,6
2022-06-09,1호선,서울역,48521,46760,95281,6
2022-06-10,1호선,서울역,54261,53081,107342,6
2022-06-10,2호선,잠실(송파구청),77089,75978,153067,6
2022-06-10,2호선,선릉,63021,56003,119024,6
2022-06-10,2호선,강남,91893,91789,183682,6
2022-06-10,2호선,사당,45078,50561,95639,6
2022-06-10,2호선,신림,65455,62496,127951,6
2022-06-10,2호선,구로디지털단지,65437,65641,131078,6
2022-06-10,2호선,홍대입구,61284,69647,130931,6
2022-06-10,3호선,고속터미널,48730,50141,98871,6
2022-06-10,4호선,서울역,13152,21685,34837,6
2022-06-10,4호선,사당,30021,26356,56377,6
2022-06-10,7호선,고속터미널,18921,15504,34425,6
2022-06-10,7호선,가산디지털단지,48527,48374,96901,6
2022-06-10,8호선,잠실(송파구청),15479,18820,34299,6
2022-06-10,9호선,고속터미널,15387,19994,35381,6
2022-06-10,경부선,서울역,9535,3018,12553,6
2022-06-10,경부선,가산디지털단지,20292,23384,43676,6
2022-06-10,경의선,서울역,5113,6741,11854,6
2022-06-10,경의선,홍대입구,1978,2436,4414,6
2022-06-10,공항철도 1호선,서울역,10844,10227,21071,6
2022-06-10,공항철도 1호선,홍대입구,11188,11965,23153,6
2022-06-10,분당선,선릉,14815,22810,37625,6
2022-06-10,신림선,신림,1669,2261,3930,6
2022-06-11,2호선,잠실(송파구청),69625,65264,134889,6
2022-06-11,2호선,선릉,26821,23676,50497,6
2022-06-11,2호선,강남,60929,61682,122611,6
2022-06-11,2호선,사당,37734,41977,79711,6
2022-06-11,1호선,서울역,38309,38500,76809,6
2022-06-11,2호선,신림,52030,49479,101509,6
2022-06-11,2호선,구로디지털단지,37145,35842,72987,6
2022-06-11,2호선,홍대입구,67214,76521,143735,6
2022-06-11,3호선,고속터미널,54181,53853,108034,6
2022-06-11,4호선,서울역,6384,16042,22426,6
2022-06-11,4호선,사당,24773,22516,47289,6
2022-06-11,7호선,고속터미널,16238,12941,29179,6
2022-06-11,7호선,가산디지털단지,15913,14289,30202,6
2022-06-11,8호선,잠실(송파구청),13859,16741,30600,6
2022-06-11,9호선,고속터미널,15186,21091,36277,6
2022-06-11,경부선,서울역,9337,2367,11704,6
2022-06-11,경부선,가산디지털단지,7147,9215,16362,6
2022-06-11,경의선,서울역,1586,1804,3390,6
2022-06-11,경의선,홍대입구,2134,2752,4886,6
2022-06-11,공항철도 1호선,서울역,9589,9462,19051,6
2022-06-11,공항철도 1호선,홍대입구,13193,13725,26918,6
2022-06-11,분당선,선릉,5597,9158,14755,6
2022-06-11,신림선,신림,1669,2135,3804,6
2022-06-12,1호선,서울역,30668,28871,59539,6
2022-06-12,2호선,사당,25059,26842,51901,6
2022-06-12,2호선,강남,33896,32308,66204,6
2022-06-12,2호선,선릉,14325,12036,26361,6
2022-06-12,2호선,잠실(송파구청),50536,46376,96912,6
2022-06-12,신림선,신림,1327,1817,3144,6
2022-06-12,분당선,선릉,2990,4728,7718,6
2022-06-12,공항철도 1호선,홍대입구,10756,9574,20330,6
2022-06-12,공항철도 1호선,서울역,9064,7936,17000,6
2022-06-12,경의선,홍대입구,1748,2036,3784,6
2022-06-12,경의선,서울역,1352,1148,2500,6
2022-06-12,경부선,가산디지털단지,5169,7093,12262,6
2022-06-12,경부선,서울역,8895,2070,10965,6
2022-06-12,9호선,고속터미널,11959,16518,28477,6
2022-06-12,8호선,잠실(송파구청),10453,11875,22328,6
2022-06-12,7호선,가산디지털단지,11037,10174,21211,6
2022-06-12,7호선,고속터미널,13433,8864,22297,6
2022-06-12,4호선,사당,17215,15927,33142,6
2022-06-12,4호선,서울역,4803,11816,16619,6
2022-06-12,3호선,고속터미널,43597,41773,85370,6
2022-06-12,2호선,홍대입구,50841,49997,100838,6
2022-06-12,2호선,구로디지털단지,25601,24873,50474,6
2022-06-12,2호선,신림,37879,37281,75160,6
2022-06-13,1호선,서울역,48140,44778,92918,6
2022-06-13,2호선,잠실(송파구청),64207,63859,128066,6
2022-06-13,2호선,선릉,62877,56166,119043,6
2022-06-13,2호선,강남,84137,81651,165788,6
2022-06-13,2호선,사당,39334,43660,82994,6
2022-06-13,2호선,신림,60565,57881,118446,6
2022-06-13,2호선,구로디지털단지,62665,62520,125185,6
2022-06-13,2호선,홍대입구,52209,54656,106865,6
2022-06-13,3호선,고속터미널,41537,39813,81350,6
2022-06-13,4호선,서울역,12274,18401,30675,6
2022-06-13,4호선,사당,27324,23566,50890,6
2022-06-13,7호선,고속터미널,16710,14113,30823,6
2022-06-13,7호선,가산디지털단지,48517,49158,97675,6
2022-06-13,8호선,잠실(송파구청),13633,16089,29722,6
2022-06-13,9호선,고속터미널,13043,16314,29357,6
2022-06-13,경부선,서울역,7426,2209,9635,6
2022-06-13,경부선,가산디지털단지,20190,22542,42732,6
2022-06-13,경의선,서울역,5027,6611,11638,6
2022-06-13,경의선,홍대입구,1681,1992,3673,6
2022-06-13,공항철도 1호선,서울역,8913,8108,17021,6
2022-06-13,공항철도 1호선,홍대입구,9639,9674,19313,6
2022-06-13,분당선,선릉,14660,22630,37290,6
2022-06-13,신림선,신림,1518,2027,3545,6
2022-06-14,경의선,서울역,5304,6709,12013,6
2022-06-14,경의선,홍대입구,1828,1979,3807,6
2022-06-14,공항철도 1호선,서울역,9051,8269,17320,6
2022-06-14,공항철도 1호선,홍대입구,9964,10225,20189,6
2022-06-14,신림선,신림,1657,2201,3858,6
2022-06-14,분당선,선릉,15253,23346,38599,6
2022-06-14,1호선,서울역,47808,46245,94053,6
2022-06-14,2호선,잠실(송파구청),72201,71291,143492,6
2022-06-14,2호선,선릉,64760,57487,122247,6
2022-06-14,2호선,강남,86898,84507,171405,6
2022-06-14,2호선,사당,41526,45597,87123,6
2022-06-14,2호선,신림,61858,59761,121619,6
2022-06-14,2호선,구로디지털단지,64363,64720,129083,6
2022-06-14,2호선,홍대입구,55116,57714,112830,6
2022-06-14,3호선,고속터미널,41002,39251,80253,6
2022-06-14,4호선,서울역,12698,18309,31007,6
2022-06-14,4호선,사당,27886,23474,51360,6
2022-06-14,7호선,고속터미널,16543,14749,31292,6
2022-06-14,7호선,가산디지털단지,48666,48817,97483,6
2022-06-14,8호선,잠실(송파구청),14995,17500,32495,6
2022-06-14,9호선,고속터미널,13329,16382,29711,6
2022-06-14,경부선,서울역,6623,2037,8660,6
2022-06-14,경부선,가산디지털단지,20288,23325,43613,6
2022-06-15,3호선,고속터미널,40718,38928,79646,6
2022-06-15,2호선,홍대입구,54259,57422,111681,6
2022-06-15,2호선,구로디지털단지,63532,63394,126926,6
2022-06-15,2호선,신림,61674,59462,121136,6
2022-06-15,2호선,사당,41347,45189,86536,6
2022-06-15,2호선,강남,86012,83678,169690,6
2022-06-15,2호선,선릉,62866,55483,118349,6
2022-06-15,2호선,잠실(송파구청),71553,70930,142483,6
2022-06-15,1호선,서울역,48013,46691,94704,6
2022-06-15,4호선,서울역,12874,18621,31495,6
2022-06-15,4호선,사당,27549,23408,50957,6
2022-06-15,7호선,고속터미널,15977,13908,29885,6
2022-06-15,7호선,가산디지털단지,48019,48733,96752,6
2022-06-15,8호선,잠실(송파구청),15071,17358,32429,6
2022-06-15,9호선,고속터미널,13548,16865,30413,6
2022-06-15,경부선,서울역,6571,2167,8738,6
2022-06-15,경부선,가산디지털단지,20011,22957,42968,6
2022-06-15,경의선,서울역,4998,6415,11413,6
2022-06-15,경의선,홍대입구,1753,2023,3776,6
2022-06-15,공항철도 1호선,서울역,8788,7823,16611,6
2022-06-15,공항철도 1호선,홍대입구,9985,10099,20084,6
2022-06-15,분당선,선릉,14948,22845,37793,6
2022-06-15,신림선,신림,1546,2011,3557,6
2022-06-16,1호선,서울역,50271,48951,99222,6
2022-06-16,4호선,사당,28380,23890,52270,6
2022-06-16,4호선,서울역,12864,19792,32656,6
2022-06-16,3호선,고속터미널,43229,41602,84831,6
2022-06-16,7호선,고속터미널,17102,14615,31717,6
2022-06-16,7호선,가산디지털단지,47993,49049,97042,6
2022-06-16,8호선,잠실(송파구청),14936,18136,33072,6
2022-06-16,9호선,고속터미널,14344,17472,31816,6
2022-06-16,경부선,서울역,7121,2315,9436,6
2022-06-16,경부선,가산디지털단지,20204,23481,43685,6
2022-06-16,경의선,서울역,5074,6657,11731,6
2022-06-16,경의선,홍대입구,1809,2106,3915,6
2022-06-16,2호선,홍대입구,57605,61773,119378,6
2022-06-16,2호선,구로디지털단지,64772,65042,129814,6
2022-06-16,2호선,신림,62823,60014,122837,6
2022-06-16,2호선,사당,42768,46739,89507,6
2022-06-16,2호선,강남,88020,86811,174831,6
2022-06-16,2호선,선릉,62909,56131,119040,6
2022-06-16,2호선,잠실(송파구청),73985,73272,147257,6
2022-06-16,공항철도 1호선,서울역,9458,8733,18191,6
2022-06-16,공항철도 1호선,홍대입구,10674,10962,21636,6
2022-06-16,분당선,선릉,14683,22826,37509,6
2022-06-16,신림선,신림,1688,2130,3818,6
2022-06-17,경의선,서울역,5227,6822,12049,6
2022-06-17,경의선,홍대입구,2055,2493,4548,6
2022-06-17,공항철도 1호선,서울역,11122,10465,21587,6
2022-06-17,공항철도 1호선,홍대입구,12033,12796,24829,6
2022-06-17,분당선,선릉,14443,22345,36788,6
2022-06-17,신림선,신림,1760,2193,3953,6
2022-06-17,1호선,서울역,55480,55203,110683,6
2022-06-17,2호선,잠실(송파구청),77157,76036,153193,6
2022-06-17,2호선,선릉,61519,55186,116705,6
2022-06-17,2호선,강남,92648,92588,185236,6
2022-06-17,2호선,사당,44834,50673,95507,6
2022-06-17,2호선,신림,65130,62478,127608,6
2022-06-17,2호선,구로디지털단지,65648,65325,130973,6
2022-06-17,2호선,홍대입구,62758,72609,135367,6
2022-06-17,3호선,고속터미널,51776,53739,105515,6
2022-06-17,4호선,서울역,12832,22086,34918,6
2022-06-17,4호선,사당,29896,26082,55978,6
2022-06-17,7호선,고속터미널,20196,16406,36602,6
2022-06-17,7호선,가산디지털단지,47350,47518,94868,6
2022-06-17,8호선,잠실(송파구청),15493,18733,34226,6
2022-06-17,9호선,고속터미널,16161,21973,38134,6
2022-06-17,경부선,서울역,9934,3050,12984,6
2022-06-17,경부선,가산디지털단지,19800,22779,42579,6
2022-06-18,4호선,사당,25362,22783,48145,6
2022-06-18,공항철도 1호선,서울역,10034,9679,19713,6
2022-06-18,공항철도 1호선,홍대입구,13765,14602,28367,6
2022-06-18,분당선,선릉,5988,8994,14982,6
2022-06-18,1호선,서울역,40159,40128,80287,6
2022-06-18,2호선,잠실(송파구청),73311,68994,142305,6
2022-06-18,2호선,선릉,26882,23812,50694,6
2022-06-18,2호선,강남,63337,64164,127501,6
2022-06-18,2호선,사당,38150,42679,80829,6
2022-06-18,2호선,신림,51392,48889,100281,6
2022-06-18,2호선,구로디지털단지,37463,36120,73583,6
2022-06-18,2호선,홍대입구,68904,79076,147980,6
2022-06-18,3호선,고속터미널,54974,55454,110428,6
2022-06-18,4호선,서울역,6717,17141,23858,6
2022-06-18,경부선,서울역,10051,2351,12402,6
2022-06-18,9호선,고속터미널,15840,23032,38872,6
2022-06-18,8호선,잠실(송파구청),13735,16522,30257,6
2022-06-18,7호선,가산디지털단지,15548,13981,29529,6
2022-06-18,7호선,고속터미널,17693,13170,30863,6
2022-06-18,신림선,신림,1621,1848,3469,6
2022-06-18,경의선,홍대입구,2227,2854,5081,6
2022-06-18,경의선,서울역,1672,1896,3568,6
2022-06-18,경부선,가산디지털단지,7063,9076,16139,6
2022-06-19,경의선,서울역,1382,1219,2601,6
2022-06-19,1호선,서울역,33101,31446,64547,6
2022-06-19,공항철도 1호선,서울역,9549,8629,18178,6
2022-06-19,공항철도 1호선,홍대입구,11215,10362,21577,6
2022-06-19,경부선,가산디지털단지,5117,6460,11577,6
2022-06-19,경부선,서울역,9383,2217,11600,6
2022-06-19,9호선,고속터미널,12461,16927,29388,6
2022-06-19,8호선,잠실(송파구청),10431,11602,22033,6
2022-06-19,7호선,가산디지털단지,10597,9882,20479,6
2022-06-19,7호선,고속터미널,14947,9370,24317,6
2022-06-19,4호선,사당,17456,16242,33698,6
2022-06-19,4호선,서울역,5036,13150,18186,6
2022-06-19,분당선,선릉,3103,4811,7914,6
2022-06-19,3호선,고속터미널,44622,42439,87061,6
2022-06-19,2호선,홍대입구,52753,52017,104770,6
2022-06-19,2호선,구로디지털단지,25803,25760,51563,6
2022-06-19,2호선,신림,37446,36630,74076,6
2022-06-19,2호선,사당,25277,27621,52898,6
2022-06-19,2호선,강남,35349,33859,69208,6
2022-06-19,2호선,선릉,14669,12572,27241,6
2022-06-19,2호선,잠실(송파구청),51637,48685,100322,6
2022-06-19,신림선,신림,1258,1649,2907,6
2022-06-19,경의선,홍대입구,1848,2032,3880,6
2022-06-20,7호선,고속터미널,17721,14283,32004,6
2022-06-20,7호선,가산디지털단지,48445,48722,97167,6
2022-06-20,8호선,잠실(송파구청),14244,16998,31242,6
2022-06-20,9호선,고속터미널,13732,16951,30683,6
2022-06-20,경부선,서울역,7887,2496,10383,6
2022-06-20,경부선,가산디지털단지,19835,21682,41517,6
2022-06-20,경의선,서울역,4936,6543,11479,6
2022-06-20,경의선,홍대입구,1685,2050,3735,6
2022-06-20,공항철도 1호선,서울역,9483,8477,17960,6
2022-06-20,공항철도 1호선,홍대입구,10209,10212,20421,6
2022-06-20,분당선,선릉,14541,22620,37161,6
2022-06-20,신림선,신림,1613,2222,3835,6
2022-06-20,2호선,사당,39479,43737,83216,6
2022-06-20,2호선,신림,60509,58108,118617,6
2022-06-20,2호선,구로디지털단지,62812,62604,125416,6
2022-06-20,2호선,홍대입구,55533,58503,114036,6
2022-06-20,2호선,잠실(송파구청),69846,70426,140272,6
2022-06-20,3호선,고속터미널,38612,36290,74902,6
2022-06-20,4호선,서울역,12331,18394,30725,6
2022-06-20,4호선,사당,26834,22961,49795,6
2022-06-20,2호선,선릉,61700,54868,116568,6
2022-06-20,2호선,강남,85408,83388,168796,6
2022-06-20,1호선,서울역,49576,48118,97694,6
2022-06-21,1호선,서울역,48594,47324,95918,6
2022-06-21,2호선,잠실(송파구청),74912,75052,149964,6
2022-06-21,2호선,선릉,64011,56638,120649,6
2022-06-21,2호선,강남,88883,87256,176139,6
2022-06-21,2호선,사당,42015,46082,88097,6
2022-06-21,2호선,신림,62089,61109,123198,6
2022-06-21,2호선,구로디지털단지,63951,64108,128059,6
2022-06-21,2호선,홍대입구,58890,63568,122458,6
2022-06-21,3호선,고속터미널,44871,41955,86826,6
2022-06-21,4호선,서울역,12547,18415,30962,6
2022-06-21,4호선,사당,27692,23302,50994,6
2022-06-21,7호선,고속터미널,17300,14934,32234,6
2022-06-21,7호선,가산디지털단지,49163,49183,98346,6
2022-06-21,8호선,잠실(송파구청),14995,18017,33012,6
2022-06-21,9호선,고속터미널,14374,17774,32148,6
2022-06-21,경부선,서울역,7323,2159,9482,6
2022-06-21,경부선,가산디지털단지,20015,23102,43117,6
2022-06-21,경의선,서울역,5050,6426,11476,6
2022-06-21,경의선,홍대입구,1830,2164,3994,6
2022-06-21,공항철도 1호선,서울역,9008,8035,17043,6
2022-06-21,공항철도 1호선,홍대입구,10965,11142,22107,6
2022-06-21,분당선,선릉,15306,23452,38758,6
2022-06-21,신림선,신림,1466,1938,3404,6
2022-06-22,분당선,선릉,14981,23292,38273,6
2022-06-22,신림선,신림,1567,2082,3649,6
2022-06-22,공항철도 1호선,홍대입구,11567,11623,23190,6
2022-06-22,공항철도 1호선,서울역,9415,8349,17764,6
2022-06-22,경의선,홍대입구,1930,2301,4231,6
2022-06-22,경의선,서울역,5007,6437,11444,6
2022-06-22,경부선,가산디지털단지,20192,23181,43373,6
2022-06-22,경부선,서울역,7321,2326,9647,6
2022-06-22,9호선,고속터미널,14559,18171,32730,6
2022-06-22,8호선,잠실(송파구청),15088,18254,33342,6
2022-06-22,7호선,가산디지털단지,48797,49193,97990,6
2022-06-22,7호선,고속터미널,17218,14862,32080,6
2022-06-22,4호선,사당,27676,23563,51239,6
2022-06-22,4호선,서울역,12891,19491,32382,6
2022-06-22,3호선,고속터미널,44849,42319,87168,6
2022-06-22,2호선,홍대입구,61145,65560,126705,6
2022-06-22,2호선,구로디지털단지,64374,64620,128994,6
2022-06-22,2호선,신림,62842,60691,123533,6
2022-06-22,2호선,사당,41835,46068,87903,6
2022-06-22,2호선,강남,89898,87747,177645,6
2022-06-22,2호선,선릉,64365,56685,121050,6
2022-06-22,2호선,잠실(송파구청),77400,76460,153860,6
2022-06-22,1호선,서울역,49443,48383,97826,6
2022-06-23,경부선,서울역,8081,2504,10585,6
2022-06-23,9호선,고속터미널,13014,17194,30208,6
2022-06-23,8호선,잠실(송파구청),16247,17918,34165,6
2022-06-23,7호선,가산디지털단지,48887,47839,96726,6
2022-06-23,7호선,고속터미널,16882,14236,31118,6
2022-06-23,4호선,서울역,12636,19186,31822,6
2022-06-23,4호선,사당,26895,22327,49222,6
2022-06-23,1호선,서울역,50409,48028,98437,6
2022-06-23,3호선,고속터미널,43778,41044,84822,6
2022-06-23,2호선,홍대입구,55374,58092,113466,6
2022-06-23,2호선,구로디지털단지,61929,61659,123588,6
2022-06-23,2호선,신림,59558,57167,116725,6
2022-06-23,2호선,사당,39537,43052,82589,6
2022-06-23,2호선,강남,87398,84635,172033,6
2022-06-23,2호선,선릉,62264,55187,117451,6
2022-06-23,2호선,잠실(송파구청),73120,72250,145370,6
2022-06-23,신림선,신림,1585,1946,3531,6
2022-06-23,분당선,선릉,15205,22826,38031,6
2022-06-23,공항철도 1호선,홍대입구,9956,10330,20286,6
2022-06-23,공항철도 1호선,서울역,9591,8697,18288,6
2022-06-23,경의선,홍대입구,1557,1949,3506,6
2022-06-23,경의선,서울역,4518,5964,10482,6
2022-06-23,경부선,가산디지털단지,18963,22437,41400,6
2022-06-24,1호선,서울역,55677,54538,110215,6
2022-06-24,2호선,잠실(송파구청),80414,79832,160246,6
2022-06-24,2호선,선릉,61830,55241,117071,6
2022-06-24,2호선,강남,94875,95390,190265,6
2022-06-24,2호선,사당,44697,50494,95191,6
2022-06-24,2호선,신림,64790,61979,126769,6
2022-06-24,2호선,구로디지털단지,64635,64260,128895,6
2022-06-24,2호선,홍대입구,64987,75526,140513,6
2022-06-24,3호선,고속터미널,52268,54174,106442,6
2022-06-24,4호선,서울역,12842,22245,35087,6
2022-06-24,4호선,사당,29609,25633,55242,6
2022-06-24,7호선,고속터미널,20117,16075,36192,6
2022-06-24,7호선,가산디지털단지,47129,47129,94258,6
2022-06-24,8호선,잠실(송파구청),16031,19289,35320,6
2022-06-24,9호선,고속터미널,16141,22279,38420,6
2022-06-24,경부선,서울역,10543,3120,13663,6
2022-06-24,경부선,가산디지털단지,19843,22555,42398,6
2022-06-24,경의선,서울역,4975,6693,11668,6
2022-06-24,경의선,홍대입구,2089,2642,4731,6
2022-06-24,공항철도 1호선,서울역,11428,10757,22185,6
2022-06-24,공항철도 1호선,홍대입구,12485,13220,25705,6
2022-06-24,분당선,선릉,14669,22520,37189,6
2022-06-24,신림선,신림,1669,2127,3796,6
2022-06-25,1호선,서울역,40553,41057,81610,6
2022-06-25,2호선,잠실(송파구청),73761,70750,144511,6
2022-06-25,2호선,선릉,26947,23848,50795,6
2022-06-25,2호선,강남,65148,65672,130820,6
2022-06-25,2호선,사당,37604,42423,80027,6
2022-06-25,2호선,신림,52086,49413,101499,6
2022-06-25,2호선,구로디지털단지,37801,36724,74525,6
2022-06-25,2호선,홍대입구,71399,81749,153148,6
2022-06-25,3호선,고속터미널,57225,57111,114336,6
2022-06-25,4호선,서울역,7009,17301,24310,6
2022-06-25,4호선,사당,25051,22604,47655,6
2022-06-25,7호선,고속터미널,17390,13392,30782,6
2022-06-25,7호선,가산디지털단지,15731,14263,29994,6
2022-06-25,8호선,잠실(송파구청),14653,17132,31785,6
2022-06-25,9호선,고속터미널,16143,23059,39202,6
2022-06-25,경부선,서울역,10202,2596,12798,6
2022-06-25,경부선,가산디지털단지,7071,9345,16416,6
2022-06-25,경의선,서울역,1675,1769,3444,6
2022-06-25,경의선,홍대입구,2224,2949,5173,6
2022-06-25,공항철도 1호선,서울역,10039,9689,19728,6
2022-06-25,공항철도 1호선,홍대입구,14209,14650,28859,6
2022-06-25,분당선,선릉,5698,8130,13828,6
2022-06-25,신림선,신림,1472,1965,3437,6
2022-06-26,1호선,서울역,31733,31238,62971,6
2022-06-26,2호선,잠실(송파구청),52250,48779,101029,6
2022-06-26,2호선,선릉,14656,12678,27334,6
2022-06-26,2호선,강남,36780,36048,72828,6
2022-06-26,2호선,사당,25176,27280,52456,6
2022-06-26,2호선,신림,37282,36363,73645,6
2022-06-26,2호선,구로디지털단지,25721,25289,51010,6
2022-06-26,2호선,홍대입구,51677,51058,102735,6
2022-06-26,3호선,고속터미널,46038,43530,89568,6
2022-06-26,4호선,서울역,4727,12661,17388,6
2022-06-26,4호선,사당,17115,15775,32890,6
2022-06-26,7호선,고속터미널,14817,9346,24163,6
2022-06-26,7호선,가산디지털단지,10845,9961,20806,6
2022-06-26,8호선,잠실(송파구청),10735,11928,22663,6
2022-06-26,9호선,고속터미널,12301,17515,29816,6
2022-06-26,경부선,서울역,9769,2233,12002,6
2022-06-26,경부선,가산디지털단지,5028,6890,11918,6
2022-06-26,경의선,서울역,1297,1152,2449,6
2022-06-26,경의선,홍대입구,1580,2034,3614,6
2022-06-26,공항철도 1호선,서울역,9676,8400,18076,6
2022-06-26,공항철도 1호선,홍대입구,10876,9844,20720,6
2022-06-26,분당선,선릉,2967,4623,7590,6
2022-06-26,신림선,신림,1099,1597,2696,6
2022-06-27,신림선,신림,1517,2146,3663,6
2022-06-27,분당선,선릉,14768,22750,37518,6
2022-06-27,공항철도 1호선,홍대입구,10161,10394,20555,6
2022-06-27,공항철도 1호선,서울역,10056,11854,21910,6
2022-06-27,경의선,홍대입구,1639,1926,3565,6
2022-06-27,경의선,서울역,4909,6182,11091,6
2022-06-27,경부선,가산디지털단지,19405,22380,41785,6
2022-06-27,경부선,서울역,8566,2566,11132,6
2022-06-27,9호선,고속터미널,13084,17286,30370,6
2022-06-27,8호선,잠실(송파구청),14631,17253,31884,6
2022-06-27,7호선,가산디지털단지,48063,48117,96180,6
2022-06-27,7호선,고속터미널,17306,14171,31477,6
2022-06-27,4호선,사당,25333,21330,46663,6
2022-06-27,4호선,서울역,12169,18318,30487,6
2022-06-27,3호선,고속터미널,43062,41195,84257,6
2022-06-27,2호선,홍대입구,53852,57114,110966,6
2022-06-27,2호선,구로디지털단지,62046,62203,124249,6
2022-06-27,2호선,신림,58649,56279,114928,6
2022-06-27,2호선,사당,37893,41486,79379,6
2022-06-27,2호선,강남,85676,83337,169013,6
2022-06-27,2호선,잠실(송파구청),69617,69671,139288,6
2022-06-27,1호선,서울역,48415,47729,96144,6
2022-06-27,2호선,선릉,61751,54759,116510,6
2022-06-28,3호선,고속터미널,41197,39357,80554,6
2022-06-28,4호선,서울역,12812,19035,31847,6
2022-06-28,4호선,사당,26268,21937,48205,6
2022-06-28,7호선,고속터미널,16691,14323,31014,6
2022-06-28,7호선,가산디지털단지,47786,48056,95842,6
2022-06-28,8호선,잠실(송파구청),15064,17333,32397,6
2022-06-28,9호선,고속터미널,13251,16580,29831,6
2022-06-28,경부선,서울역,7722,2336,10058,6
2022-06-28,경부선,가산디지털단지,19597,22404,42001,6
2022-06-28,경의선,서울역,4819,6105,10924,6
2022-06-28,경의선,홍대입구,1663,1984,3647,6
2022-06-28,공항철도 1호선,서울역,10073,11632,21705,6
2022-06-28,공항철도 1호선,홍대입구,10077,10212,20289,6
2022-06-28,분당선,선릉,15180,23010,38190,6
2022-06-28,1호선,서울역,48231,47227,95458,6
2022-06-28,2호선,잠실(송파구청),71870,71749,143619,6
2022-06-28,2호선,선릉,62970,55643,118613,6
2022-06-28,2호선,강남,88231,85912,174143,6
2022-06-28,2호선,사당,39582,43444,83026,6
2022-06-28,2호선,신림,60208,57998,118206,6
2022-06-28,신림선,신림,1591,2077,3668,6
2022-06-28,2호선,구로디지털단지,63122,63165,126287,6
2022-06-28,2호선,홍대입구,55269,58328,113597,6
2022-06-29,1호선,서울역,48258,46324,94582,6
2022-06-29,2호선,잠실(송파구청),72504,72592,145096,6
2022-06-29,2호선,선릉,62306,54935,117241,6
2022-06-29,2호선,강남,86791,84588,171379,6
2022-06-29,2호선,사당,39045,42079,81124,6
2022-06-29,2호선,신림,59799,57596,117395,6
2022-06-29,2호선,구로디지털단지,62887,62765,125652,6
2022-06-29,2호선,홍대입구,56317,59522,115839,6
2022-06-29,3호선,고속터미널,41937,39528,81465,6
2022-06-29,4호선,서울역,12527,18589,31116,6
2022-06-29,4호선,사당,26096,22150,48246,6
2022-06-29,7호선,고속터미널,16120,13905,30025,6
2022-06-29,7호선,가산디지털단지,48367,47932,96299,6
2022-06-29,8호선,잠실(송파구청),15764,17939,33703,6
2022-06-29,9호선,고속터미널,12806,16605,29411,6
2022-06-29,경부선,서울역,7669,2348,10017,6
2022-06-29,경부선,가산디지털단지,19291,22463,41754,6
2022-06-29,경의선,서울역,4687,5923,10610,6
2022-06-29,경의선,홍대입구,1731,2109,3840,6
2022-06-29,공항철도 1호선,서울역,10147,10492,20639,6
2022-06-29,공항철도 1호선,홍대입구,10394,10494,20888,6
2022-06-29,분당선,선릉,15172,22623,37795,6
2022-06-29,신림선,신림,1554,2021,3575,6
2022-06-30,2호선,사당,37956,41865,79821,6
2022-06-30,2호선,강남,84281,81881,166162,6
2022-06-30,2호선,선릉,62309,54697,117006,6
2022-06-30,2호선,잠실(송파구청),69628,69980,139608,6
2022-06-30,1호선,서울역,48882,46503,95385,6
2022-06-30,신림선,신림,1548,2077,3625,6
2022-06-30,분당선,선릉,15186,22945,38131,6
2022-06-30,공항철도 1호선,홍대입구,9813,10254,20067,6
2022-06-30,공항철도 1호선,서울역,9421,8329,17750,6
2022-06-30,경의선,홍대입구,1594,1869,3463,6
2022-06-30,경의선,서울역,4496,5812,10308,6
2022-06-30,경부선,가산디지털단지,18637,21672,40309,6
2022-06-30,경부선,서울역,7738,2448,10186,6
2022-06-30,9호선,고속터미널,12556,16324,28880,6
2022-06-30,8호선,잠실(송파구청),15827,18076,33903,6
2022-06-30,7호선,가산디지털단지,47532,47454,94986,6
2022-06-30,7호선,고속터미널,16155,13835,29990,6
2022-06-30,4호선,사당,25316,21638,46954,6
2022-06-30,4호선,서울역,12225,19179,31404,6
2022-06-30,3호선,고속터미널,42028,40584,82612,6
2022-06-30,2호선,신림,58153,55580,113733,6
2022-06-30,2호선,구로디지털단지,60224,60739,120963,6
2022-06-30,2호선,홍대입구,54376,57846,112222,6
2022-07-01,2호선,잠실(송파구청),81553,80908,162461,7
2022-07-01,2호선,선릉,62039,54390,116429,7
2022-07-01,2호선,강남,93266,92240,185506,7
2022-07-01,2호선,사당,45262,48844,94106,7
2022-07-01,2호선,신림,63886,61007,124893,7
2022-07-01,2호선,구로디지털단지,64952,64740,129692,7
2022-07-01,분당선,선릉,14347,22274,36621,7
2022-07-01,신림선,신림,1696,2313,4009,7
2022-07-01,2호선,홍대입구,66440,76144,142584,7
2022-07-01,3호선,고속터미널,51937,53990,105927,7
2022-07-01,4호선,서울역,12690,19753,32443,7
2022-07-01,4호선,사당,30368,25400,55768,7
2022-07-01,1호선,서울역,51298,54304,105602,7
2022-07-01,7호선,고속터미널,19015,15797,34812,7
2022-07-01,7호선,가산디지털단지,47737,47653,95390,7
2022-07-01,8호선,잠실(송파구청),16813,20177,36990,7
2022-07-01,9호선,고속터미널,16013,21887,37900,7
2022-07-01,경부선,서울역,7366,2799,10165,7
2022-07-01,경부선,가산디지털단지,19598,22383,41981,7
2022-07-01,경의선,서울역,4626,6435,11061,7
2022-07-01,경의선,홍대입구,2170,2661,4831,7
2022-07-01,공항철도 1호선,서울역,9973,10321,20294,7
2022-07-01,공항철도 1호선,홍대입구,12594,13242,25836,7
2022-07-02,신림선,신림,1502,2017,3519,7
2022-07-02,분당선,선릉,5599,8685,14284,7
2022-07-02,공항철도 1호선,홍대입구,13893,14707,28600,7
2022-07-02,공항철도 1호선,서울역,9750,9436,19186,7
2022-07-02,경의선,홍대입구,2159,2796,4955,7
2022-07-02,경의선,서울역,1814,1793,3607,7
2022-07-02,경부선,가산디지털단지,6536,8659,15195,7
2022-07-02,경부선,서울역,9929,2412,12341,7
2022-07-02,9호선,고속터미널,15487,22790,38277,7
2022-07-02,8호선,잠실(송파구청),15477,18471,33948,7
2022-07-02,7호선,가산디지털단지,15135,13648,28783,7
2022-07-02,7호선,고속터미널,16449,12533,28982,7
2022-07-02,1호선,서울역,43834,40499,84333,7
2022-07-02,2호선,잠실(송파구청),77460,74635,152095,7
2022-07-02,2호선,선릉,26698,23309,50007,7
2022-07-02,2호선,강남,63384,63621,127005,7
2022-07-02,2호선,사당,35517,40195,75712,7
2022-07-02,2호선,신림,50390,48426,98816,7
2022-07-02,2호선,구로디지털단지,36359,35311,71670,7
2022-07-02,2호선,홍대입구,71992,82146,154138,7
2022-07-02,3호선,고속터미널,56960,57248,114208,7
2022-07-02,4호선,서울역,8315,16847,25162,7
2022-07-02,4호선,사당,24187,21161,45348,7
2022-07-03,신림선,신림,1198,1784,2982,7
2022-07-03,2호선,선릉,13605,11899,25504,7
2022-07-03,2호선,강남,36350,34618,70968,7
2022-07-03,2호선,사당,23937,26139,50076,7
2022-07-03,2호선,신림,37194,36316,73510,7
2022-07-03,2호선,구로디지털단지,25187,24785,49972,7
2022-07-03,2호선,홍대입구,53743,53432,107175,7
2022-07-03,3호선,고속터미널,46380,43634,90014,7
2022-07-03,4호선,서울역,4727,12129,16856,7
2022-07-03,4호선,사당,16588,15489,32077,7
2022-07-03,2호선,잠실(송파구청),55185,52108,107293,7
2022-07-03,1호선,서울역,30495,29306,59801,7
2022-07-03,7호선,고속터미널,14208,8359,22567,7
2022-07-03,7호선,가산디지털단지,10721,10105,20826,7
2022-07-03,8호선,잠실(송파구청),11650,13287,24937,7
2022-07-03,9호선,고속터미널,12445,17105,29550,7
2022-07-03,경부선,서울역,9423,2128,11551,7
2022-07-03,경부선,가산디지털단지,4698,6727,11425,7
2022-07-03,경의선,서울역,1225,1012,2237,7
2022-07-03,경의선,홍대입구,1870,2241,4111,7
2022-07-03,공항철도 1호선,서울역,9595,8159,17754,7
2022-07-03,공항철도 1호선,홍대입구,11345,10597,21942,7
2022-07-03,분당선,선릉,2885,4358,7243,7
2022-07-04,2호선,홍대입구,57319,59963,117282,7
2022-07-04,신림선,신림,1627,2122,3749,7
2022-07-04,경의선,서울역,5072,6296,11368,7
2022-07-04,경의선,홍대입구,1808,2072,3880,7
2022-07-04,공항철도 1호선,서울역,8984,8152,17136,7
2022-07-04,공항철도 1호선,홍대입구,10514,10630,21144,7
2022-07-04,분당선,선릉,14925,23059,37984,7
2022-07-04,2호선,구로디지털단지,62902,62896,125798,7
2022-07-04,2호선,신림,59693,57418,117111,7
2022-07-04,2호선,사당,39060,42229,81289,7
2022-07-04,2호선,강남,89871,86832,176703,7
2022-07-04,2호선,선릉,63363,55409,118772,7
2022-07-04,2호선,잠실(송파구청),72101,72182,144283,7
2022-07-04,1호선,서울역,47157,46887,94044,7
2022-07-04,3호선,고속터미널,43130,40879,84009,7
2022-07-04,4호선,서울역,12096,17045,29141,7
2022-07-04,4호선,사당,26039,20998,47037,7
2022-07-04,7호선,고속터미널,17141,13805,30946,7
2022-07-04,7호선,가산디지털단지,48829,48500,97329,7
2022-07-04,8호선,잠실(송파구청),15264,17833,33097,7
2022-07-04,9호선,고속터미널,13177,16686,29863,7
2022-07-04,경부선,서울역,7229,2243,9472,7
2022-07-04,경부선,가산디지털단지,19843,23143,42986,7
2022-07-05,신림선,신림,1667,2263,3930,7
2022-07-05,1호선,서울역,46491,45419,91910,7
2022-07-05,2호선,잠실(송파구청),76494,76186,152680,7
2022-07-05,2호선,선릉,65167,57215,122382,7
2022-07-05,2호선,강남,93187,90242,183429,7
2022-07-05,2호선,사당,40293,44018,84311,7
2022-07-05,2호선,신림,61163,58907,120070,7
2022-07-05,2호선,구로디지털단지,63655,63921,127576,7
2022-07-05,2호선,홍대입구,61323,64639,125962,7
2022-07-05,3호선,고속터미널,42910,41186,84096,7
2022-07-05,4호선,서울역,12381,17686,30067,7
2022-07-05,4호선,사당,26508,22097,48605,7
2022-07-05,7호선,고속터미널,16320,13958,30278,7
2022-07-05,7호선,가산디지털단지,48856,48941,97797,7
2022-07-05,8호선,잠실(송파구청),16221,18572,34793,7
2022-07-05,9호선,고속터미널,13663,16844,30507,7
2022-07-05,경부선,서울역,6580,1926,8506,7
2022-07-05,경부선,가산디지털단지,19651,22864,42515,7
2022-07-05,경의선,서울역,4969,6303,11272,7
2022-07-05,경의선,홍대입구,1800,2254,4054,7
2022-07-05,공항철도 1호선,서울역,8545,7730,16275,7
2022-07-05,공항철도 1호선,홍대입구,11249,11163,22412,7
2022-07-05,분당선,선릉,15505,23605,39110,7
2022-07-06,신림선,신림,1721,2322,4043,7
2022-07-06,공항철도 1호선,서울역,8818,8006,16824,7
2022-07-06,공항철도 1호선,홍대입구,11033,11106,22139,7
2022-07-06,경의선,서울역,4893,6168,11061,7
2022-07-06,경의선,홍대입구,1814,2339,4153,7
2022-07-06,분당선,선릉,15257,23286,38543,7
2022-07-06,8호선,잠실(송파구청),16479,18973,35452,7
2022-07-06,7호선,가산디지털단지,49067,48792,97859,7
2022-07-06,7호선,고속터미널,15984,13923,29907,7
2022-07-06,4호선,사당,27238,22408,49646,7
2022-07-06,4호선,서울역,12765,18566,31331,7
2022-07-06,3호선,고속터미널,43784,41578,85362,7
2022-07-06,2호선,홍대입구,60389,63726,124115,7
2022-07-06,2호선,구로디지털단지,63973,63911,127884,7
2022-07-06,2호선,신림,62114,59505,121619,7
2022-07-06,2호선,사당,40764,44204,84968,7
2022-07-06,2호선,강남,92530,88839,181369,7
2022-07-06,2호선,선릉,64309,56926,121235,7
2022-07-06,2호선,잠실(송파구청),77267,77003,154270,7
2022-07-06,1호선,서울역,47279,45824,93103,7
2022-07-06,9호선,고속터미널,13583,17131,30714,7
2022-07-06,경부선,서울역,6691,2098,8789,7
2022-07-06,경부선,가산디지털단지,19580,22697,42277,7
2022-07-07,신림선,신림,1676,2070,3746,7
2022-07-07,분당선,선릉,15149,23075,38224,7
2022-07-07,공항철도 1호선,홍대입구,10534,10700,21234,7
2022-07-07,공항철도 1호선,서울역,8976,8330,17306,7
2022-07-07,경의선,홍대입구,1700,2081,3781,7
2022-07-07,경의선,서울역,4799,6114,10913,7
2022-07-07,경부선,가산디지털단지,19342,22661,42003,7
2022-07-07,경부선,서울역,7077,2106,9183,7
2022-07-07,9호선,고속터미널,13422,17412,30834,7
2022-07-07,7호선,가산디지털단지,48143,48144,96287,7
2022-07-07,7호선,고속터미널,16238,13952,30190,7
2022-07-07,4호선,사당,26600,22159,48759,7
2022-07-07,4호선,서울역,12341,18455,30796,7
2022-07-07,3호선,고속터미널,43386,41537,84923,7
2022-07-07,2호선,홍대입구,57800,61692,119492,7
2022-07-07,2호선,구로디지털단지,62629,62515,125144,7
2022-07-07,2호선,신림,60417,58107,118524,7
2022-07-07,2호선,사당,39889,43707,83596,7
2022-07-07,2호선,강남,90644,87987,178631,7
2022-07-07,2호선,선릉,64044,56251,120295,7
2022-07-07,2호선,잠실(송파구청),75632,75760,151392,7
2022-07-07,1호선,서울역,47343,46539,93882,7
2022-07-07,8호선,잠실(송파구청),15688,18388,34076,7
2022-07-08,신림선,신림,1650,2156,3806,7
2022-07-08,분당선,선릉,14606,22641,37247,7
2022-07-08,공항철도 1호선,홍대입구,12266,12726,24992,7
2022-07-08,공항철도 1호선,서울역,10630,10351,20981,7
2022-07-08,경의선,홍대입구,1971,2578,4549,7
2022-07-08,경의선,서울역,4950,6500,11450,7
2022-07-08,경부선,가산디지털단지,19394,22348,41742,7
2022-07-08,경부선,서울역,9850,3018,12868,7
2022-07-08,9호선,고속터미널,15685,21317,37002,7
2022-07-08,8호선,잠실(송파구청),16285,19737,36022,7
2022-07-08,7호선,가산디지털단지,47843,47871,95714,7
2022-07-08,7호선,고속터미널,19122,15866,34988,7
2022-07-08,4호선,사당,28753,24709,53462,7
2022-07-08,4호선,서울역,12607,21288,33895,7
2022-07-08,3호선,고속터미널,50468,53372,103840,7
2022-07-08,2호선,홍대입구,64588,72684,137272,7
2022-07-08,2호선,구로디지털단지,64495,64085,128580,7
2022-07-08,2호선,신림,63732,61459,125191,7
2022-07-08,2호선,사당,43860,48382,92242,7
2022-07-08,2호선,강남,96077,95228,191305,7
2022-07-08,2호선,선릉,62845,55373,118218,7
2022-07-08,2호선,잠실(송파구청),81182,81096,162278,7
2022-07-08,1호선,서울역,53055,52623,105678,7
2022-07-09,신림선,신림,1410,1909,3319,7
2022-07-09,분당선,선릉,5689,8582,14271,7
2022-07-09,공항철도 1호선,홍대입구,15123,15393,30516,7
2022-07-09,공항철도 1호선,서울역,9391,9401,18792,7
2022-07-09,경의선,홍대입구,2420,3125,5545,7
2022-07-09,경의선,서울역,1470,1616,3086,7
2022-07-09,경부선,가산디지털단지,6576,8562,15138,7
2022-07-09,경부선,서울역,9107,2294,11401,7
2022-07-09,9호선,고속터미널,15654,22519,38173,7
2022-07-09,8호선,잠실(송파구청),14921,17837,32758,7
2022-07-09,7호선,가산디지털단지,15518,13943,29461,7
2022-07-09,7호선,고속터미널,16311,12484,28795,7
2022-07-09,4호선,사당,24411,21790,46201,7
2022-07-09,4호선,서울역,6506,15647,22153,7
2022-07-09,3호선,고속터미널,56574,56214,112788,7
2022-07-09,2호선,홍대입구,73994,83089,157083,7
2022-07-09,2호선,구로디지털단지,36307,35114,71421,7
2022-07-09,2호선,신림,49999,47700,97699,7
2022-07-09,2호선,사당,36051,40814,76865,7
2022-07-09,2호선,강남,63995,64281,128276,7
2022-07-09,2호선,선릉,26566,23181,49747,7
2022-07-09,2호선,잠실(송파구청),74778,72054,146832,7
2022-07-09,1호선,서울역,36244,36601,72845,7
2022-07-10,경의선,홍대입구,1885,2275,4160,7
2022-07-10,공항철도 1호선,서울역,9292,8213,17505,7
2022-07-10,공항철도 1호선,홍대입구,11826,11383,23209,7
2022-07-10,분당선,선릉,2959,4347,7306,7
2022-07-10,신림선,신림,1138,1800,2938,7
2022-07-10,경의선,서울역,1265,1083,2348,7
2022-07-10,경부선,가산디지털단지,4701,6655,11356,7
2022-07-10,경부선,서울역,9350,1976,11326,7
2022-07-10,9호선,고속터미널,12307,16810,29117,7
2022-07-10,8호선,잠실(송파구청),11782,13335,25117,7
2022-07-10,7호선,가산디지털단지,10710,9909,20619,7
2022-07-10,7호선,고속터미널,14209,8768,22977,7
2022-07-10,1호선,서울역,30175,28550,58725,7
2022-07-10,4호선,사당,17337,15960,33297,7
2022-07-10,4호선,서울역,4904,12015,16919,7
2022-07-10,3호선,고속터미널,47291,43582,90873,7
2022-07-10,2호선,홍대입구,58059,57719,115778,7
2022-07-10,2호선,구로디지털단지,25222,24884,50106,7
2022-07-10,2호선,신림,37495,36828,74323,7
2022-07-10,2호선,사당,24676,26737,51413,7
2022-07-10,2호선,강남,37133,35597,72730,7
2022-07-10,2호선,선릉,14125,12292,26417,7
2022-07-10,2호선,잠실(송파구청),53991,50798,104789,7
2022-07-11,신림선,신림,1573,2091,3664,7
2022-07-11,분당선,선릉,14737,22484,37221,7
2022-07-11,공항철도 1호선,홍대입구,10271,10432,20703,7
2022-07-11,공항철도 1호선,서울역,9342,8067,17409,7
2022-07-11,경의선,홍대입구,1717,2066,3783,7
2022-07-11,경의선,서울역,4829,6262,11091,7
2022-07-11,경부선,가산디지털단지,19704,22735,42439,7
2022-07-11,경부선,서울역,7613,2198,9811,7
2022-07-11,9호선,고속터미널,13044,16726,29770,7
2022-07-11,8호선,잠실(송파구청),15010,17567,32577,7
2022-07-11,7호선,가산디지털단지,48381,48254,96635,7
2022-07-11,7호선,고속터미널,16786,13901,30687,7
2022-07-11,4호선,사당,21909,18374,40283,7
2022-07-11,4호선,서울역,12067,17631,29698,7
2022-07-11,3호선,고속터미널,42728,40186,82914,7
2022-07-11,2호선,홍대입구,55597,58626,114223,7
2022-07-11,2호선,구로디지털단지,62259,62572,124831,7
2022-07-11,2호선,신림,58717,56574,115291,7
2022-07-11,2호선,사당,36446,38424,74870,7
2022-07-11,2호선,강남,88595,85799,174394,7
2022-07-11,2호선,선릉,62105,54965,117070,7
2022-07-11,2호선,잠실(송파구청),70266,70799,141065,7
2022-07-11,1호선,서울역,46309,45502,91811,7
2022-07-12,분당선,선릉,15412,23294,38706,7
2022-07-12,공항철도 1호선,홍대입구,10978,11146,22124,7
2022-07-12,공항철도 1호선,서울역,8721,8065,16786,7
2022-07-12,경의선,홍대입구,1880,2217,4097,7
2022-07-12,경의선,서울역,4919,6201,11120,7
2022-07-12,경부선,가산디지털단지,19831,23075,42906,7
2022-07-12,경부선,서울역,6903,2113,9016,7
2022-07-12,9호선,고속터미널,13610,16966,30576,7
2022-07-12,8호선,잠실(송파구청),15266,18293,33559,7
2022-07-12,7호선,가산디지털단지,48884,48897,97781,7
2022-07-12,7호선,고속터미널,16273,13956,30229,7
2022-07-12,4호선,사당,26302,21747,48049,7
2022-07-12,4호선,서울역,12475,17713,30188,7
2022-07-12,3호선,고속터미널,42374,40004,82378,7
2022-07-12,2호선,홍대입구,59262,62630,121892,7
2022-07-12,2호선,구로디지털단지,64089,64462,128551,7
2022-07-12,2호선,신림,60760,58497,119257,7
2022-07-12,2호선,사당,40571,43449,84020,7
2022-07-12,2호선,강남,92818,89754,182572,7
2022-07-12,2호선,선릉,64965,57556,122521,7
2022-07-12,2호선,잠실(송파구청),76380,75782,152162,7
2022-07-12,1호선,서울역,46923,46024,92947,7
2022-07-12,신림선,신림,1663,2209,3872,7
2022-07-13,2호선,잠실(송파구청),71534,71272,142806,7
2022-07-13,2호선,선릉,61391,54220,115611,7
2022-07-13,2호선,강남,86916,83856,170772,7
2022-07-13,2호선,사당,37016,39980,76996,7
2022-07-13,2호선,신림,57160,54823,111983,7
2022-07-13,2호선,구로디지털단지,60096,60622,120718,7
2022-07-13,2호선,홍대입구,53885,57208,111093,7
2022-07-13,3호선,고속터미널,41816,39424,81240,7
2022-07-13,4호선,서울역,12706,18969,31675,7
2022-07-13,4호선,사당,24735,20765,45500,7
2022-07-13,7호선,고속터미널,15967,13133,29100,7
2022-07-13,7호선,가산디지털단지,48190,47398,95588,7
2022-07-13,8호선,잠실(송파구청),15343,17528,32871,7
2022-07-13,9호선,고속터미널,12555,16735,29290,7
2022-07-13,경부선,서울역,7994,2388,10382,7
2022-07-13,경부선,가산디지털단지,18256,22217,40473,7
2022-07-13,경의선,서울역,4608,5839,10447,7
2022-07-13,경의선,홍대입구,1482,1939,3421,7
2022-07-13,공항철도 1호선,서울역,10262,8984,19246,7
2022-07-13,공항철도 1호선,홍대입구,9728,10521,20249,7
2022-07-13,분당선,선릉,15039,22440,37479,7
2022-07-13,신림선,신림,1563,2109,3672,7
2022-07-13,1호선,서울역,48276,45551,93827,7
2022-07-14,1호선,서울역,48500,47714,96214,7
2022-07-14,2호선,잠실(송파구청),79505,79184,158689,7
2022-07-14,2호선,선릉,63845,56912,120757,7
2022-07-14,2호선,강남,92282,89389,181671,7
2022-07-14,2호선,사당,40900,44759,85659,7
2022-07-14,2호선,신림,61720,59018,120738,7
2022-07-14,2호선,구로디지털단지,64376,64122,128498,7
2022-07-14,2호선,홍대입구,62051,66401,128452,7
2022-07-14,3호선,고속터미널,43306,42128,85434,7
2022-07-14,4호선,서울역,12634,19117,31751,7
2022-07-14,4호선,사당,26616,22348,48964,7
2022-07-14,7호선,고속터미널,16484,14277,30761,7
2022-07-14,7호선,가산디지털단지,48124,48694,96818,7
2022-07-14,8호선,잠실(송파구청),15490,18484,33974,7
2022-07-14,9호선,고속터미널,13939,18114,32053,7
2022-07-14,경부선,서울역,7617,2283,9900,7
2022-07-14,경부선,가산디지털단지,19787,22824,42611,7
2022-07-14,경의선,서울역,4815,6205,11020,7
2022-07-14,경의선,홍대입구,1817,2176,3993,7
2022-07-14,공항철도 1호선,서울역,9164,8820,17984,7
2022-07-14,공항철도 1호선,홍대입구,11653,11525,23178,7
2022-07-14,분당선,선릉,15138,23082,38220,7
2022-07-14,신림선,신림,1594,2227,3821,7
2022-07-15,7호선,고속터미널,19086,15815,34901,7
2022-07-15,7호선,가산디지털단지,47882,47499,95381,7
2022-07-15,8호선,잠실(송파구청),16367,19845,36212,7
2022-07-15,9호선,고속터미널,16026,22149,38175,7
2022-07-15,1호선,서울역,53146,52667,105813,7
2022-07-15,2호선,잠실(송파구청),85892,85901,171793,7
2022-07-15,2호선,선릉,64538,56470,121008,7
2022-07-15,2호선,강남,96795,96558,193353,7
2022-07-15,2호선,사당,43771,48238,92009,7
2022-07-15,2호선,신림,64275,60890,125165,7
2022-07-15,경부선,서울역,10130,3013,13143,7
2022-07-15,경부선,가산디지털단지,19805,22657,42462,7
2022-07-15,경의선,서울역,4891,6341,11232,7
2022-07-15,경의선,홍대입구,2096,2573,4669,7
2022-07-15,공항철도 1호선,서울역,10719,10319,21038,7
2022-07-15,공항철도 1호선,홍대입구,12335,13111,25446,7
2022-07-15,분당선,선릉,15207,22887,38094,7
2022-07-15,신림선,신림,1760,2240,4000,7
2022-07-15,3호선,고속터미널,52140,53027,105167,7
2022-07-15,4호선,서울역,12754,21288,34042,7
2022-07-15,4호선,사당,28496,24453,52949,7
2022-07-15,2호선,구로디지털단지,64397,64229,128626,7
2022-07-15,2호선,홍대입구,67085,75557,142642,7
2022-07-16,신림선,신림,1358,1941,3299,7
2022-07-16,경부선,서울역,9220,2336,11556,7
2022-07-16,9호선,고속터미널,15143,21994,37137,7
2022-07-16,8호선,잠실(송파구청),13926,16394,30320,7
2022-07-16,7호선,가산디지털단지,14724,13180,27904,7
2022-07-16,7호선,고속터미널,16044,12215,28259,7
2022-07-16,분당선,선릉,5568,8397,13965,7
2022-07-16,공항철도 1호선,홍대입구,14219,14785,29004,7
2022-07-16,공항철도 1호선,서울역,9477,9013,18490,7
2022-07-16,경의선,홍대입구,2171,2765,4936,7
2022-07-16,경의선,서울역,1610,1658,3268,7
2022-07-16,경부선,가산디지털단지,6383,8526,14909,7
2022-07-16,4호선,사당,23267,20448,43715,7
2022-07-16,4호선,서울역,7254,16133,23387,7
2022-07-16,3호선,고속터미널,54662,54504,109166,7
2022-07-16,2호선,홍대입구,71624,81710,153334,7
2022-07-16,2호선,구로디지털단지,35876,34687,70563,7
2022-07-16,2호선,신림,50242,47444,97686,7
2022-07-16,2호선,사당,34062,38903,72965,7
2022-07-16,2호선,강남,62348,62448,124796,7
2022-07-16,2호선,선릉,26015,23169,49184,7
2022-07-16,2호선,잠실(송파구청),72338,68774,141112,7
2022-07-16,1호선,서울역,39140,38213,77353,7
2022-07-17,1호선,서울역,30407,28987,59394,7
2022-07-17,2호선,잠실(송파구청),53368,50250,103618,7
2022-07-17,2호선,선릉,14201,12227,26428,7
2022-07-17,2호선,강남,36539,35375,71914,7
2022-07-17,2호선,사당,23580,25566,49146,7
2022-07-17,2호선,신림,37883,37019,74902,7
2022-07-17,2호선,구로디지털단지,24941,24776,49717,7
2022-07-17,2호선,홍대입구,57772,57504,115276,7
2022-07-17,3호선,고속터미널,45305,42587,87892,7
2022-07-17,4호선,서울역,4849,12500,17349,7
2022-07-17,4호선,사당,16373,14950,31323,7
2022-07-17,7호선,고속터미널,13947,8859,22806,7
2022-07-17,7호선,가산디지털단지,10563,9623,20186,7
2022-07-17,8호선,잠실(송파구청),11043,12516,23559,7
2022-07-17,9호선,고속터미널,12122,17051,29173,7
2022-07-17,경부선,서울역,9241,1988,11229,7
2022-07-17,경부선,가산디지털단지,4829,6689,11518,7
2022-07-17,경의선,서울역,1275,1028,2303,7
2022-07-17,경의선,홍대입구,1961,2341,4302,7
2022-07-17,공항철도 1호선,서울역,9236,8109,17345,7
2022-07-17,공항철도 1호선,홍대입구,12177,11340,23517,7
2022-07-17,분당선,선릉,2982,4431,7413,7
2022-07-17,신림선,신림,1109,1748,2857,7
2022-07-18,7호선,고속터미널,17192,14306,31498,7
2022-07-18,7호선,가산디지털단지,47594,47809,95403,7
2022-07-18,8호선,잠실(송파구청),14487,16485,30972,7
2022-07-18,9호선,고속터미널,12897,16279,29176,7
2022-07-18,경부선,서울역,7526,2320,9846,7
2022-07-18,4호선,사당,24772,20815,45587,7
2022-07-18,4호선,서울역,12089,17913,30002,7
2022-07-18,3호선,고속터미널,37353,35128,72481,7
2022-07-18,2호선,홍대입구,56500,59738,116238,7
2022-07-18,2호선,구로디지털단지,61230,61410,122640,7
2022-07-18,2호선,신림,58660,56094,114754,7
2022-07-18,2호선,사당,37449,40960,78409,7
2022-07-18,2호선,강남,87595,84835,172430,7
2022-07-18,2호선,선릉,62226,54974,117200,7
2022-07-18,2호선,잠실(송파구청),69223,69472,138695,7
2022-07-18,1호선,서울역,46822,45348,92170,7
2022-07-18,경부선,가산디지털단지,19495,22446,41941,7
2022-07-18,경의선,서울역,4967,6323,11290,7
2022-07-18,경의선,홍대입구,1748,2043,3791,7
2022-07-18,공항철도 1호선,서울역,9131,8429,17560,7
2022-07-18,공항철도 1호선,홍대입구,10690,10608,21298,7
2022-07-18,분당선,선릉,14884,22607,37491,7
2022-07-18,신림선,신림,1627,2192,3819,7
2022-07-19,경부선,서울역,6906,2087,8993,7
2022-07-19,경부선,가산디지털단지,19518,22782,42300,7
2022-07-19,경의선,서울역,4830,6077,10907,7
2022-07-19,경의선,홍대입구,1764,2137,3901,7
2022-07-19,1호선,서울역,47044,45244,92288,7
2022-07-19,2호선,잠실(송파구청),76158,75940,152098,7
2022-07-19,4호선,사당,26170,21968,48138,7
2022-07-19,4호선,서울역,12333,17928,30261,7
2022-07-19,3호선,고속터미널,43076,41149,84225,7
2022-07-19,2호선,홍대입구,59048,62368,121416,7
2022-07-19,2호선,구로디지털단지,63076,63407,126483,7
2022-07-19,2호선,신림,60136,57798,117934,7
2022-07-19,2호선,사당,40055,43231,83286,7
2022-07-19,2호선,강남,91211,87936,179147,7
2022-07-19,2호선,선릉,63770,56660,120430,7
2022-07-19,공항철도 1호선,서울역,8656,7636,16292,7
2022-07-19,공항철도 1호선,홍대입구,10907,11156,22063,7
2022-07-19,분당선,선릉,15445,22935,38380,7
2022-07-19,신림선,신림,1677,2200,3877,7
2022-07-19,7호선,고속터미널,16994,14484,31478,7
2022-07-19,7호선,가산디지털단지,48221,48395,96616,7
2022-07-19,8호선,잠실(송파구청),15234,18056,33290,7
2022-07-19,9호선,고속터미널,13540,17299,30839,7
2022-07-20,신림선,신림,1700,2315,4015,7
2022-07-20,분당선,선릉,15216,23014,38230,7
2022-07-20,공항철도 1호선,홍대입구,11316,11326,22642,7
2022-07-20,공항철도 1호선,서울역,8929,8008,16937,7
2022-07-20,경의선,홍대입구,1919,2310,4229,7
2022-07-20,경의선,서울역,4810,6217,11027,7
2022-07-20,경부선,가산디지털단지,19539,22696,42235,7
2022-07-20,경부선,서울역,7282,2110,9392,7
2022-07-20,9호선,고속터미널,13656,17411,31067,7
2022-07-20,8호선,잠실(송파구청),15916,18421,34337,7
2022-07-20,7호선,가산디지털단지,48245,48281,96526,7
2022-07-20,7호선,고속터미널,16693,14012,30705,7
2022-07-20,1호선,서울역,48149,46822,94971,7
2022-07-20,2호선,잠실(송파구청),77679,76988,154667,7
2022-07-20,2호선,선릉,63922,56655,120577,7
2022-07-20,2호선,강남,91246,88251,179497,7
2022-07-20,2호선,사당,40244,43538,83782,7
2022-07-20,2호선,신림,61007,59039,120046,7
2022-07-20,2호선,구로디지털단지,62962,63008,125970,7
2022-07-20,2호선,홍대입구,61032,64760,125792,7
2022-07-20,3호선,고속터미널,43627,41742,85369,7
2022-07-20,4호선,서울역,12955,19155,32110,7
2022-07-20,4호선,사당,26734,22425,49159,7
2022-07-21,7호선,고속터미널,16326,13956,30282,7
2022-07-21,7호선,가산디지털단지,47076,48157,95233,7
2022-07-21,8호선,잠실(송파구청),14664,17713,32377,7
2022-07-21,9호선,고속터미널,13416,17328,30744,7
2022-07-21,경부선,서울역,7642,2307,9949,7
2022-07-21,경부선,가산디지털단지,19376,22552,41928,7
2022-07-21,경의선,서울역,4851,6077,10928,7
2022-07-21,경의선,홍대입구,1948,2392,4340,7
2022-07-21,공항철도 1호선,서울역,9189,8527,17716,7
2022-07-21,공항철도 1호선,홍대입구,11328,11496,22824,7
2022-07-21,분당선,선릉,15056,22838,37894,7
2022-07-21,신림선,신림,1568,2068,3636,7
2022-07-21,1호선,서울역,47832,46734,94566,7
2022-07-21,2호선,잠실(송파구청),75286,75393,150679,7
2022-07-21,2호선,선릉,63014,56268,119282,7
2022-07-21,2호선,강남,88984,87076,176060,7
2022-07-21,2호선,사당,40031,44059,84090,7
2022-07-21,2호선,신림,60107,57505,117612,7
2022-07-21,2호선,구로디지털단지,62059,62007,124066,7
2022-07-21,2호선,홍대입구,59680,63643,123323,7
2022-07-21,3호선,고속터미널,42342,41078,83420,7
2022-07-21,4호선,서울역,12516,19199,31715,7
2022-07-21,4호선,사당,26332,22119,48451,7
2022-07-22,신림선,신림,1660,2227,3887,7
2022-07-22,분당선,선릉,14638,22100,36738,7
2022-07-22,1호선,서울역,53137,52368,105505,7
2022-07-22,2호선,잠실(송파구청),79617,78246,157863,7
2022-07-22,2호선,선릉,61111,54131,115242,7
2022-07-22,2호선,강남,93558,91899,185457,7
2022-07-22,2호선,사당,42013,47029,89042,7
2022-07-22,2호선,신림,61755,58616,120371,7
2022-07-22,2호선,구로디지털단지,62871,62551,125422,7
2022-07-22,2호선,홍대입구,64812,73453,138265,7
2022-07-22,3호선,고속터미널,49960,52306,102266,7
2022-07-22,4호선,서울역,12354,21417,33771,7
2022-07-22,4호선,사당,28013,23862,51875,7
2022-07-22,7호선,고속터미널,18803,15220,34023,7
2022-07-22,7호선,가산디지털단지,46585,46366,92951,7
2022-07-22,8호선,잠실(송파구청),15592,18675,34267,7
2022-07-22,9호선,고속터미널,15377,21438,36815,7
2022-07-22,경부선,서울역,9747,2922,12669,7
2022-07-22,경부선,가산디지털단지,19229,22086,41315,7
2022-07-22,경의선,서울역,4846,6348,11194,7
2022-07-22,경의선,홍대입구,2019,2470,4489,7
2022-07-22,공항철도 1호선,서울역,10883,10600,21483,7
2022-07-22,공항철도 1호선,홍대입구,12785,12879,25664,7
2022-07-23,2호선,홍대입구,69086,75518,144604,7
2022-07-23,2호선,구로디지털단지,34141,33594,67735,7
2022-07-23,2호선,신림,47152,44831,91983,7
2022-07-23,7호선,고속터미널,15454,11488,26942,7
2022-07-23,7호선,가산디지털단지,13957,12392,26349,7
2022-07-23,8호선,잠실(송파구청),14274,15843,30117,7
2022-07-23,3호선,고속터미널,50934,51894,102828,7
2022-07-23,4호선,사당,21856,19465,41321,7
2022-07-23,2호선,사당,32287,35539,67826,7
2022-07-23,2호선,강남,59296,58483,117779,7
2022-07-23,2호선,선릉,23834,21248,45082,7
2022-07-23,2호선,잠실(송파구청),67141,64689,131830,7
2022-07-23,9호선,고속터미널,13588,20113,33701,7
2022-07-23,경부선,서울역,8585,2277,10862,7
2022-07-23,경부선,가산디지털단지,6031,8094,14125,7
2022-07-23,경의선,홍대입구,1984,2751,4735,7
2022-07-23,공항철도 1호선,서울역,9014,9119,18133,7
2022-07-23,공항철도 1호선,홍대입구,13532,13977,27509,7
2022-07-23,분당선,선릉,5228,7854,13082,7
2022-07-23,신림선,신림,1375,1984,3359,7
2022-07-23,경의선,서울역,1519,1749,3268,7
2022-07-23,1호선,서울역,34747,35058,69805,7
2022-07-23,4호선,서울역,6205,15369,21574,7
2022-07-24,신림선,신림,1173,1695,2868,7
2022-07-24,분당선,선릉,2755,4328,7083,7
2022-07-24,공항철도 1호선,홍대입구,11282,10460,21742,7
2022-07-24,공항철도 1호선,서울역,8966,8268,17234,7
2022-07-24,경의선,홍대입구,1824,2354,4178,7
2022-07-24,경의선,서울역,1221,1088,2309,7
2022-07-24,경부선,가산디지털단지,4572,6341,10913,7
2022-07-24,경부선,서울역,8813,2117,10930,7
2022-07-24,9호선,고속터미널,11248,15753,27001,7
2022-07-24,8호선,잠실(송파구청),10063,11165,21228,7
2022-07-24,7호선,가산디지털단지,9949,9041,18990,7
2022-07-24,7호선,고속터미널,13093,8172,21265,7
2022-07-24,4호선,사당,15087,14131,29218,7
2022-07-24,4호선,서울역,4344,11049,15393,7
2022-07-24,3호선,고속터미널,42236,40382,82618,7
2022-07-24,2호선,홍대입구,53088,53533,106621,7
2022-07-24,2호선,구로디지털단지,23563,23249,46812,7
2022-07-24,2호선,신림,34998,34663,69661,7
2022-07-24,2호선,사당,21926,23785,45711,7
2022-07-24,2호선,강남,34690,32945,67635,7
2022-07-24,2호선,선릉,13041,11273,24314,7
2022-07-24,2호선,잠실(송파구청),48809,45935,94744,7
2022-07-24,1호선,서울역,29049,26654,55703,7
2022-07-25,공항철도 1호선,서울역,9201,8473,17674,7
2022-07-25,공항철도 1호선,홍대입구,10743,10691,21434,7
2022-07-25,분당선,선릉,14348,21820,36168,7
2022-07-25,신림선,신림,1570,2143,3713,7
2022-07-25,7호선,고속터미널,17168,14031,31199,7
2022-07-25,7호선,가산디지털단지,47042,47197,94239,7
2022-07-25,8호선,잠실(송파구청),14917,17370,32287,7
2022-07-25,4호선,사당,24669,20754,45423,7
2022-07-25,4호선,서울역,11787,18094,29881,7
2022-07-25,3호선,고속터미널,43682,41365,85047,7
2022-07-25,2호선,홍대입구,58162,61659,119821,7
2022-07-25,2호선,구로디지털단지,60745,60949,121694,7
2022-07-25,2호선,신림,58023,55498,113521,7
2022-07-25,2호선,사당,37102,40499,77601,7
2022-07-25,2호선,강남,86647,83739,170386,7
2022-07-25,2호선,선릉,61048,53881,114929,7
2022-07-25,2호선,잠실(송파구청),74923,75269,150192,7
2022-07-25,1호선,서울역,47357,45890,93247,7
2022-07-25,9호선,고속터미널,13468,17159,30627,7
2022-07-25,경부선,서울역,8145,2551,10696,7
2022-07-25,경부선,가산디지털단지,18799,21920,40719,7
2022-07-25,경의선,서울역,4729,6035,10764,7
2022-07-25,경의선,홍대입구,1772,2241,4013,7
2022-07-26,신림선,신림,1586,2270,3856,7
2022-07-26,2호선,홍대입구,58230,61199,119429,7
2022-07-26,1호선,서울역,46582,44443,91025,7
2022-07-26,2호선,잠실(송파구청),77658,77349,155007,7
2022-07-26,2호선,선릉,62249,55111,117360,7
2022-07-26,2호선,강남,88300,85237,173537,7
2022-07-26,2호선,사당,38361,42289,80650,7
2022-07-26,2호선,신림,58777,56741,115518,7
2022-07-26,3호선,고속터미널,42291,39866,82157,7
2022-07-26,4호선,서울역,12010,18191,30201,7
2022-07-26,4호선,사당,25920,21408,47328,7
2022-07-26,2호선,구로디지털단지,62053,62021,124074,7
2022-07-26,7호선,고속터미널,16224,13668,29892,7
2022-07-26,7호선,가산디지털단지,47280,47532,94812,7
2022-07-26,8호선,잠실(송파구청),15248,17943,33191,7
2022-07-26,9호선,고속터미널,13204,16720,29924,7
2022-07-26,경부선,서울역,7236,2273,9509,7
2022-07-26,경부선,가산디지털단지,18961,21926,40887,7
2022-07-26,경의선,서울역,4558,5987,10545,7
2022-07-26,경의선,홍대입구,1772,2101,3873,7
2022-07-26,공항철도 1호선,서울역,8752,7889,16641,7
2022-07-26,공항철도 1호선,홍대입구,10490,10901,21391,7
2022-07-26,분당선,선릉,14813,22245,37058,7
2022-07-27,신림선,신림,1627,2294,3921,7
2022-07-27,분당선,선릉,14512,21802,36314,7
2022-07-27,공항철도 1호선,홍대입구,11037,11340,22377,7
2022-07-27,공항철도 1호선,서울역,9093,8447,17540,7
2022-07-27,경의선,홍대입구,1851,2243,4094,7
2022-07-27,경의선,서울역,4580,6018,10598,7
2022-07-27,경부선,가산디지털단지,18580,21519,40099,7
2022-07-27,경부선,서울역,7956,2471,10427,7
2022-07-27,9호선,고속터미널,13075,17396,30471,7
2022-07-27,8호선,잠실(송파구청),15423,18055,33478,7
2022-07-27,7호선,가산디지털단지,46554,46601,93155,7
2022-07-27,7호선,고속터미널,16024,13645,29669,7
2022-07-27,4호선,사당,25725,21370,47095,7
2022-07-27,4호선,서울역,12168,19049,31217,7
2022-07-27,3호선,고속터미널,42389,40482,82871,7
2022-07-27,2호선,홍대입구,59849,63560,123409,7
2022-07-27,2호선,구로디지털단지,61203,61242,122445,7
2022-07-27,2호선,신림,59172,56898,116070,7
2022-07-27,2호선,사당,38744,42174,80918,7
2022-07-27,2호선,강남,87634,84055,171689,7
2022-07-27,2호선,선릉,61490,54292,115782,7
2022-07-27,2호선,잠실(송파구청),77763,77293,155056,7
2022-07-27,1호선,서울역,48224,46488,94712,7
2022-07-28,4호선,서울역,12162,19896,32058,7
2022-07-28,4호선,사당,26148,21687,47835,7
2022-07-28,7호선,고속터미널,16818,13888,30706,7
2022-07-28,7호선,가산디지털단지,45822,46035,91857,7
2022-07-28,8호선,잠실(송파구청),15649,18301,33950,7
2022-07-28,9호선,고속터미널,13873,18310,32183,7
2022-07-28,경부선,서울역,8145,2561,10706,7
2022-07-28,경부선,가산디지털단지,18297,21260,39557,7
2022-07-28,경의선,서울역,4790,6124,10914,7
2022-07-28,경의선,홍대입구,1824,2259,4083,7
2022-07-28,공항철도 1호선,서울역,9461,9081,18542,7
2022-07-28,공항철도 1호선,홍대입구,11426,11952,23378,7
2022-07-28,분당선,선릉,14302,21879,36181,7
2022-07-28,1호선,서울역,48499,47581,96080,7
2022-07-28,2호선,잠실(송파구청),81144,81269,162413,7
2022-07-28,2호선,선릉,61278,54336,115614,7
2022-07-28,2호선,강남,88439,85405,173844,7
2022-07-28,2호선,사당,39458,43478,82936,7
2022-07-28,2호선,신림,59423,56519,115942,7
2022-07-28,2호선,구로디지털단지,60612,60681,121293,7
2022-07-28,2호선,홍대입구,61630,65731,127361,7
2022-07-28,3호선,고속터미널,43552,42517,86069,7
2022-07-28,신림선,신림,1611,2249,3860,7
2022-07-29,분당선,선릉,13777,20902,34679,7
2022-07-29,공항철도 1호선,홍대입구,12627,13236,25863,7
2022-07-29,공항철도 1호선,서울역,11099,10936,22035,7
2022-07-29,경의선,홍대입구,2061,2728,4789,7
2022-07-29,경의선,서울역,4667,6192,10859,7
2022-07-29,1호선,서울역,52759,53172,105931,7
2022-07-29,2호선,잠실(송파구청),82635,82139,164774,7
2022-07-29,2호선,선릉,59169,52518,111687,7
2022-07-29,2호선,강남,90892,89616,180508,7
2022-07-29,2호선,사당,40073,44595,84668,7
2022-07-29,2호선,신림,60437,57765,118202,7
2022-07-29,2호선,구로디지털단지,60124,60229,120353,7
2022-07-29,2호선,홍대입구,66396,73957,140353,7
2022-07-29,3호선,고속터미널,51448,54259,105707,7
2022-07-29,4호선,서울역,11956,21928,33884,7
2022-07-29,4호선,사당,27195,22703,49898,7
2022-07-29,7호선,고속터미널,19235,15361,34596,7
2022-07-29,7호선,가산디지털단지,45225,44410,89635,7
2022-07-29,8호선,잠실(송파구청),16274,19091,35365,7
2022-07-29,9호선,고속터미널,16272,23561,39833,7
2022-07-29,경부선,서울역,9950,3097,13047,7
2022-07-29,경부선,가산디지털단지,17857,20847,38704,7
2022-07-29,신림선,신림,1780,2293,4073,7
2022-07-30,4호선,사당,20159,17228,37387,7
2022-07-30,4호선,서울역,5889,15282,21171,7
2022-07-30,1호선,서울역,35541,36777,72318,7
2022-07-30,2호선,잠실(송파구청),68624,65586,134210,7
2022-07-30,2호선,선릉,21571,19044,40615,7
2022-07-30,2호선,강남,55226,54764,109990,7
2022-07-30,2호선,사당,28421,31376,59797,7
2022-07-30,2호선,신림,44971,42160,87131,7
2022-07-30,2호선,구로디지털단지,31345,30236,61581,7
2022-07-30,2호선,홍대입구,66121,74312,140433,7
2022-07-30,8호선,잠실(송파구청),14158,16124,30282,7
2022-07-30,9호선,고속터미널,14637,22102,36739,7
2022-07-30,경부선,서울역,9005,2436,11441,7
2022-07-30,경부선,가산디지털단지,5858,7514,13372,7
2022-07-30,경의선,서울역,1419,1517,2936,7
2022-07-30,경의선,홍대입구,1919,2694,4613,7
2022-07-30,공항철도 1호선,서울역,9371,9460,18831,7
2022-07-30,공항철도 1호선,홍대입구,12822,13273,26095,7
2022-07-30,분당선,선릉,4600,6683,11283,7
2022-07-30,신림선,신림,1388,1740,3128,7
2022-07-30,3호선,고속터미널,50633,52156,102789,7
2022-07-30,7호선,가산디지털단지,13331,11939,25270,7
2022-07-30,7호선,고속터미널,14648,10868,25516,7
2022-07-31,신림선,신림,973,1399,2372,7
2022-07-31,2호선,잠실(송파구청),50683,47773,98456,7
2022-07-31,8호선,잠실(송파구청),11285,12180,23465,7
2022-07-31,7호선,가산디지털단지,8733,7824,16557,7
2022-07-31,7호선,고속터미널,13901,7447,21348,7
2022-07-31,4호선,사당,14160,12695,26855,7
2022-07-31,4호선,서울역,4326,12258,16584,7
2022-07-31,3호선,고속터미널,43773,39029,82802,7
2022-07-31,9호선,고속터미널,11088,16536,27624,7
2022-07-31,경부선,서울역,9647,2217,11864,7
2022-07-31,경부선,가산디지털단지,3895,5806,9701,7
2022-07-31,경의선,서울역,1240,1097,2337,7
2022-07-31,경의선,홍대입구,1449,1877,3326,7
2022-07-31,공항철도 1호선,서울역,9854,8512,18366,7
2022-07-31,공항철도 1호선,홍대입구,10031,9711,19742,7
2022-07-31,분당선,선릉,2529,3709,6238,7
2022-07-31,1호선,서울역,32137,29669,61806,7
2022-07-31,2호선,홍대입구,50103,49349,99452,7
2022-07-31,2호선,구로디지털단지,21499,21661,43160,7
2022-07-31,2호선,신림,32131,31556,63687,7
2022-07-31,2호선,사당,18946,20878,39824,7
2022-07-31,2호선,강남,31573,29921,61494,7
2022-07-31,2호선,선릉,11740,10487,22227,7
2022-08-01,경의선,서울역,4259,5509,9768,8
2022-08-01,경의선,홍대입구,1745,2273,4018,8
2022-08-01,공항철도 1호선,서울역,9507,8682,18189,8
2022-08-01,공항철도 1호선,홍대입구,11054,11420,22474,8
2022-08-01,분당선,선릉,13065,20185,33250,8
2022-08-01,신림선,신림,1543,2224,3767,8
2022-08-01,1호선,서울역,47711,45432,93143,8
2022-08-01,2호선,잠실(송파구청),77926,76365,154291,8
2022-08-01,2호선,선릉,55727,48855,104582,8
2022-08-01,2호선,강남,81367,78225,159592,8
2022-08-01,2호선,사당,33666,37104,70770,8
2022-08-01,2호선,신림,54360,52200,106560,8
2022-08-01,2호선,구로디지털단지,55050,55418,110468,8
2022-08-01,2호선,홍대입구,58861,61514,120375,8
2022-08-01,3호선,고속터미널,42513,39733,82246,8
2022-08-01,4호선,서울역,10882,18017,28899,8
2022-08-01,4호선,사당,23135,18753,41888,8
2022-08-01,7호선,고속터미널,17257,13104,30361,8
2022-08-01,7호선,가산디지털단지,41483,41587,83070,8
2022-08-01,8호선,잠실(송파구청),15386,17806,33192,8
2022-08-01,9호선,고속터미널,12882,17184,30066,8
2022-08-01,경부선,서울역,8890,2395,11285,8
2022-08-01,경부선,가산디지털단지,16460,19217,35677,8
2022-08-02,4호선,사당,23948,19800,43748,8
2022-08-02,4호선,서울역,11300,17341,28641,8
2022-08-02,3호선,고속터미널,41650,39054,80704,8
2022-08-02,2호선,홍대입구,57176,59296,116472,8
2022-08-02,2호선,구로디지털단지,56375,56401,112776,8
2022-08-02,2호선,신림,54975,52992,107967,8
2022-08-02,2호선,사당,35249,38819,74068,8
2022-08-02,2호선,강남,84287,80477,164764,8
2022-08-02,2호선,선릉,56971,50736,107707,8
2022-08-02,2호선,잠실(송파구청),77445,76899,154344,8
2022-08-02,1호선,서울역,46815,43759,90574,8
2022-08-02,경부선,서울역,8314,2252,10566,8
2022-08-02,경부선,가산디지털단지,16108,19060,35168,8
2022-08-02,경의선,서울역,4240,5313,9553,8
2022-08-02,경의선,홍대입구,1763,2113,3876,8
2022-08-02,공항철도 1호선,서울역,9701,9315,19016,8
2022-08-02,공항철도 1호선,홍대입구,10847,11233,22080,8
2022-08-02,분당선,선릉,13915,20533,34448,8
2022-08-02,신림선,신림,1622,2203,3825,8
2022-08-02,9호선,고속터미널,12508,16826,29334,8
2022-08-02,8호선,잠실(송파구청),15632,18063,33695,8
2022-08-02,7호선,가산디지털단지,42006,41511,83517,8
2022-08-02,7호선,고속터미널,16721,13276,29997,8
2022-08-03,2호선,홍대입구,58082,61238,119320,8
2022-08-03,2호선,구로디지털단지,56831,57120,113951,8
2022-08-03,2호선,신림,56406,53976,110382,8
2022-08-03,2호선,사당,36089,39206,75295,8
2022-08-03,2호선,강남,83172,80185,163357,8
2022-08-03,2호선,선릉,57347,50619,107966,8
2022-08-03,2호선,잠실(송파구청),75209,75005,150214,8
2022-08-03,1호선,서울역,46124,44255,90379,8
2022-08-03,4호선,사당,23956,19854,43810,8
2022-08-03,4호선,서울역,11041,17909,28950,8
2022-08-03,3호선,고속터미널,41136,39470,80606,8
2022-08-03,7호선,고속터미널,16410,13245,29655,8
2022-08-03,7호선,가산디지털단지,41510,41695,83205,8
2022-08-03,8호선,잠실(송파구청),14949,17466,32415,8
2022-08-03,9호선,고속터미널,13051,16776,29827,8
2022-08-03,경부선,서울역,8287,2240,10527,8
2022-08-03,경부선,가산디지털단지,16727,19415,36142,8
2022-08-03,경의선,서울역,4350,5302,9652,8
2022-08-03,경의선,홍대입구,1720,2113,3833,8
2022-08-03,공항철도 1호선,서울역,9215,8472,17687,8
2022-08-03,공항철도 1호선,홍대입구,10958,11211,22169,8
2022-08-03,분당선,선릉,13654,20442,34096,8
2022-08-03,신림선,신림,1663,2131,3794,8
2022-08-04,2호선,잠실(송파구청),78110,77643,155753,8
2022-08-04,2호선,선릉,58976,52192,111168,8
2022-08-04,2호선,사당,37493,41066,78559,8
2022-08-04,2호선,신림,57745,55252,112997,8
2022-08-04,2호선,구로디지털단지,58749,58751,117500,8
2022-08-04,7호선,가산디지털단지,43347,43518,86865,8
2022-08-04,8호선,잠실(송파구청),15329,17805,33134,8
2022-08-04,9호선,고속터미널,13133,17206,30339,8
2022-08-04,경부선,서울역,7693,2328,10021,8
2022-08-04,경부선,가산디지털단지,17644,20342,37986,8
2022-08-04,경의선,서울역,4499,5752,10251,8
2022-08-04,경의선,홍대입구,1938,2217,4155,8
2022-08-04,공항철도 1호선,서울역,9219,8701,17920,8
2022-08-04,공항철도 1호선,홍대입구,11395,11865,23260,8
2022-08-04,분당선,선릉,14065,21089,35154,8
2022-08-04,7호선,고속터미널,16448,13629,30077,8
2022-08-04,2호선,홍대입구,60738,64935,125673,8
2022-08-04,3호선,고속터미널,42137,40875,83012,8
2022-08-04,4호선,서울역,11540,18146,29686,8
2022-08-04,4호선,사당,25224,20894,46118,8
2022-08-04,신림선,신림,1660,2275,3935,8
2022-08-04,2호선,강남,85162,81971,167133,8
2022-08-04,1호선,서울역,46776,45483,92259,8
2022-08-05,신림선,신림,1717,2252,3969,8
2022-08-05,분당선,선릉,13602,20321,33923,8
2022-08-05,공항철도 1호선,홍대입구,12332,12894,25226,8
2022-08-05,공항철도 1호선,서울역,10220,9813,20033,8
2022-08-05,경의선,홍대입구,2065,2430,4495,8
2022-08-05,경의선,서울역,4525,5854,10379,8
2022-08-05,경부선,가산디지털단지,17330,19797,37127,8
2022-08-05,경부선,서울역,9487,2826,12313,8
2022-08-05,9호선,고속터미널,14508,20058,34566,8
2022-08-05,8호선,잠실(송파구청),15926,18666,34592,8
2022-08-05,7호선,가산디지털단지,43424,42885,86309,8
2022-08-05,7호선,고속터미널,18173,14643,32816,8
2022-08-05,4호선,사당,26049,21656,47705,8
2022-08-05,4호선,서울역,11542,19921,31463,8
2022-08-05,3호선,고속터미널,47813,49568,97381,8
2022-08-05,2호선,홍대입구,63796,71045,134841,8
2022-08-05,2호선,구로디지털단지,58633,58678,117311,8
2022-08-05,2호선,신림,58754,56510,115264,8
2022-08-05,2호선,사당,38533,42216,80749,8
2022-08-05,2호선,강남,88357,86655,175012,8
2022-08-05,2호선,선릉,57582,50545,108127,8
2022-08-05,2호선,잠실(송파구청),78628,77053,155681,8
2022-08-05,1호선,서울역,49735,49242,98977,8
2022-08-06,1호선,서울역,32416,32367,64783,8
2022-08-06,2호선,잠실(송파구청),63773,61185,124958,8
2022-08-06,2호선,선릉,22119,19130,41249,8
2022-08-06,2호선,강남,55874,55729,111603,8
2022-08-06,2호선,사당,28664,31585,60249,8
2022-08-06,2호선,신림,44500,42033,86533,8
2022-08-06,2호선,구로디지털단지,31891,30946,62837,8
2022-08-06,2호선,홍대입구,64508,72296,136804,8
2022-08-06,3호선,고속터미널,46662,47100,93762,8
2022-08-06,4호선,서울역,5649,13721,19370,8
2022-08-06,4호선,사당,19940,17303,37243,8
2022-08-06,7호선,고속터미널,13756,10049,23805,8
2022-08-06,7호선,가산디지털단지,12668,11294,23962,8
2022-08-06,8호선,잠실(송파구청),13333,15562,28895,8
2022-08-06,9호선,고속터미널,12314,18218,30532,8
2022-08-06,경부선,서울역,7950,2073,10023,8
2022-08-06,경부선,가산디지털단지,5567,7317,12884,8
2022-08-06,경의선,서울역,1403,1465,2868,8
2022-08-06,경의선,홍대입구,1936,2535,4471,8
2022-08-06,공항철도 1호선,서울역,8739,8583,17322,8
2022-08-06,공항철도 1호선,홍대입구,12742,13071,25813,8
2022-08-06,분당선,선릉,4668,7138,11806,8
2022-08-06,신림선,신림,1345,1887,3232,8
2022-08-07,1호선,서울역,28430,26845,55275,8
2022-08-07,2호선,잠실(송파구청),49998,47369,97367,8
2022-08-07,2호선,선릉,12070,10461,22531,8
2022-08-07,2호선,강남,32469,31177,63646,8
2022-08-07,2호선,사당,20059,22433,42492,8
2022-08-07,2호선,신림,33573,32922,66495,8
2022-08-07,2호선,구로디지털단지,22653,22503,45156,8
2022-08-07,2호선,홍대입구,51697,51852,103549,8
2022-08-07,3호선,고속터미널,40409,37537,77946,8
2022-08-07,4호선,서울역,4231,10775,15006,8
2022-08-07,4호선,사당,14442,13276,27718,8
2022-08-07,7호선,고속터미널,12942,7470,20412,8
2022-08-07,7호선,가산디지털단지,9173,8406,17579,8
2022-08-07,8호선,잠실(송파구청),10865,11947,22812,8
2022-08-07,9호선,고속터미널,10484,14491,24975,8
2022-08-07,경부선,서울역,8638,2002,10640,8
2022-08-07,경부선,가산디지털단지,4257,5895,10152,8
2022-08-07,경의선,서울역,1187,1087,2274,8
2022-08-07,경의선,홍대입구,1678,2120,3798,8
2022-08-07,공항철도 1호선,서울역,8935,7970,16905,8
2022-08-07,공항철도 1호선,홍대입구,10754,10253,21007,8
2022-08-07,분당선,선릉,2680,3883,6563,8
2022-08-07,신림선,신림,1093,1614,2707,8
2022-08-08,신림선,신림,1706,2347,4053,8
2022-08-08,1호선,서울역,44544,43670,88214,8
2022-08-08,2호선,잠실(송파구청),68501,67171,135672,8
2022-08-08,2호선,선릉,57495,50550,108045,8
2022-08-08,2호선,강남,86593,77893,164486,8
2022-08-08,2호선,사당,36000,37666,73666,8
2022-08-08,2호선,신림,53869,52600,106469,8
2022-08-08,2호선,구로디지털단지,57403,58416,115819,8
2022-08-08,2호선,홍대입구,51435,53175,104610,8
2022-08-08,3호선,고속터미널,38079,35543,73622,8
2022-08-08,4호선,서울역,11438,17705,29143,8
2022-08-08,4호선,사당,23660,18547,42207,8
2022-08-08,7호선,고속터미널,16171,12951,29122,8
2022-08-08,7호선,가산디지털단지,46835,45526,92361,8
2022-08-08,8호선,잠실(송파구청),15487,16790,32277,8
2022-08-08,9호선,고속터미널,10890,15365,26255,8
2022-08-08,경부선,서울역,7561,2571,10132,8
2022-08-08,경부선,가산디지털단지,16716,20758,37474,8
2022-08-08,경의선,서울역,4042,5350,9392,8
2022-08-08,경의선,홍대입구,1490,1833,3323,8
2022-08-08,공항철도 1호선,서울역,8530,8271,16801,8
2022-08-08,공항철도 1호선,홍대입구,9811,10034,19845,8
2022-08-08,분당선,선릉,14095,20408,34503,8
2022-08-09,경의선,서울역,4261,5284,9545,8
2022-08-09,경의선,홍대입구,1327,1610,2937,8
2022-08-09,공항철도 1호선,서울역,8513,7835,16348,8
2022-08-09,공항철도 1호선,홍대입구,8385,8814,17199,8
2022-08-09,신림선,신림,1384,1825,3209,8
2022-08-09,분당선,선릉,12871,17564,30435,8
2022-08-09,1호선,서울역,42032,40050,82082,8
2022-08-09,2호선,잠실(송파구청),59806,59258,119064,8
2022-08-09,2호선,선릉,52643,47797,100440,8
2022-08-09,2호선,강남,66275,63723,129998,8
2022-08-09,2호선,사당,30084,31405,61489,8
2022-08-09,2호선,신림,49046,47563,96609,8
2022-08-09,2호선,구로디지털단지,51904,51721,103625,8
2022-08-09,2호선,홍대입구,44208,45623,89831,8
2022-08-09,3호선,고속터미널,35817,35185,71002,8
2022-08-09,4호선,서울역,10953,16119,27072,8
2022-08-09,4호선,사당,18898,15230,34128,8
2022-08-09,7호선,고속터미널,13574,11839,25413,8
2022-08-09,7호선,가산디지털단지,43169,41846,85015,8
2022-08-09,8호선,잠실(송파구청),13751,15117,28868,8
2022-08-09,9호선,고속터미널,4372,5164,9536,8
2022-08-09,경부선,서울역,6780,2175,8955,8
2022-08-09,경부선,가산디지털단지,16333,18808,35141,8
2022-08-10,9호선,고속터미널,12379,14900,27279,8
2022-08-10,경부선,가산디지털단지,18294,20852,39146,8
2022-08-10,경의선,서울역,4580,5699,10279,8
2022-08-10,경의선,홍대입구,1755,2198,3953,8
2022-08-10,공항철도 1호선,홍대입구,10402,10840,21242,8
2022-08-10,분당선,선릉,14146,20622,34768,8
2022-08-10,3호선,고속터미널,38005,36689,74694,8
2022-08-10,4호선,서울역,11612,17843,29455,8
2022-08-10,공항철도 1호선,서울역,9030,8324,17354,8
2022-08-10,신림선,신림,1587,2118,3705,8
2022-08-10,1호선,서울역,45329,44310,89639,8
2022-08-10,2호선,잠실(송파구청),70661,70356,141017,8
2022-08-10,2호선,선릉,58049,51588,109637,8
2022-08-10,2호선,강남,76161,72739,148900,8
2022-08-10,2호선,사당,36093,38637,74730,8
2022-08-10,2호선,신림,56903,55202,112105,8
2022-08-10,2호선,구로디지털단지,57810,58036,115846,8
2022-08-10,경부선,서울역,6944,2327,9271,8
2022-08-10,2호선,홍대입구,56675,60821,117496,8
2022-08-10,4호선,사당,22964,19150,42114,8
2022-08-10,7호선,고속터미널,14908,12842,27750,8
2022-08-10,7호선,가산디지털단지,44555,44456,89011,8
2022-08-10,8호선,잠실(송파구청),14773,16929,31702,8
2022-08-11,신림선,신림,1475,2059,3534,8
2022-08-11,4호선,서울역,11593,18174,29767,8
2022-08-11,4호선,사당,24224,19840,44064,8
2022-08-11,2호선,사당,36774,39930,76704,8
2022-08-11,2호선,신림,56720,54230,110950,8
2022-08-11,2호선,구로디지털단지,58799,58889,117688,8
2022-08-11,2호선,홍대입구,57227,61335,118562,8
2022-08-11,3호선,고속터미널,38889,38530,77419,8
2022-08-11,2호선,강남,79605,76199,155804,8
2022-08-11,2호선,선릉,58754,52388,111142,8
2022-08-11,2호선,잠실(송파구청),70580,70482,141062,8
2022-08-11,1호선,서울역,45932,45132,91064,8
2022-08-11,7호선,고속터미널,15301,13460,28761,8
2022-08-11,7호선,가산디지털단지,44565,44938,89503,8
2022-08-11,8호선,잠실(송파구청),14596,17104,31700,8
2022-08-11,9호선,고속터미널,12255,15164,27419,8
2022-08-11,경부선,서울역,7523,2460,9983,8
2022-08-11,경부선,가산디지털단지,17989,20637,38626,8
2022-08-11,경의선,서울역,4549,5593,10142,8
2022-08-11,경의선,홍대입구,1875,2224,4099,8
2022-08-11,공항철도 1호선,서울역,9211,8575,17786,8
2022-08-11,공항철도 1호선,홍대입구,11007,11283,22290,8
2022-08-11,분당선,선릉,14184,21227,35411,8
2022-08-12,공항철도 1호선,서울역,11110,10807,21917,8
2022-08-12,공항철도 1호선,홍대입구,12901,13452,26353,8
2022-08-12,분당선,선릉,13986,20873,34859,8
2022-08-12,1호선,서울역,51661,53036,104697,8
2022-08-12,2호선,잠실(송파구청),81179,80467,161646,8
2022-08-12,2호선,선릉,59562,52309,111871,8
2022-08-12,2호선,강남,87842,86551,174393,8
2022-08-12,2호선,사당,41214,44508,85722,8
2022-08-12,2호선,신림,61292,58402,119694,8
2022-08-12,2호선,구로디지털단지,60404,59519,119923,8
2022-08-12,2호선,홍대입구,67383,75205,142588,8
2022-08-12,신림선,신림,1723,2259,3982,8
2022-08-12,3호선,고속터미널,49458,56009,105467,8
2022-08-12,4호선,서울역,11955,21782,33737,8
2022-08-12,4호선,사당,27025,22680,49705,8
2022-08-12,경의선,홍대입구,2124,2716,4840,8
2022-08-12,경의선,서울역,4641,6106,10747,8
2022-08-12,경부선,가산디지털단지,17994,20618,38612,8
2022-08-12,경부선,서울역,9803,3324,13127,8
2022-08-12,9호선,고속터미널,14957,21682,36639,8
2022-08-12,7호선,고속터미널,18189,15333,33522,8
2022-08-12,8호선,잠실(송파구청),16085,18773,34858,8
2022-08-12,7호선,가산디지털단지,44383,43633,88016,8
2022-08-13,경부선,가산디지털단지,5479,7061,12540,8
2022-08-13,경부선,서울역,8801,2693,11494,8
2022-08-13,분당선,선릉,4602,6734,11336,8
2022-08-13,9호선,고속터미널,12189,19880,32069,8
2022-08-13,8호선,잠실(송파구청),12979,15482,28461,8
2022-08-13,7호선,가산디지털단지,12208,10764,22972,8
2022-08-13,7호선,고속터미널,13946,10829,24775,8
2022-08-13,공항철도 1호선,홍대입구,12324,12896,25220,8
2022-08-13,공항철도 1호선,서울역,8939,9623,18562,8
2022-08-13,2호선,구로디지털단지,31259,29962,61221,8
2022-08-13,2호선,신림,43271,40074,83345,8
2022-08-13,2호선,사당,27551,30707,58258,8
2022-08-13,2호선,강남,49667,50009,99676,8
2022-08-13,2호선,선릉,21492,18780,40272,8
2022-08-13,2호선,잠실(송파구청),63368,61732,125100,8
2022-08-13,4호선,사당,18823,16436,35259,8
2022-08-13,4호선,서울역,6026,15933,21959,8
2022-08-13,3호선,고속터미널,45824,52480,98304,8
2022-08-13,2호선,홍대입구,60928,67551,128479,8
2022-08-13,1호선,서울역,34909,37747,72656,8
2022-08-13,신림선,신림,1200,1549,2749,8
2022-08-13,경의선,홍대입구,1956,2654,4610,8
2022-08-13,경의선,서울역,1299,1515,2814,8
2022-08-14,7호선,고속터미널,11068,6963,18031,8
2022-08-14,7호선,가산디지털단지,9717,8634,18351,8
2022-08-14,8호선,잠실(송파구청),10984,12634,23618,8
2022-08-14,9호선,고속터미널,9818,14009,23827,8
2022-08-14,경부선,서울역,7992,1852,9844,8
2022-08-14,경부선,가산디지털단지,4369,5767,10136,8
2022-08-14,경의선,서울역,1077,1116,2193,8
2022-08-14,경의선,홍대입구,1847,2332,4179,8
2022-08-14,공항철도 1호선,서울역,8372,7440,15812,8
2022-08-14,공항철도 1호선,홍대입구,11398,11729,23127,8
2022-08-14,분당선,선릉,2718,3741,6459,8
2022-08-14,신림선,신림,1091,1523,2614,8
2022-08-14,2호선,홍대입구,55154,59205,114359,8
2022-08-14,2호선,구로디지털단지,23465,22540,46005,8
2022-08-14,2호선,신림,35041,34226,69267,8
2022-08-14,1호선,서울역,27476,26518,53994,8
2022-08-14,2호선,사당,21426,23154,44580,8
2022-08-14,2호선,강남,32154,32341,64495,8
2022-08-14,2호선,선릉,12076,10426,22502,8
2022-08-14,2호선,잠실(송파구청),54837,51495,106332,8
2022-08-14,3호선,고속터미널,37298,36876,74174,8
2022-08-14,4호선,서울역,4547,11263,15810,8
2022-08-14,4호선,사당,14757,13322,28079,8
2022-08-15,신림선,신림,1007,1362,2369,8
2022-08-15,분당선,선릉,2663,4138,6801,8
2022-08-15,공항철도 1호선,홍대입구,9487,9222,18709,8
2022-08-15,공항철도 1호선,서울역,9502,7613,17115,8
2022-08-15,경의선,홍대입구,1471,1837,3308,8
2022-08-15,경의선,서울역,1390,1192,2582,8
2022-08-15,경부선,가산디지털단지,4535,6589,11124,8
2022-08-15,경부선,서울역,9637,1745,11382,8
2022-08-15,9호선,고속터미널,11069,13296,24365,8
2022-08-15,8호선,잠실(송파구청),10893,11728,22621,8
2022-08-15,7호선,가산디지털단지,9666,9253,18919,8
2022-08-15,7호선,고속터미널,14759,7078,21837,8
2022-08-15,4호선,사당,13082,12189,25271,8
2022-08-15,4호선,서울역,4071,10142,14213,8
2022-08-15,3호선,고속터미널,44443,35735,80178,8
2022-08-15,2호선,홍대입구,48242,48442,96684,8
2022-08-15,2호선,구로디지털단지,22524,23119,45643,8
2022-08-15,2호선,신림,32467,32644,65111,8
2022-08-15,2호선,사당,19169,20982,40151,8
2022-08-15,2호선,강남,30953,29257,60210,8
2022-08-15,2호선,선릉,13186,12109,25295,8
2022-08-15,2호선,잠실(송파구청),47082,44389,91471,8
2022-08-15,1호선,서울역,32920,29633,62553,8
2022-08-16,경의선,서울역,4770,5978,10748,8
2022-08-16,경의선,홍대입구,1805,2193,3998,8
2022-08-16,공항철도 1호선,서울역,9875,8302,18177,8
2022-08-16,공항철도 1호선,홍대입구,10913,11259,22172,8
2022-08-16,분당선,선릉,14210,21477,35687,8
2022-08-16,신림선,신림,1611,2304,3915,8
2022-08-16,2호선,신림,56667,55340,112007,8
2022-08-16,2호선,구로디지털단지,59754,60088,119842,8
2022-08-16,2호선,홍대입구,57871,61709,119580,8
2022-08-16,3호선,고속터미널,42803,38857,81660,8
2022-08-16,4호선,서울역,11483,17342,28825,8
2022-08-16,4호선,사당,22776,20096,42872,8
2022-08-16,7호선,고속터미널,16542,13042,29584,8
2022-08-16,7호선,가산디지털단지,44973,45077,90050,8
2022-08-16,8호선,잠실(송파구청),14273,16765,31038,8
2022-08-16,1호선,서울역,48749,44367,93116,8
2022-08-16,2호선,잠실(송파구청),71939,71560,143499,8
2022-08-16,2호선,선릉,59798,52947,112745,8
2022-08-16,2호선,강남,82384,79412,161796,8
2022-08-16,2호선,사당,38163,39974,78137,8
2022-08-16,9호선,고속터미널,13319,15948,29267,8
2022-08-16,경부선,서울역,8912,2267,11179,8
2022-08-16,경부선,가산디지털단지,18135,21020,39155,8
2022-08-17,7호선,고속터미널,16114,13346,29460,8
2022-08-17,7호선,가산디지털단지,45698,45892,91590,8
2022-08-17,8호선,잠실(송파구청),14476,17133,31609,8
2022-08-17,2호선,구로디지털단지,60771,61137,121908,8
2022-08-17,9호선,고속터미널,13220,16454,29674,8
2022-08-17,3호선,고속터미널,41499,39535,81034,8
2022-08-17,2호선,홍대입구,59662,62914,122576,8
2022-08-17,4호선,서울역,11926,17459,29385,8
2022-08-17,4호선,사당,26619,21392,48011,8
2022-08-17,2호선,신림,58504,56273,114777,8
2022-08-17,1호선,서울역,48154,46350,94504,8
2022-08-17,2호선,잠실(송파구청),73716,72993,146709,8
2022-08-17,2호선,선릉,60744,53618,114362,8
2022-08-17,2호선,강남,85577,81606,167183,8
2022-08-17,2호선,사당,39639,42226,81865,8
2022-08-17,경부선,서울역,7855,2250,10105,8
2022-08-17,경부선,가산디지털단지,18590,21497,40087,8
2022-08-17,경의선,서울역,4725,5820,10545,8
2022-08-17,경의선,홍대입구,1812,2250,4062,8
2022-08-17,공항철도 1호선,서울역,9396,8314,17710,8
2022-08-17,공항철도 1호선,홍대입구,10946,11499,22445,8
2022-08-17,분당선,선릉,14493,21766,36259,8
2022-08-17,신림선,신림,1611,2225,3836,8
2022-08-18,8호선,잠실(송파구청),14554,16793,31347,8
2022-08-18,7호선,가산디지털단지,45695,46061,91756,8
2022-08-18,7호선,고속터미널,16067,13622,29689,8
2022-08-18,4호선,사당,25253,21446,46699,8
2022-08-18,4호선,서울역,12043,18654,30697,8
2022-08-18,3호선,고속터미널,41773,40476,82249,8
2022-08-18,2호선,홍대입구,60305,64402,124707,8
2022-08-18,2호선,구로디지털단지,61178,61305,122483,8
2022-08-18,2호선,신림,58929,56321,115250,8
2022-08-18,2호선,사당,39932,42759,82691,8
2022-08-18,2호선,강남,85878,82883,168761,8
2022-08-18,2호선,선릉,61114,54491,115605,8
2022-08-18,2호선,잠실(송파구청),73647,72580,146227,8
2022-08-18,1호선,서울역,48506,46806,95312,8
2022-08-18,9호선,고속터미널,13216,16814,30030,8
2022-08-18,경부선,서울역,7961,2272,10233,8
2022-08-18,경부선,가산디지털단지,18354,21444,39798,8
2022-08-18,경의선,서울역,4717,6117,10834,8
2022-08-18,경의선,홍대입구,1840,2273,4113,8
2022-08-18,공항철도 1호선,서울역,9361,8584,17945,8
2022-08-18,공항철도 1호선,홍대입구,11457,11660,23117,8
2022-08-18,분당선,선릉,14541,21836,36377,8
2022-08-18,신림선,신림,1654,2216,3870,8
2022-08-19,신림선,신림,1618,2108,3726,8
2022-08-19,4호선,사당,26848,22392,49240,8
2022-08-19,4호선,서울역,12419,20863,33282,8
2022-08-19,3호선,고속터미널,47583,48533,96116,8
2022-08-19,2호선,홍대입구,60209,67022,127231,8
2022-08-19,2호선,구로디지털단지,61093,60707,121800,8
2022-08-19,2호선,신림,59117,56876,115993,8
2022-08-19,2호선,사당,39608,43298,82906,8
2022-08-19,2호선,강남,87007,84190,171197,8
2022-08-19,2호선,선릉,60001,52724,112725,8
2022-08-19,2호선,잠실(송파구청),72234,70980,143214,8
2022-08-19,1호선,서울역,52600,51610,104210,8
2022-08-19,7호선,고속터미널,18088,14213,32301,8
2022-08-19,7호선,가산디지털단지,46104,44896,91000,8
2022-08-19,8호선,잠실(송파구청),15681,17659,33340,8
2022-08-19,9호선,고속터미널,13204,18616,31820,8
2022-08-19,경부선,서울역,10009,3051,13060,8
2022-08-19,경부선,가산디지털단지,18231,21457,39688,8
2022-08-19,경의선,서울역,4589,6028,10617,8
2022-08-19,경의선,홍대입구,1873,2348,4221,8
2022-08-19,공항철도 1호선,서울역,10979,10193,21172,8
2022-08-19,공항철도 1호선,홍대입구,11391,12579,23970,8
2022-08-19,분당선,선릉,14681,21458,36139,8
2022-08-20,신림선,신림,1366,1801,3167,8
2022-08-20,분당선,선릉,5410,8406,13816,8
2022-08-20,공항철도 1호선,홍대입구,14584,14768,29352,8
2022-08-20,공항철도 1호선,서울역,9312,9309,18621,8
2022-08-20,경의선,홍대입구,2236,2806,5042,8
2022-08-20,경의선,서울역,1450,1543,2993,8
2022-08-20,경부선,가산디지털단지,6206,8058,14264,8
2022-08-20,경부선,서울역,8834,2236,11070,8
2022-08-20,9호선,고속터미널,13277,18716,31993,8
2022-08-20,8호선,잠실(송파구청),13588,15898,29486,8
2022-08-20,7호선,가산디지털단지,14001,12639,26640,8
2022-08-20,7호선,고속터미널,15046,11539,26585,8
2022-08-20,4호선,사당,22036,20241,42277,8
2022-08-20,4호선,서울역,6243,15529,21772,8
2022-08-20,3호선,고속터미널,50219,50578,100797,8
2022-08-20,2호선,홍대입구,68915,78198,147113,8
2022-08-20,2호선,구로디지털단지,34646,33667,68313,8
2022-08-20,2호선,신림,47363,44712,92075,8
2022-08-20,2호선,사당,32522,36783,69305,8
2022-08-20,2호선,강남,57869,58111,115980,8
2022-08-20,2호선,선릉,25252,22277,47529,8
2022-08-20,2호선,잠실(송파구청),66440,63931,130371,8
2022-08-20,1호선,서울역,35245,35625,70870,8
2022-08-21,1호선,서울역,30169,28266,58435,8
2022-08-21,2호선,잠실(송파구청),50567,47420,97987,8
2022-08-21,2호선,선릉,13797,11802,25599,8
2022-08-21,2호선,강남,34497,32812,67309,8
2022-08-21,2호선,사당,22648,25045,47693,8
2022-08-21,2호선,신림,35675,34868,70543,8
2022-08-21,2호선,구로디지털단지,24162,23727,47889,8
2022-08-21,2호선,홍대입구,54305,54083,108388,8
2022-08-21,3호선,고속터미널,41237,39777,81014,8
2022-08-21,4호선,서울역,4618,11784,16402,8
2022-08-21,4호선,사당,16086,14660,30746,8
2022-08-21,7호선,고속터미널,12756,8556,21312,8
2022-08-21,7호선,가산디지털단지,9707,8865,18572,8
2022-08-21,8호선,잠실(송파구청),10700,11888,22588,8
2022-08-21,9호선,고속터미널,10693,14667,25360,8
2022-08-21,경부선,서울역,8762,2118,10880,8
2022-08-21,경부선,가산디지털단지,4525,6217,10742,8
2022-08-21,경의선,서울역,1241,1092,2333,8
2022-08-21,경의선,홍대입구,1719,2289,4008,8
2022-08-21,공항철도 1호선,서울역,9253,8273,17526,8
2022-08-21,공항철도 1호선,홍대입구,11529,10961,22490,8
2022-08-21,분당선,선릉,2956,4378,7334,8
2022-08-21,신림선,신림,1052,1643,2695,8
2022-08-22,1호선,서울역,46390,45083,91473,8
2022-08-22,신림선,신림,1630,2247,3877,8
2022-08-22,분당선,선릉,14148,21044,35192,8
2022-08-22,공항철도 1호선,홍대입구,10453,10545,20998,8
2022-08-22,공항철도 1호선,서울역,9006,8403,17409,8
2022-08-22,경의선,홍대입구,1688,2060,3748,8
2022-08-22,경의선,서울역,4717,6072,10789,8
2022-08-22,경부선,가산디지털단지,18635,21730,40365,8
2022-08-22,경부선,서울역,7638,2359,9997,8
2022-08-22,9호선,고속터미널,12512,15861,28373,8
2022-08-22,8호선,잠실(송파구청),13927,15923,29850,8
2022-08-22,7호선,가산디지털단지,46136,46143,92279,8
2022-08-22,7호선,고속터미널,16330,13351,29681,8
2022-08-22,4호선,사당,24011,19802,43813,8
2022-08-22,4호선,서울역,11560,17280,28840,8
2022-08-22,3호선,고속터미널,40994,38761,79755,8
2022-08-22,2호선,홍대입구,56197,59068,115265,8
2022-08-22,2호선,구로디지털단지,59729,60115,119844,8
2022-08-22,2호선,신림,57190,54514,111704,8
2022-08-22,2호선,사당,36501,39370,75871,8
2022-08-22,2호선,강남,82641,79316,161957,8
2022-08-22,2호선,선릉,59405,53055,112460,8
2022-08-22,2호선,잠실(송파구청),67520,66850,134370,8
2022-08-23,1호선,서울역,46672,44148,90820,8
2022-08-23,2호선,잠실(송파구청),71950,71441,143391,8
2022-08-23,2호선,선릉,61082,54085,115167,8
2022-08-23,2호선,강남,84933,81540,166473,8
2022-08-23,2호선,사당,38550,41398,79948,8
2022-08-23,2호선,신림,58374,56118,114492,8
2022-08-23,2호선,구로디지털단지,61014,61314,122328,8
2022-08-23,2호선,홍대입구,56753,60301,117054,8
2022-08-23,3호선,고속터미널,41306,39153,80459,8
2022-08-23,4호선,서울역,11841,17625,29466,8
2022-08-23,4호선,사당,25246,21030,46276,8
2022-08-23,7호선,고속터미널,15865,13524,29389,8
2022-08-23,7호선,가산디지털단지,46221,46634,92855,8
2022-08-23,8호선,잠실(송파구청),14490,16644,31134,8
2022-08-23,9호선,고속터미널,12705,16099,28804,8
2022-08-23,경부선,서울역,7219,2151,9370,8
2022-08-23,경부선,가산디지털단지,19090,21886,40976,8
2022-08-23,경의선,서울역,4663,5949,10612,8
2022-08-23,경의선,홍대입구,1748,2086,3834,8
2022-08-23,공항철도 1호선,서울역,8723,7923,16646,8
2022-08-23,공항철도 1호선,홍대입구,10740,10985,21725,8
2022-08-23,분당선,선릉,14737,21873,36610,8
2022-08-23,신림선,신림,1559,2159,3718,8
2022-08-24,9호선,고속터미널,13079,16705,29784,8
2022-08-24,8호선,잠실(송파구청),14444,16921,31365,8
2022-08-24,7호선,가산디지털단지,46275,46691,92966,8
2022-08-24,7호선,고속터미널,15610,13422,29032,8
2022-08-24,4호선,사당,25646,21258,46904,8
2022-08-24,4호선,서울역,12244,18448,30692,8
2022-08-24,3호선,고속터미널,41138,39145,80283,8
2022-08-24,2호선,홍대입구,58028,61764,119792,8
2022-08-24,2호선,구로디지털단지,61587,61802,123389,8
2022-08-24,2호선,신림,59189,57017,116206,8
2022-08-24,2호선,사당,39020,42180,81200,8
2022-08-24,2호선,강남,84569,81630,166199,8
2022-08-24,2호선,선릉,60978,54263,115241,8
2022-08-24,2호선,잠실(송파구청),71310,70824,142134,8
2022-08-24,1호선,서울역,48101,45766,93867,8
2022-08-24,신림선,신림,1580,2107,3687,8
2022-08-24,분당선,선릉,14574,21526,36100,8
2022-08-24,공항철도 1호선,홍대입구,11271,11451,22722,8
2022-08-24,공항철도 1호선,서울역,9161,8210,17371,8
2022-08-24,경의선,홍대입구,1880,2284,4164,8
2022-08-24,경의선,서울역,4879,6075,10954,8
2022-08-24,경부선,가산디지털단지,19034,22019,41053,8
2022-08-24,경부선,서울역,7285,2325,9610,8
2022-08-25,경의선,서울역,4773,6039,10812,8
2022-08-25,경의선,홍대입구,1861,2248,4109,8
2022-08-25,공항철도 1호선,서울역,9468,8597,18065,8
2022-08-25,공항철도 1호선,홍대입구,11411,11749,23160,8
2022-08-25,분당선,선릉,14608,21632,36240,8
2022-08-25,신림선,신림,1596,2108,3704,8
2022-08-25,경부선,가산디지털단지,18803,21914,40717,8
2022-08-25,경부선,서울역,7844,2453,10297,8
2022-08-25,9호선,고속터미널,13256,17252,30508,8
2022-08-25,8호선,잠실(송파구청),14332,16838,31170,8
2022-08-25,7호선,가산디지털단지,46335,46541,92876,8
2022-08-25,7호선,고속터미널,15986,13569,29555,8
2022-08-25,4호선,사당,26110,21905,48015,8
2022-08-25,4호선,서울역,12313,19001,31314,8
2022-08-25,3호선,고속터미널,42391,40860,83251,8
2022-08-25,2호선,홍대입구,58512,63736,122248,8
2022-08-25,2호선,구로디지털단지,61256,61542,122798,8
2022-08-25,2호선,신림,58907,56224,115131,8
2022-08-25,2호선,사당,39319,43095,82414,8
2022-08-25,2호선,강남,85823,83087,168910,8
2022-08-25,2호선,선릉,61205,54507,115712,8
2022-08-25,2호선,잠실(송파구청),72055,71696,143751,8
2022-08-25,1호선,서울역,48513,46600,95113,8
2022-08-26,신림선,신림,1655,2249,3904,8
2022-08-26,1호선,서울역,54837,53283,108120,8
2022-08-26,2호선,잠실(송파구청),75903,75617,151520,8
2022-08-26,2호선,선릉,60712,54091,114803,8
2022-08-26,2호선,강남,89847,88744,178591,8
2022-08-26,2호선,사당,42148,46251,88399,8
2022-08-26,2호선,신림,62159,59762,121921,8
2022-08-26,2호선,구로디지털단지,62738,62417,125155,8
2022-08-26,2호선,홍대입구,64227,73313,137540,8
2022-08-26,3호선,고속터미널,60016,56709,116725,8
2022-08-26,4호선,서울역,12535,21396,33931,8
2022-08-26,4호선,사당,28168,23721,51889,8
2022-08-26,7호선,고속터미널,19240,15963,35203,8
2022-08-26,7호선,가산디지털단지,46787,46122,92909,8
2022-08-26,8호선,잠실(송파구청),15147,18059,33206,8
2022-08-26,9호선,고속터미널,20821,27642,48463,8
2022-08-26,경부선,서울역,10170,3117,13287,8
2022-08-26,경부선,가산디지털단지,18883,22005,40888,8
2022-08-26,경의선,서울역,4846,6477,11323,8
2022-08-26,경의선,홍대입구,2119,2556,4675,8
2022-08-26,공항철도 1호선,서울역,11250,10815,22065,8
2022-08-26,공항철도 1호선,홍대입구,12557,13283,25840,8
2022-08-26,분당선,선릉,14397,21375,35772,8
2022-08-27,신림선,신림,1415,1903,3318,8
2022-08-27,분당선,선릉,5825,9007,14832,8
2022-08-27,공항철도 1호선,홍대입구,14782,15346,30128,8
2022-08-27,공항철도 1호선,서울역,10533,10011,20544,8
2022-08-27,경의선,홍대입구,2349,3141,5490,8
2022-08-27,경의선,서울역,1504,1785,3289,8
2022-08-27,경부선,가산디지털단지,6583,8611,15194,8
2022-08-27,경부선,서울역,10255,2579,12834,8
2022-08-27,9호선,고속터미널,24784,32235,57019,8
2022-08-27,8호선,잠실(송파구청),14176,16577,30753,8
2022-08-27,7호선,가산디지털단지,14613,13100,27713,8
2022-08-27,7호선,고속터미널,17596,13565,31161,8
2022-08-27,4호선,사당,23489,20887,44376,8
2022-08-27,4호선,서울역,6670,16355,23025,8
2022-08-27,3호선,고속터미널,70736,61116,131852,8
2022-08-27,2호선,홍대입구,72314,82372,154686,8
2022-08-27,2호선,구로디지털단지,36166,35326,71492,8
2022-08-27,2호선,신림,49447,46546,95993,8
2022-08-27,2호선,사당,33964,37920,71884,8
2022-08-27,2호선,강남,60106,60754,120860,8
2022-08-27,2호선,선릉,26842,23248,50090,8
2022-08-27,2호선,잠실(송파구청),72115,69331,141446,8
2022-08-27,1호선,서울역,39242,38664,77906,8
2022-08-28,1호선,서울역,32602,30503,63105,8
2022-08-28,2호선,잠실(송파구청),52049,48982,101031,8
2022-08-28,2호선,선릉,14323,12228,26551,8
2022-08-28,2호선,강남,35379,34118,69497,8
2022-08-28,2호선,사당,23306,25951,49257,8
2022-08-28,2호선,신림,36999,36144,73143,8
2022-08-28,2호선,구로디지털단지,25325,24905,50230,8
2022-08-28,2호선,홍대입구,57285,57799,115084,8
2022-08-28,3호선,고속터미널,49017,44899,93916,8
2022-08-28,4호선,서울역,5077,13353,18430,8
2022-08-28,4호선,사당,16750,15615,32365,8
2022-08-28,7호선,고속터미널,14650,9497,24147,8
2022-08-28,7호선,가산디지털단지,10425,9611,20036,8
2022-08-28,8호선,잠실(송파구청),10746,12152,22898,8
2022-08-28,9호선,고속터미널,14107,18825,32932,8
2022-08-28,경부선,서울역,9930,2376,12306,8
2022-08-28,경부선,가산디지털단지,5107,6864,11971,8
2022-08-28,경의선,서울역,1302,1219,2521,8
2022-08-28,경의선,홍대입구,1945,2420,4365,8
2022-08-28,공항철도 1호선,서울역,9921,9341,19262,8
2022-08-28,공항철도 1호선,홍대입구,12763,11875,24638,8
2022-08-28,분당선,선릉,3043,4550,7593,8
2022-08-28,신림선,신림,1154,1639,2793,8
2022-08-29,1호선,서울역,48834,46678,95512,8
2022-08-29,신림선,신림,1514,2030,3544,8
2022-08-29,분당선,선릉,14136,21476,35612,8
2022-08-29,공항철도 1호선,홍대입구,10205,10726,20931,8
2022-08-29,공항철도 1호선,서울역,9525,8565,18090,8
2022-08-29,경의선,홍대입구,1815,2070,3885,8
2022-08-29,경의선,서울역,4804,6149,10953,8
2022-08-29,경부선,가산디지털단지,19138,22158,41296,8
2022-08-29,경부선,서울역,8282,2387,10669,8
2022-08-29,9호선,고속터미널,13004,16366,29370,8
2022-08-29,8호선,잠실(송파구청),13837,16330,30167,8
2022-08-29,7호선,가산디지털단지,46548,47232,93780,8
2022-08-29,7호선,고속터미널,16715,13670,30385,8
2022-08-29,4호선,사당,25165,20778,45943,8
2022-08-29,4호선,서울역,12168,18238,30406,8
2022-08-29,3호선,고속터미널,42461,40305,82766,8
2022-08-29,2호선,홍대입구,55134,58648,113782,8
2022-08-29,2호선,구로디지털단지,60856,61175,122031,8
2022-08-29,2호선,신림,57682,55159,112841,8
2022-08-29,2호선,사당,36631,40191,76822,8
2022-08-29,2호선,강남,79280,77037,156317,8
2022-08-29,2호선,선릉,59409,52751,112160,8
2022-08-29,2호선,잠실(송파구청),68068,68594,136662,8
2022-08-30,1호선,서울역,47548,45011,92559,8
2022-08-30,2호선,잠실(송파구청),67528,67726,135254,8
2022-08-30,2호선,선릉,60780,54083,114863,8
2022-08-30,2호선,강남,81046,78028,159074,8
2022-08-30,2호선,사당,37764,40904,78668,8
2022-08-30,2호선,신림,56893,54776,111669,8
2022-08-30,2호선,구로디지털단지,59919,60155,120074,8
2022-08-30,2호선,홍대입구,52474,56434,108908,8
2022-08-30,3호선,고속터미널,41600,38750,80350,8
2022-08-30,4호선,서울역,12178,17952,30130,8
2022-08-30,4호선,사당,25650,21164,46814,8
2022-08-30,7호선,고속터미널,15859,13507,29366,8
2022-08-30,7호선,가산디지털단지,46923,47285,94208,8
2022-08-30,8호선,잠실(송파구청),14359,16838,31197,8
2022-08-30,9호선,고속터미널,11821,15459,27280,8
2022-08-30,경부선,서울역,7435,2175,9610,8
2022-08-30,경부선,가산디지털단지,18752,21836,40588,8
2022-08-30,경의선,서울역,4747,5994,10741,8
2022-08-30,경의선,홍대입구,1639,1876,3515,8
2022-08-30,공항철도 1호선,서울역,8659,8024,16683,8
2022-08-30,공항철도 1호선,홍대입구,9659,10300,19959,8
2022-08-30,분당선,선릉,14898,22068,36966,8
2022-08-30,신림선,신림,1573,2173,3746,8
2022-08-31,1호선,서울역,49311,46839,96150,8
2022-08-31,2호선,잠실(송파구청),74229,74035,148264,8
2022-08-31,2호선,선릉,61786,54849,116635,8
2022-08-31,2호선,강남,83516,79939,163455,8
2022-08-31,2호선,사당,39732,43136,82868,8
2022-08-31,2호선,신림,60363,57693,118056,8
2022-08-31,2호선,구로디지털단지,62384,62407,124791,8
2022-08-31,2호선,홍대입구,58812,62877,121689,8
2022-08-31,3호선,고속터미널,42623,40162,82785,8
2022-08-31,4호선,서울역,12608,18423,31031,8
2022-08-31,4호선,사당,26395,22060,48455,8
2022-08-31,7호선,고속터미널,15807,13828,29635,8
2022-08-31,7호선,가산디지털단지,46988,47661,94649,8
2022-08-31,8호선,잠실(송파구청),14963,18302,33265,8
2022-08-31,9호선,고속터미널,13310,16779,30089,8
2022-08-31,경부선,서울역,7441,2210,9651,8
2022-08-31,경부선,가산디지털단지,19472,22678,42150,8
2022-08-31,경의선,서울역,5033,6443,11476,8
2022-08-31,경의선,홍대입구,1894,2325,4219,8
2022-08-31,공항철도 1호선,서울역,9501,8471,17972,8
2022-08-31,공항철도 1호선,홍대입구,11087,11545,22632,8
2022-08-31,분당선,선릉,14565,21822,36387,8
2022-08-31,신림선,신림,1607,2204,3811,8
2022-09-01,2호선,신림,61313,58762,120075,9
2022-09-01,2호선,사당,41219,44430,85649,9
2022-09-01,2호선,강남,84920,82240,167160,9
2022-09-01,2호선,선릉,62394,56014,118408,9
2022-09-01,2호선,잠실(송파구청),74247,74217,148464,9
2022-09-01,1호선,서울역,49081,47845,96926,9
2022-09-01,신림선,신림,1689,2148,3837,9
2022-09-01,분당선,선릉,14953,22413,37366,9
2022-09-01,공항철도 1호선,홍대입구,11277,11836,23113,9
2022-09-01,공항철도 1호선,서울역,9552,8544,18096,9
2022-09-01,경의선,홍대입구,2003,2439,4442,9
2022-09-01,경의선,서울역,5107,6527,11634,9
2022-09-01,경부선,가산디지털단지,19871,22694,42565,9
2022-09-01,경부선,서울역,7116,2224,9340,9
2022-09-01,9호선,고속터미널,13990,17082,31072,9
2022-09-01,8호선,잠실(송파구청),14638,17387,32025,9
2022-09-01,7호선,가산디지털단지,47125,47772,94897,9
2022-09-01,7호선,고속터미널,16357,14258,30615,9
2022-09-01,4호선,사당,27289,23293,50582,9
2022-09-01,4호선,서울역,12502,18209,30711,9
2022-09-01,3호선,고속터미널,44468,42039,86507,9
2022-09-01,2호선,홍대입구,62238,66709,128947,9
2022-09-01,2호선,구로디지털단지,62567,62906,125473,9
2022-09-02,신림선,신림,1750,2477,4227,9
2022-09-02,분당선,선릉,14676,22124,36800,9
2022-09-02,공항철도 1호선,홍대입구,12665,13350,26015,9
2022-09-02,공항철도 1호선,서울역,11332,9950,21282,9
2022-09-02,경의선,홍대입구,2069,2770,4839,9
2022-09-02,경의선,서울역,5286,6939,12225,9
2022-09-02,경부선,가산디지털단지,19564,22635,42199,9
2022-09-02,경부선,서울역,9781,2802,12583,9
2022-09-02,9호선,고속터미널,16943,21734,38677,9
2022-09-02,8호선,잠실(송파구청),15277,18454,33731,9
2022-09-02,7호선,가산디지털단지,47574,47473,95047,9
2022-09-02,7호선,고속터미널,18856,15377,34233,9
2022-09-02,4호선,사당,29887,25280,55167,9
2022-09-02,4호선,서울역,12903,20611,33514,9
2022-09-02,3호선,고속터미널,53627,51924,105551,9
2022-09-02,2호선,홍대입구,66531,76604,143135,9
2022-09-02,2호선,구로디지털단지,64135,64397,128532,9
2022-09-02,2호선,신림,62928,60771,123699,9
2022-09-02,2호선,사당,43655,47914,91569,9
2022-09-02,2호선,강남,90177,89226,179403,9
2022-09-02,2호선,선릉,61750,55048,116798,9
2022-09-02,2호선,잠실(송파구청),80217,80244,160461,9
2022-09-02,1호선,서울역,54463,52615,107078,9
2022-09-03,1호선,서울역,38756,37447,76203,9
2022-09-03,2호선,잠실(송파구청),70705,68432,139137,9
2022-09-03,2호선,선릉,26806,23892,50698,9
2022-09-03,2호선,강남,62285,62371,124656,9
2022-09-03,2호선,사당,34190,38719,72909,9
2022-09-03,2호선,신림,49432,47319,96751,9
2022-09-03,2호선,구로디지털단지,37191,36204,73395,9
2022-09-03,2호선,홍대입구,74926,86153,161079,9
2022-09-03,3호선,고속터미널,58051,55470,113521,9
2022-09-03,4호선,서울역,6979,16004,22983,9
2022-09-03,4호선,사당,23997,21054,45051,9
2022-09-03,7호선,고속터미널,16706,12275,28981,9
2022-09-03,7호선,가산디지털단지,15253,13410,28663,9
2022-09-03,8호선,잠실(송파구청),13566,16458,30024,9
2022-09-03,9호선,고속터미널,17300,23431,40731,9
2022-09-03,경부선,서울역,9898,2383,12281,9
2022-09-03,경부선,가산디지털단지,6663,8928,15591,9
2022-09-03,경의선,서울역,1596,1741,3337,9
2022-09-03,경의선,홍대입구,2456,3155,5611,9
2022-09-03,공항철도 1호선,서울역,9702,9451,19153,9
2022-09-03,공항철도 1호선,홍대입구,15158,15818,30976,9
2022-09-03,분당선,선릉,5916,8321,14237,9
2022-09-03,신림선,신림,1390,1916,3306,9
2022-09-04,1호선,서울역,29262,28987,58249,9
2022-09-04,2호선,잠실(송파구청),45704,42955,88659,9
2022-09-04,2호선,선릉,13357,11500,24857,9
2022-09-04,2호선,강남,32874,30737,63611,9
2022-09-04,2호선,사당,21413,23732,45145,9
2022-09-04,2호선,신림,33973,32574,66547,9
2022-09-04,2호선,구로디지털단지,23893,23205,47098,9
2022-09-04,2호선,홍대입구,48792,47264,96056,9
2022-09-04,3호선,고속터미널,41627,41510,83137,9
2022-09-04,4호선,서울역,4612,12051,16663,9
2022-09-04,4호선,사당,15268,14335,29603,9
2022-09-04,7호선,고속터미널,12043,8169,20212,9
2022-09-04,7호선,가산디지털단지,9453,8435,17888,9
2022-09-04,8호선,잠실(송파구청),10119,10983,21102,9
2022-09-04,9호선,고속터미널,10122,16031,26153,9
2022-09-04,경부선,서울역,8531,2062,10593,9
2022-09-04,경부선,가산디지털단지,4436,6014,10450,9
2022-09-04,경의선,서울역,1036,1002,2038,9
2022-09-04,경의선,홍대입구,1532,1947,3479,9
2022-09-04,공항철도 1호선,서울역,8720,8532,17252,9
2022-09-04,공항철도 1호선,홍대입구,10196,9086,19282,9
2022-09-04,분당선,선릉,2913,4415,7328,9
2022-09-04,신림선,신림,1033,1240,2273,9
2022-09-05,공항철도 1호선,홍대입구,8308,8740,17048,9
2022-09-05,공항철도 1호선,서울역,8572,7906,16478,9
2022-09-05,경의선,홍대입구,1406,1718,3124,9
2022-09-05,경의선,서울역,4556,5787,10343,9
2022-09-05,경부선,가산디지털단지,18072,21379,39451,9
2022-09-05,경부선,서울역,6816,2246,9062,9
2022-09-05,9호선,고속터미널,10549,14439,24988,9
2022-09-05,8호선,잠실(송파구청),14278,15974,30252,9
2022-09-05,7호선,가산디지털단지,48087,46717,94804,9
2022-09-05,7호선,고속터미널,14786,12530,27316,9
2022-09-05,4호선,사당,23210,19395,42605,9
2022-09-05,4호선,서울역,11451,16325,27776,9
2022-09-05,3호선,고속터미널,38053,36334,74387,9
2022-09-05,2호선,홍대입구,47467,48554,96021,9
2022-09-05,2호선,구로디지털단지,58022,57621,115643,9
2022-09-05,2호선,신림,53962,51422,105384,9
2022-09-05,2호선,사당,33559,35666,69225,9
2022-09-05,2호선,강남,74563,71232,145795,9
2022-09-05,2호선,선릉,57363,50726,108089,9
2022-09-05,2호선,잠실(송파구청),61528,62832,124360,9
2022-09-05,1호선,서울역,44945,43305,88250,9
2022-09-05,신림선,신림,1551,2084,3635,9
2022-09-05,분당선,선릉,14699,21135,35834,9
2022-09-06,분당선,선릉,13429,20096,33525,9
2022-09-06,공항철도 1호선,홍대입구,9756,9731,19487,9
2022-09-06,공항철도 1호선,서울역,6287,6136,12423,9
2022-09-06,경의선,홍대입구,1838,2172,4010,9
2022-09-06,경의선,서울역,4289,5459,9748,9
2022-09-06,경부선,가산디지털단지,18326,20937,39263,9
2022-09-06,경부선,서울역,3320,1434,4754,9
2022-09-06,9호선,고속터미널,12476,15098,27574,9
2022-09-06,8호선,잠실(송파구청),12830,15080,27910,9
2022-09-06,7호선,가산디지털단지,44888,45361,90249,9
2022-09-06,7호선,고속터미널,14741,13190,27931,9
2022-09-06,4호선,사당,23186,19793,42979,9
2022-09-06,4호선,서울역,10530,14192,24722,9
2022-09-06,3호선,고속터미널,37688,36667,74355,9
2022-09-06,신림선,신림,1623,2105,3728,9
2022-09-06,2호선,홍대입구,53791,57101,110892,9
2022-09-06,2호선,구로디지털단지,57508,57511,115019,9
2022-09-06,2호선,신림,56529,53537,110066,9
2022-09-06,2호선,사당,35679,38199,73878,9
2022-09-06,2호선,강남,73139,71208,144347,9
2022-09-06,2호선,선릉,55427,49797,105224,9
2022-09-06,2호선,잠실(송파구청),60953,61273,122226,9
2022-09-06,1호선,서울역,37357,38248,75605,9
2022-09-07,분당선,선릉,15160,22614,37774,9
2022-09-07,신림선,신림,1738,2301,4039,9
2022-09-07,4호선,사당,28657,23471,52128,9
2022-09-07,4호선,서울역,13120,21266,34386,9
2022-09-07,1호선,서울역,48689,54143,102832,9
2022-09-07,2호선,잠실(송파구청),77638,77682,155320,9
2022-09-07,2호선,선릉,63589,56696,120285,9
2022-09-07,2호선,강남,89322,86727,176049,9
2022-09-07,7호선,고속터미널,15952,15258,31210,9
2022-09-07,7호선,가산디지털단지,48414,48525,96939,9
2022-09-07,8호선,잠실(송파구청),15341,18453,33794,9
2022-09-07,9호선,고속터미널,13945,19514,33459,9
2022-09-07,경부선,서울역,6149,2896,9045,9
2022-09-07,경부선,가산디지털단지,20301,23229,43530,9
2022-09-07,2호선,사당,42197,45699,87896,9
2022-09-07,2호선,신림,63124,59157,122281,9
2022-09-07,2호선,구로디지털단지,65128,65081,130209,9
2022-09-07,2호선,홍대입구,62037,65601,127638,9
2022-09-07,3호선,고속터미널,44877,50579,95456,9
2022-09-07,경의선,서울역,5245,7142,12387,9
2022-09-07,경의선,홍대입구,2037,2461,4498,9
2022-09-07,공항철도 1호선,서울역,9095,9895,18990,9
2022-09-07,공항철도 1호선,홍대입구,11660,11530,23190,9
2022-09-08,신림선,신림,1671,2135,3806,9
2022-09-08,분당선,선릉,13302,19931,33233,9
2022-09-08,공항철도 1호선,홍대입구,12473,12441,24914,9
2022-09-08,공항철도 1호선,서울역,11104,11531,22635,9
2022-09-08,경의선,홍대입구,2215,2627,4842,9
2022-09-08,1호선,서울역,49174,58571,107745,9
2022-09-08,2호선,잠실(송파구청),76382,78773,155155,9
2022-09-08,2호선,선릉,56048,49332,105380,9
2022-09-08,2호선,강남,83374,82412,165786,9
2022-09-08,2호선,사당,39695,43360,83055,9
2022-09-08,2호선,신림,62779,56237,119016,9
2022-09-08,2호선,구로디지털단지,61787,60261,122048,9
2022-09-08,2호선,홍대입구,65035,71959,136994,9
2022-09-08,3호선,고속터미널,53589,79958,133547,9
2022-09-08,4호선,서울역,12037,22181,34218,9
2022-09-08,4호선,사당,28285,23292,51577,9
2022-09-08,7호선,고속터미널,17924,18722,36646,9
2022-09-08,7호선,가산디지털단지,44879,43581,88460,9
2022-09-08,8호선,잠실(송파구청),15167,18464,33631,9
2022-09-08,9호선,고속터미널,16056,29543,45599,9
2022-09-08,경부선,서울역,8038,3770,11808,9
2022-09-08,경부선,가산디지털단지,18362,20829,39191,9
2022-09-08,경의선,서울역,5117,6914,12031,9
2022-09-09,7호선,가산디지털단지,10433,8138,18571,9
2022-09-09,8호선,잠실(송파구청),9243,11234,20477,9
2022-09-09,9호선,고속터미널,8938,22901,31839,9
2022-09-09,경부선,서울역,5637,2773,8410,9
2022-09-09,4호선,사당,13289,10820,24109,9
2022-09-09,4호선,서울역,4245,13522,17767,9
2022-09-09,3호선,고속터미널,29492,57737,87229,9
2022-09-09,경부선,가산디지털단지,5185,6005,11190,9
2022-09-09,7호선,고속터미널,8938,11060,19998,9
2022-09-09,신림선,신림,924,1014,1938,9
2022-09-09,분당선,선릉,2327,3017,5344,9
2022-09-09,경의선,홍대입구,1482,1693,3175,9
2022-09-09,경의선,서울역,1204,1351,2555,9
2022-09-09,1호선,서울역,26967,38417,65384,9
2022-09-09,2호선,잠실(송파구청),45011,45377,90388,9
2022-09-09,2호선,선릉,10630,8567,19197,9
2022-09-09,2호선,강남,28144,28180,56324,9
2022-09-09,2호선,사당,16473,18130,34603,9
2022-09-09,2호선,신림,32921,25093,58014,9
2022-09-09,2호선,구로디지털단지,21671,18613,40284,9
2022-09-09,2호선,홍대입구,45702,48634,94336,9
2022-09-09,공항철도 1호선,서울역,7223,9942,17165,9
2022-09-09,공항철도 1호선,홍대입구,9815,9028,18843,9
2022-09-10,공항철도 1호선,서울역,8786,7469,16255,9
2022-09-10,공항철도 1호선,홍대입구,6807,6892,13699,9
2022-09-10,9호선,고속터미널,7526,10271,17797,9
2022-09-10,경부선,서울역,6724,1806,8530,9
2022-09-10,경부선,가산디지털단지,4163,5786,9949,9
2022-09-10,1호선,서울역,28492,28558,57050,9
2022-09-10,경의선,서울역,1055,1042,2097,9
2022-09-10,경의선,홍대입구,914,1579,2493,9
2022-09-10,8호선,잠실(송파구청),7175,8303,15478,9
2022-09-10,7호선,가산디지털단지,7509,6596,14105,9
2022-09-10,7호선,고속터미널,10534,6070,16604,9
2022-09-10,4호선,사당,9534,8081,17615,9
2022-09-10,4호선,서울역,4017,10269,14286,9
2022-09-10,3호선,고속터미널,24912,25395,50307,9
2022-09-10,분당선,선릉,1344,1920,3264,9
2022-09-10,2호선,홍대입구,33802,38343,72145,9
2022-09-10,신림선,신림,646,874,1520,9
2022-09-10,2호선,구로디지털단지,15639,15701,31340,9
2022-09-10,2호선,신림,23141,23057,46198,9
2022-09-10,2호선,사당,11512,13175,24687,9
2022-09-10,2호선,강남,15881,16461,32342,9
2022-09-10,2호선,선릉,6268,5226,11494,9
2022-09-10,2호선,잠실(송파구청),37062,35088,72150,9
2022-09-11,7호선,고속터미널,18678,6183,24861,9
2022-09-11,3호선,고속터미널,51587,32144,83731,9
2022-09-11,2호선,홍대입구,46912,53957,100869,9
2022-09-11,2호선,구로디지털단지,20160,21350,41510,9
2022-09-11,2호선,신림,27675,31300,58975,9
2022-09-11,2호선,사당,17435,20000,37435,9
2022-09-11,2호선,강남,23840,24952,48792,9
2022-09-11,2호선,선릉,8263,7551,15814,9
2022-09-11,2호선,잠실(송파구청),48110,44995,93105,9
2022-09-11,1호선,서울역,34150,24371,58521,9
2022-09-11,4호선,사당,13151,11998,25149,9
2022-09-11,4호선,서울역,4478,9170,13648,9
2022-09-11,신림선,신림,872,1438,2310,9
2022-09-11,분당선,선릉,1730,2742,4472,9
2022-09-11,공항철도 1호선,홍대입구,9571,10850,20421,9
2022-09-11,공항철도 1호선,서울역,10783,6437,17220,9
2022-09-11,경의선,홍대입구,1628,2269,3897,9
2022-09-11,경의선,서울역,1240,993,2233,9
2022-09-11,경부선,가산디지털단지,4539,7056,11595,9
2022-09-11,경부선,서울역,9566,1423,10989,9
2022-09-11,9호선,고속터미널,13096,12570,25666,9
2022-09-11,8호선,잠실(송파구청),10366,11694,22060,9
2022-09-11,7호선,가산디지털단지,10259,9687,19946,9
2022-09-12,7호선,고속터미널,23778,8074,31852,9
2022-09-12,4호선,서울역,4271,9829,14100,9
2022-09-12,3호선,고속터미널,62115,40272,102387,9
2022-09-12,2호선,홍대입구,52548,54274,106822,9
2022-09-12,4호선,사당,14168,13551,27719,9
2022-09-12,2호선,구로디지털단지,22128,23391,45519,9
2022-09-12,2호선,신림,31711,34257,65968,9
2022-09-12,2호선,사당,20009,23073,43082,9
2022-09-12,1호선,서울역,36137,27420,63557,9
2022-09-12,2호선,강남,30515,29741,60256,9
2022-09-12,2호선,선릉,12363,11213,23576,9
2022-09-12,2호선,잠실(송파구청),49787,46784,96571,9
2022-09-12,9호선,고속터미널,15656,15989,31645,9
2022-09-12,경부선,서울역,12464,1843,14307,9
2022-09-12,경부선,가산디지털단지,4750,7041,11791,9
2022-09-12,경의선,서울역,1465,1226,2691,9
2022-09-12,경의선,홍대입구,1886,2491,4377,9
2022-09-12,공항철도 1호선,서울역,10797,8722,19519,9
2022-09-12,공항철도 1호선,홍대입구,11234,11677,22911,9
2022-09-12,분당선,선릉,2612,4203,6815,9
2022-09-12,신림선,신림,995,1622,2617,9
2022-09-12,8호선,잠실(송파구청),10951,12166,23117,9
2022-09-12,7호선,가산디지털단지,10490,10360,20850,9
2022-09-13,3호선,고속터미널,45255,37978,83233,9
2022-09-13,2호선,홍대입구,57306,59255,116561,9
2022-09-13,2호선,구로디지털단지,59304,59587,118891,9
2022-09-13,2호선,신림,56779,56077,112856,9
2022-09-13,2호선,사당,37911,41523,79434,9
2022-09-13,2호선,강남,78992,74391,153383,9
2022-09-13,2호선,선릉,58023,51959,109982,9
2022-09-13,2호선,잠실(송파구청),67674,67733,135407,9
2022-09-13,1호선,서울역,50597,43054,93651,9
2022-09-13,9호선,고속터미널,13804,15965,29769,9
2022-09-13,경부선,서울역,10560,2168,12728,9
2022-09-13,경부선,가산디지털단지,18075,21518,39593,9
2022-09-13,경의선,서울역,5238,6464,11702,9
2022-09-13,경의선,홍대입구,2024,2444,4468,9
2022-09-13,공항철도 1호선,서울역,10409,7741,18150,9
2022-09-13,공항철도 1호선,홍대입구,10383,11101,21484,9
2022-09-13,분당선,선릉,13855,21256,35111,9
2022-09-13,신림선,신림,1698,2310,4008,9
2022-09-13,4호선,서울역,11319,15326,26645,9
2022-09-13,4호선,사당,26149,21846,47995,9
2022-09-13,8호선,잠실(송파구청),13541,15678,29219,9
2022-09-13,7호선,가산디지털단지,45212,45097,90309,9
2022-09-13,7호선,고속터미널,19084,13413,32497,9
2022-09-14,3호선,고속터미널,41922,38717,80639,9
2022-09-14,신림선,신림,1678,2233,3911,9
2022-09-14,2호선,구로디지털단지,63397,63444,126841,9
2022-09-14,2호선,신림,60563,58467,119030,9
2022-09-14,2호선,사당,40807,43751,84558,9
2022-09-14,2호선,강남,84724,81908,166632,9
2022-09-14,2호선,선릉,63493,56507,120000,9
2022-09-14,2호선,잠실(송파구청),71506,71859,143365,9
2022-09-14,1호선,서울역,49381,46245,95626,9
2022-09-14,2호선,홍대입구,58206,61470,119676,9
2022-09-14,4호선,서울역,12560,17882,30442,9
2022-09-14,4호선,사당,26887,22880,49767,9
2022-09-14,분당선,선릉,15213,22953,38166,9
2022-09-14,공항철도 1호선,홍대입구,10660,11028,21688,9
2022-09-14,공항철도 1호선,서울역,9251,7587,16838,9
2022-09-14,경의선,서울역,5240,6744,11984,9
2022-09-14,경부선,가산디지털단지,19626,22803,42429,9
2022-09-14,경부선,서울역,7369,2134,9503,9
2022-09-14,9호선,고속터미널,13276,16416,29692,9
2022-09-14,8호선,잠실(송파구청),14275,17081,31356,9
2022-09-14,7호선,가산디지털단지,48156,48554,96710,9
2022-09-14,7호선,고속터미널,16139,13811,29950,9
2022-09-14,경의선,홍대입구,1963,2312,4275,9
2022-09-15,1호선,서울역,50504,48531,99035,9
2022-09-15,2호선,잠실(송파구청),73535,73506,147041,9
2022-09-15,2호선,선릉,63876,56885,120761,9
2022-09-15,2호선,강남,87246,84314,171560,9
2022-09-15,2호선,사당,41835,45254,87089,9
2022-09-15,2호선,신림,61255,58815,120070,9
2022-09-15,2호선,구로디지털단지,64387,64446,128833,9
2022-09-15,2호선,홍대입구,60249,65397,125646,9
2022-09-15,3호선,고속터미널,43348,40626,83974,9
2022-09-15,4호선,서울역,13104,19021,32125,9
2022-09-15,4호선,사당,28025,23818,51843,9
2022-09-15,7호선,고속터미널,16686,14129,30815,9
2022-09-15,7호선,가산디지털단지,48528,49256,97784,9
2022-09-15,8호선,잠실(송파구청),14326,17251,31577,9
2022-09-15,9호선,고속터미널,13905,16613,30518,9
2022-09-15,경부선,서울역,7872,2337,10209,9
2022-09-15,경부선,가산디지털단지,19983,23237,43220,9
2022-09-15,경의선,서울역,5295,6714,12009,9
2022-09-15,경의선,홍대입구,1983,2387,4370,9
2022-09-15,공항철도 1호선,서울역,10143,8630,18773,9
2022-09-15,공항철도 1호선,홍대입구,11061,11553,22614,9
2022-09-15,분당선,선릉,15184,23166,38350,9
2022-09-15,신림선,신림,1639,2245,3884,9
2022-09-16,신림선,신림,1777,2434,4211,9
2022-09-16,분당선,선릉,15205,22910,38115,9
2022-09-16,공항철도 1호선,홍대입구,12716,13895,26611,9
2022-09-16,공항철도 1호선,서울역,12358,10320,22678,9
2022-09-16,경의선,홍대입구,2120,2780,4900,9
2022-09-16,경의선,서울역,5386,6942,12328,9
2022-09-16,경부선,가산디지털단지,19708,22947,42655,9
2022-09-16,경부선,서울역,10764,3246,14010,9
2022-09-16,9호선,고속터미널,15573,20724,36297,9
2022-09-16,8호선,잠실(송파구청),16417,18713,35130,9
2022-09-16,7호선,가산디지털단지,48759,48370,97129,9
2022-09-16,7호선,고속터미널,19721,15591,35312,9
2022-09-16,4호선,사당,30097,25947,56044,9
2022-09-16,4호선,서울역,14642,21892,36534,9
2022-09-16,3호선,고속터미널,52713,51638,104351,9
2022-09-16,2호선,홍대입구,68028,77025,145053,9
2022-09-16,2호선,구로디지털단지,65328,65512,130840,9
2022-09-16,2호선,신림,63399,61346,124745,9
2022-09-16,2호선,사당,44713,48973,93686,9
2022-09-16,2호선,강남,92721,91283,184004,9
2022-09-16,2호선,선릉,63245,55875,119120,9
2022-09-16,2호선,잠실(송파구청),81268,80994,162262,9
2022-09-16,1호선,서울역,59887,55390,115277,9
2022-09-17,7호선,가산디지털단지,15271,13795,29066,9
2022-09-17,7호선,고속터미널,17742,13073,30815,9
2022-09-17,1호선,서울역,41348,39328,80676,9
2022-09-17,2호선,잠실(송파구청),76882,72301,149183,9
2022-09-17,2호선,선릉,28498,25182,53680,9
2022-09-17,2호선,강남,64806,65179,129985,9
2022-09-17,2호선,사당,37720,42232,79952,9
2022-09-17,2호선,신림,50638,48069,98707,9
2022-09-17,2호선,구로디지털단지,39034,37719,76753,9
2022-09-17,2호선,홍대입구,74933,86615,161548,9
2022-09-17,3호선,고속터미널,63239,57227,120466,9
2022-09-17,4호선,서울역,7130,16867,23997,9
2022-09-17,4호선,사당,25261,22234,47495,9
2022-09-17,신림선,신림,1231,1853,3084,9
2022-09-17,분당선,선릉,6045,9265,15310,9
2022-09-17,공항철도 1호선,홍대입구,15568,16244,31812,9
2022-09-17,공항철도 1호선,서울역,10784,10078,20862,9
2022-09-17,경의선,홍대입구,2310,3112,5422,9
2022-09-17,경의선,서울역,1658,1741,3399,9
2022-09-17,경부선,가산디지털단지,6986,9224,16210,9
2022-09-17,경부선,서울역,10978,2701,13679,9
2022-09-17,9호선,고속터미널,20034,27333,47367,9
2022-09-17,8호선,잠실(송파구청),13738,16932,30670,9
2022-09-18,2호선,잠실(송파구청),57763,53741,111504,9
2022-09-18,2호선,선릉,16016,13610,29626,9
2022-09-18,2호선,강남,38606,37001,75607,9
2022-09-18,2호선,사당,26610,29213,55823,9
2022-09-18,2호선,신림,38287,36525,74812,9
2022-09-18,2호선,구로디지털단지,27366,26659,54025,9
2022-09-18,2호선,홍대입구,59206,57950,117156,9
2022-09-18,3호선,고속터미널,48699,46043,94742,9
2022-09-18,4호선,서울역,5311,13794,19105,9
2022-09-18,4호선,사당,18220,16618,34838,9
2022-09-18,7호선,고속터미널,13303,9405,22708,9
2022-09-18,7호선,가산디지털단지,10943,9831,20774,9
2022-09-18,8호선,잠실(송파구청),10876,12347,23223,9
2022-09-18,9호선,고속터미널,14640,22042,36682,9
2022-09-18,경부선,서울역,9552,2398,11950,9
2022-09-18,경부선,가산디지털단지,5076,6842,11918,9
2022-09-18,경의선,서울역,1312,1249,2561,9
2022-09-18,경의선,홍대입구,1911,2329,4240,9
2022-09-18,1호선,서울역,32843,32591,65434,9
2022-09-18,공항철도 1호선,서울역,10239,9779,20018,9
2022-09-18,공항철도 1호선,홍대입구,13136,12235,25371,9
2022-09-18,분당선,선릉,3263,5041,8304,9
2022-09-18,신림선,신림,1121,1545,2666,9
2022-09-19,경부선,서울역,7381,2554,9935,9
2022-09-19,2호선,잠실(송파구청),71715,71381,143096,9
2022-09-19,2호선,선릉,61780,54227,116007,9
2022-09-19,2호선,강남,83298,79008,162306,9
2022-09-19,2호선,사당,40094,44228,84322,9
2022-09-19,2호선,신림,59451,57690,117141,9
2022-09-19,2호선,구로디지털단지,62741,61328,124069,9
2022-09-19,2호선,홍대입구,57668,60286,117954,9
2022-09-19,3호선,고속터미널,41201,40506,81707,9
2022-09-19,4호선,서울역,12525,18559,31084,9
2022-09-19,4호선,사당,26938,24522,51460,9
2022-09-19,7호선,고속터미널,16558,14247,30805,9
2022-09-19,7호선,가산디지털단지,48471,48861,97332,9
2022-09-19,8호선,잠실(송파구청),14322,16803,31125,9
2022-09-19,9호선,고속터미널,13152,17446,30598,9
2022-09-19,경부선,가산디지털단지,19745,23089,42834,9
2022-09-19,경의선,서울역,5304,6845,12149,9
2022-09-19,경의선,홍대입구,1829,2146,3975,9
2022-09-19,공항철도 1호선,서울역,9583,9102,18685,9
2022-09-19,공항철도 1호선,홍대입구,10947,10914,21861,9
2022-09-19,분당선,선릉,14904,22913,37817,9
2022-09-19,신림선,신림,1722,2247,3969,9
2022-09-19,1호선,서울역,48798,48175,96973,9
2022-09-20,1호선,서울역,49585,48440,98025,9
2022-09-20,2호선,잠실(송파구청),75130,74982,150112,9
2022-09-20,2호선,선릉,64376,57019,121395,9
2022-09-20,2호선,강남,86588,82967,169555,9
2022-09-20,2호선,사당,42594,46072,88666,9
2022-09-20,2호선,신림,61031,58494,119525,9
2022-09-20,2호선,구로디지털단지,64619,64861,129480,9
2022-09-20,2호선,홍대입구,59640,62859,122499,9
2022-09-20,3호선,고속터미널,42470,40458,82928,9
2022-09-20,4호선,서울역,13046,18860,31906,9
2022-09-20,4호선,사당,28038,23920,51958,9
2022-09-20,7호선,고속터미널,15956,14194,30150,9
2022-09-20,7호선,가산디지털단지,49064,49378,98442,9
2022-09-20,8호선,잠실(송파구청),14748,17352,32100,9
2022-09-20,9호선,고속터미널,13558,17024,30582,9
2022-09-20,경부선,서울역,6788,2273,9061,9
2022-09-20,경부선,가산디지털단지,20189,23452,43641,9
2022-09-20,경의선,서울역,5338,6816,12154,9
2022-09-20,경의선,홍대입구,1981,2278,4259,9
2022-09-20,공항철도 1호선,서울역,9417,8294,17711,9
2022-09-20,공항철도 1호선,홍대입구,10991,11287,22278,9
2022-09-20,분당선,선릉,15408,23206,38614,9
2022-09-20,신림선,신림,1692,2301,3993,9
2022-09-21,신림선,신림,1655,2307,3962,9
2022-09-21,분당선,선릉,15108,22756,37864,9
2022-09-21,공항철도 1호선,홍대입구,11431,11552,22983,9
2022-09-21,공항철도 1호선,서울역,9577,8652,18229,9
2022-09-21,경의선,홍대입구,2009,2320,4329,9
2022-09-21,경의선,서울역,5211,6936,12147,9
2022-09-21,경부선,가산디지털단지,19791,23099,42890,9
2022-09-21,경부선,서울역,7131,2274,9405,9
2022-09-21,9호선,고속터미널,13985,17598,31583,9
2022-09-21,8호선,잠실(송파구청),15019,17801,32820,9
2022-09-21,7호선,가산디지털단지,48799,49021,97820,9
2022-09-21,7호선,고속터미널,15784,14194,29978,9
2022-09-21,4호선,사당,28569,24273,52842,9
2022-09-21,4호선,서울역,13301,19189,32490,9
2022-09-21,3호선,고속터미널,43364,41003,84367,9
2022-09-21,2호선,홍대입구,60550,64305,124855,9
2022-09-21,2호선,구로디지털단지,64518,64683,129201,9
2022-09-21,2호선,신림,61582,59098,120680,9
2022-09-21,2호선,사당,42832,46166,88998,9
2022-09-21,2호선,강남,86355,82635,168990,9
2022-09-21,2호선,선릉,63476,56174,119650,9
2022-09-21,2호선,잠실(송파구청),75937,76350,152287,9
2022-09-21,1호선,서울역,50430,49003,99433,9
2022-09-22,2호선,잠실(송파구청),76996,77594,154590,9
2022-09-22,2호선,선릉,63237,56388,119625,9
2022-09-22,2호선,강남,86478,83687,170165,9
2022-09-22,2호선,사당,43670,47142,90812,9
2022-09-22,2호선,신림,61733,59103,120836,9
2022-09-22,2호선,구로디지털단지,64873,64833,129706,9
2022-09-22,2호선,홍대입구,61635,65604,127239,9
2022-09-22,3호선,고속터미널,44780,41819,86599,9
2022-09-22,4호선,서울역,13171,19897,33068,9
2022-09-22,4호선,사당,28702,24813,53515,9
2022-09-22,7호선,고속터미널,16699,14258,30957,9
2022-09-22,7호선,가산디지털단지,48260,48927,97187,9
2022-09-22,8호선,잠실(송파구청),14859,17571,32430,9
2022-09-22,9호선,고속터미널,14320,17725,32045,9
2022-09-22,경부선,서울역,7706,2337,10043,9
2022-09-22,경부선,가산디지털단지,20215,23195,43410,9
2022-09-22,경의선,서울역,5375,6998,12373,9
2022-09-22,경의선,홍대입구,1998,2464,4462,9
2022-09-22,공항철도 1호선,서울역,10211,8985,19196,9
2022-09-22,공항철도 1호선,홍대입구,11644,12287,23931,9
2022-09-22,분당선,선릉,15000,22908,37908,9
2022-09-22,신림선,신림,1634,2337,3971,9
2022-09-22,1호선,서울역,51885,50427,102312,9
2022-09-23,1호선,서울역,57535,55995,113530,9
2022-09-23,2호선,잠실(송파구청),84302,84546,168848,9
2022-09-23,2호선,선릉,62556,55639,118195,9
2022-09-23,2호선,강남,92109,91106,183215,9
2022-09-23,2호선,사당,46066,51349,97415,9
2022-09-23,2호선,신림,64229,61766,125995,9
2022-09-23,2호선,구로디지털단지,65321,65146,130467,9
2022-09-23,2호선,홍대입구,68305,77980,146285,9
2022-09-23,3호선,고속터미널,54310,53429,107739,9
2022-09-23,4호선,서울역,13437,22765,36202,9
2022-09-23,4호선,사당,30731,26803,57534,9
2022-09-23,7호선,고속터미널,19935,15648,35583,9
2022-09-23,7호선,가산디지털단지,48254,47990,96244,9
2022-09-23,8호선,잠실(송파구청),15936,19633,35569,9
2022-09-23,9호선,고속터미널,16986,22204,39190,9
2022-09-23,경부선,서울역,10309,3306,13615,9
2022-09-23,경부선,가산디지털단지,19995,22995,42990,9
2022-09-23,경의선,서울역,5533,7032,12565,9
2022-09-23,경의선,홍대입구,2269,2866,5135,9
2022-09-23,공항철도 1호선,서울역,12595,11102,23697,9
2022-09-23,공항철도 1호선,홍대입구,13094,14219,27313,9
2022-09-23,분당선,선릉,14770,22498,37268,9
2022-09-23,신림선,신림,1800,2430,4230,9
2022-09-24,1호선,서울역,46646,44963,91609,9
2022-09-24,2호선,잠실(송파구청),79023,75520,154543,9
2022-09-24,2호선,선릉,28756,25486,54242,9
2022-09-24,2호선,강남,64356,65323,129679,9
2022-09-24,2호선,사당,38887,44038,82925,9
2022-09-24,2호선,신림,51975,49118,101093,9
2022-09-24,2호선,구로디지털단지,39028,38270,77298,9
2022-09-24,2호선,홍대입구,75353,86659,162012,9
2022-09-24,3호선,고속터미널,64949,60751,125700,9
2022-09-24,4호선,서울역,8321,19092,27413,9
2022-09-24,4호선,사당,26503,24017,50520,9
2022-09-24,7호선,고속터미널,17763,13835,31598,9
2022-09-24,7호선,가산디지털단지,16308,14777,31085,9
2022-09-24,8호선,잠실(송파구청),14416,17515,31931,9
2022-09-24,9호선,고속터미널,20808,28334,49142,9
2022-09-24,경부선,서울역,11079,2923,14002,9
2022-09-24,경부선,가산디지털단지,7391,9824,17215,9
2022-09-24,경의선,서울역,1887,2042,3929,9
2022-09-24,경의선,홍대입구,2302,3130,5432,9
2022-09-24,공항철도 1호선,서울역,11599,11102,22701,9
2022-09-24,공항철도 1호선,홍대입구,15485,16489,31974,9
2022-09-24,분당선,선릉,6148,9587,15735,9
2022-09-24,신림선,신림,1413,1937,3350,9
2022-09-25,1호선,서울역,34571,33994,68565,9
2022-09-25,2호선,잠실(송파구청),56661,52479,109140,9
2022-09-25,2호선,선릉,15695,13387,29082,9
2022-09-25,2호선,강남,37780,36088,73868,9
2022-09-25,2호선,사당,26948,29308,56256,9
2022-09-25,2호선,신림,38622,37257,75879,9
2022-09-25,2호선,구로디지털단지,28030,27006,55036,9
2022-09-25,2호선,홍대입구,58039,57883,115922,9
2022-09-25,3호선,고속터미널,51498,47890,99388,9
2022-09-25,4호선,서울역,5744,14569,20313,9
2022-09-25,4호선,사당,19015,17536,36551,9
2022-09-25,7호선,고속터미널,14225,9678,23903,9
2022-09-25,7호선,가산디지털단지,11846,10790,22636,9
2022-09-25,8호선,잠실(송파구청),11060,12497,23557,9
2022-09-25,9호선,고속터미널,15345,21812,37157,9
2022-09-25,경부선,서울역,10091,2570,12661,9
2022-09-25,경부선,가산디지털단지,5741,7522,13263,9
2022-09-25,경의선,서울역,1428,1354,2782,9
2022-09-25,경의선,홍대입구,1841,2257,4098,9
2022-09-25,공항철도 1호선,서울역,10525,9803,20328,9
2022-09-25,공항철도 1호선,홍대입구,12933,11782,24715,9
2022-09-25,분당선,선릉,3269,5008,8277,9
2022-09-25,신림선,신림,1125,1574,2699,9
2022-09-26,신림선,신림,1662,2232,3894,9
2022-09-26,1호선,서울역,50484,49337,99821,9
2022-09-26,2호선,잠실(송파구청),71504,71692,143196,9
2022-09-26,2호선,선릉,61992,55173,117165,9
2022-09-26,2호선,강남,83164,80195,163359,9
2022-09-26,2호선,사당,39467,42931,82398,9
2022-09-26,2호선,신림,59812,57032,116844,9
2022-09-26,2호선,구로디지털단지,63067,63213,126280,9
2022-09-26,2호선,홍대입구,56147,59073,115220,9
2022-09-26,3호선,고속터미널,43058,41921,84979,9
2022-09-26,4호선,서울역,12779,19089,31868,9
2022-09-26,4호선,사당,26866,22678,49544,9
2022-09-26,7호선,고속터미널,16646,14351,30997,9
2022-09-26,7호선,가산디지털단지,48585,49133,97718,9
2022-09-26,8호선,잠실(송파구청),14217,16900,31117,9
2022-09-26,9호선,고속터미널,13450,17287,30737,9
2022-09-26,경부선,서울역,7805,2477,10282,9
2022-09-26,경부선,가산디지털단지,19971,23025,42996,9
2022-09-26,경의선,서울역,5292,6920,12212,9
2022-09-26,경의선,홍대입구,1860,2125,3985,9
2022-09-26,공항철도 1호선,서울역,9698,8851,18549,9
2022-09-26,공항철도 1호선,홍대입구,10711,10620,21331,9
2022-09-26,분당선,선릉,14876,22350,37226,9
2022-09-27,경의선,서울역,5510,6982,12492,9
2022-09-27,신림선,신림,1656,2236,3892,9
2022-09-27,분당선,선릉,15399,23152,38551,9
2022-09-27,공항철도 1호선,홍대입구,10987,11387,22374,9
2022-09-27,공항철도 1호선,서울역,9668,8502,18170,9
2022-09-27,경의선,홍대입구,1951,2247,4198,9
2022-09-27,경부선,가산디지털단지,20231,23256,43487,9
2022-09-27,경부선,서울역,7144,2258,9402,9
2022-09-27,9호선,고속터미널,13772,17193,30965,9
2022-09-27,8호선,잠실(송파구청),14595,17365,31960,9
2022-09-27,7호선,가산디지털단지,49139,49655,98794,9
2022-09-27,7호선,고속터미널,16488,14313,30801,9
2022-09-27,4호선,사당,28700,24320,53020,9
2022-09-27,4호선,서울역,13320,19250,32570,9
2022-09-27,3호선,고속터미널,42725,40969,83694,9
2022-09-27,2호선,홍대입구,58324,61745,120069,9
2022-09-27,2호선,구로디지털단지,64870,64887,129757,9
2022-09-27,2호선,신림,60803,58388,119191,9
2022-09-27,2호선,사당,42545,46394,88939,9
2022-09-27,2호선,강남,85170,82589,167759,9
2022-09-27,2호선,선릉,65048,57587,122635,9
2022-09-27,2호선,잠실(송파구청),75622,75670,151292,9
2022-09-27,1호선,서울역,50442,49278,99720,9
2022-09-28,2호선,잠실(송파구청),75861,74970,150831,9
2022-09-28,2호선,선릉,63659,56545,120204,9
2022-09-28,2호선,강남,84347,81397,165744,9
2022-09-28,2호선,사당,42389,45878,88267,9
2022-09-28,2호선,신림,61542,59131,120673,9
2022-09-28,2호선,구로디지털단지,64391,64355,128746,9
2022-09-28,2호선,홍대입구,59568,63290,122858,9
2022-09-28,3호선,고속터미널,42617,40586,83203,9
2022-09-28,4호선,서울역,13162,19228,32390,9
2022-09-28,4호선,사당,28223,24273,52496,9
2022-09-28,7호선,고속터미널,15832,14137,29969,9
2022-09-28,7호선,가산디지털단지,48425,48887,97312,9
2022-09-28,8호선,잠실(송파구청),14972,17803,32775,9
2022-09-28,9호선,고속터미널,13777,17260,31037,9
2022-09-28,경부선,서울역,6976,2309,9285,9
2022-09-28,분당선,선릉,15093,22715,37808,9
2022-09-28,경부선,가산디지털단지,20080,23274,43354,9
2022-09-28,신림선,신림,1598,2256,3854,9
2022-09-28,경의선,서울역,5343,6990,12333,9
2022-09-28,경의선,홍대입구,1971,2378,4349,9
2022-09-28,1호선,서울역,50639,49173,99812,9
2022-09-28,공항철도 1호선,서울역,9575,8745,18320,9
2022-09-28,공항철도 1호선,홍대입구,11191,11107,22298,9
2022-09-29,경부선,가산디지털단지,20295,23404,43699,9
2022-09-29,경부선,서울역,7690,2361,10051,9
2022-09-29,9호선,고속터미널,14349,17798,32147,9
2022-09-29,4호선,사당,28742,24776,53518,9
2022-09-29,4호선,서울역,13267,19798,33065,9
2022-09-29,3호선,고속터미널,44862,42444,87306,9
2022-09-29,2호선,홍대입구,59861,64183,124044,9
2022-09-29,2호선,구로디지털단지,64833,64833,129666,9
2022-09-29,2호선,신림,61856,59046,120902,9
2022-09-29,2호선,사당,43331,47065,90396,9
2022-09-29,2호선,강남,85299,82527,167826,9
2022-09-29,2호선,선릉,63966,56792,120758,9
2022-09-29,2호선,잠실(송파구청),76864,77262,154126,9
2022-09-29,1호선,서울역,51719,50514,102233,9
2022-09-29,8호선,잠실(송파구청),15335,18109,33444,9
2022-09-29,7호선,가산디지털단지,48090,48863,96953,9
2022-09-29,7호선,고속터미널,16997,14450,31447,9
2022-09-29,신림선,신림,1581,2283,3864,9
2022-09-29,분당선,선릉,15199,22903,38102,9
2022-09-29,공항철도 1호선,홍대입구,11254,11764,23018,9
2022-09-29,공항철도 1호선,서울역,10199,8953,19152,9
2022-09-29,경의선,홍대입구,2152,2405,4557,9
2022-09-29,경의선,서울역,5396,6891,12287,9
2022-09-30,2호선,신림,64402,61073,125475,9
2022-09-30,2호선,사당,44893,49734,94627,9
2022-09-30,2호선,강남,89504,88737,178241,9
2022-09-30,2호선,선릉,62933,55888,118821,9
2022-09-30,2호선,잠실(송파구청),87713,88363,176076,9
2022-09-30,1호선,서울역,58193,58620,116813,9
2022-09-30,분당선,선릉,14824,22457,37281,9
2022-09-30,신림선,신림,1675,2411,4086,9
2022-09-30,2호선,구로디지털단지,65862,64962,130824,9
2022-09-30,2호선,홍대입구,66365,75690,142055,9
2022-09-30,3호선,고속터미널,55197,57805,113002,9
2022-09-30,4호선,서울역,13660,23210,36870,9
2022-09-30,4호선,사당,30651,26890,57541,9
2022-09-30,7호선,고속터미널,20523,16312,36835,9
2022-09-30,7호선,가산디지털단지,47826,47958,95784,9
2022-09-30,8호선,잠실(송파구청),16225,19709,35934,9
2022-09-30,9호선,고속터미널,16991,23775,40766,9
2022-09-30,경부선,서울역,11030,3607,14637,9
2022-09-30,경부선,가산디지털단지,19992,22932,42924,9
2022-09-30,경의선,서울역,5427,7238,12665,9
2022-09-30,경의선,홍대입구,2121,2761,4882,9
2022-09-30,공항철도 1호선,서울역,12725,11573,24298,9
2022-09-30,공항철도 1호선,홍대입구,12609,13478,26087,9
2022-10-01,3호선,고속터미널,59124,62989,122113,10
2022-10-01,4호선,사당,24030,21645,45675,10
2022-10-01,8호선,잠실(송파구청),15030,17708,32738,10
2022-10-01,9호선,고속터미널,17011,26592,43603,10
2022-10-01,4호선,서울역,7210,18520,25730,10
2022-10-01,2호선,홍대입구,72912,82760,155672,10
2022-10-01,2호선,구로디지털단지,38092,37059,75151,10
2022-10-01,2호선,신림,49592,46465,96057,10
2022-10-01,2호선,사당,35260,38943,74203,10
2022-10-01,2호선,강남,58374,58877,117251,10
2022-10-01,2호선,선릉,25718,22659,48377,10
2022-10-01,2호선,잠실(송파구청),78396,75695,154091,10
2022-10-01,1호선,서울역,43012,45410,88422,10
2022-10-01,분당선,선릉,5334,8507,13841,10
2022-10-01,공항철도 1호선,홍대입구,14970,15465,30435,10
2022-10-01,공항철도 1호선,서울역,11624,11734,23358,10
2022-10-01,경의선,홍대입구,2303,2985,5288,10
2022-10-01,경의선,서울역,1797,2059,3856,10
2022-10-01,신림선,신림,1381,1754,3135,10
2022-10-01,경부선,가산디지털단지,6989,9131,16120,10
2022-10-01,경부선,서울역,11088,3473,14561,10
2022-10-01,7호선,가산디지털단지,15645,14161,29806,10
2022-10-01,7호선,고속터미널,17931,14130,32061,10
2022-10-02,2호선,신림,38358,36946,75304,10
2022-10-02,4호선,서울역,5180,13858,19038,10
2022-10-02,3호선,고속터미널,45878,44425,90303,10
2022-10-02,2호선,구로디지털단지,28019,27124,55143,10
2022-10-02,7호선,고속터미널,13445,8893,22338,10
2022-10-02,7호선,가산디지털단지,12053,10533,22586,10
2022-10-02,8호선,잠실(송파구청),14308,15379,29687,10
2022-10-02,9호선,고속터미널,12327,18169,30496,10
2022-10-02,경부선,서울역,9282,2378,11660,10
2022-10-02,경부선,가산디지털단지,5381,7264,12645,10
2022-10-02,경의선,서울역,1198,1284,2482,10
2022-10-02,경의선,홍대입구,1834,2517,4351,10
2022-10-02,공항철도 1호선,서울역,10376,9032,19408,10
2022-10-02,공항철도 1호선,홍대입구,12487,12491,24978,10
2022-10-02,분당선,선릉,3098,4722,7820,10
2022-10-02,신림선,신림,1125,1517,2642,10
2022-10-02,4호선,사당,17730,16105,33835,10
2022-10-02,2호선,홍대입구,60525,63592,124117,10
2022-10-02,2호선,사당,25252,27506,52758,10
2022-10-02,2호선,강남,36721,36591,73312,10
2022-10-02,2호선,선릉,14840,12554,27394,10
2022-10-02,2호선,잠실(송파구청),67903,62909,130812,10
2022-10-02,1호선,서울역,34177,32758,66935,10
2022-10-03,분당선,선릉,2975,4563,7538,10
2022-10-03,1호선,서울역,35360,32951,68311,10
2022-10-03,2호선,잠실(송파구청),48747,46138,94885,10
2022-10-03,2호선,선릉,14806,13251,28057,10
2022-10-03,2호선,강남,30192,29053,59245,10
2022-10-03,2호선,사당,20300,22263,42563,10
2022-10-03,2호선,신림,31728,31704,63432,10
2022-10-03,2호선,구로디지털단지,23452,23871,47323,10
2022-10-03,2호선,홍대입구,46517,45268,91785,10
2022-10-03,3호선,고속터미널,50133,43738,93871,10
2022-10-03,4호선,서울역,4872,12644,17516,10
2022-10-03,4호선,사당,14153,12998,27151,10
2022-10-03,신림선,신림,950,1199,2149,10
2022-10-03,7호선,고속터미널,16153,8705,24858,10
2022-10-03,7호선,가산디지털단지,10469,9684,20153,10
2022-10-03,8호선,잠실(송파구청),10903,11837,22740,10
2022-10-03,9호선,고속터미널,11426,17026,28452,10
2022-10-03,경부선,서울역,10810,2297,13107,10
2022-10-03,경부선,가산디지털단지,4547,6409,10956,10
2022-10-03,경의선,서울역,1370,1209,2579,10
2022-10-03,경의선,홍대입구,1210,1631,2841,10
2022-10-03,공항철도 1호선,서울역,10078,9369,19447,10
2022-10-03,공항철도 1호선,홍대입구,9887,9346,19233,10
2022-10-04,4호선,사당,27205,23100,50305,10
2022-10-04,4호선,서울역,12481,17980,30461,10
2022-10-04,신림선,신림,1662,2190,3852,10
2022-10-04,3호선,고속터미널,41604,39166,80770,10
2022-10-04,2호선,홍대입구,57362,60413,117775,10
2022-10-04,2호선,구로디지털단지,63734,63756,127490,10
2022-10-04,2호선,신림,60298,57899,118197,10
2022-10-04,2호선,사당,40338,44110,84448,10
2022-10-04,2호선,강남,84057,81384,165441,10
2022-10-04,2호선,선릉,63200,56265,119465,10
2022-10-04,2호선,잠실(송파구청),71244,71697,142941,10
2022-10-04,분당선,선릉,15054,22991,38045,10
2022-10-04,공항철도 1호선,홍대입구,10710,11140,21850,10
2022-10-04,공항철도 1호선,서울역,9758,8519,18277,10
2022-10-04,경의선,홍대입구,1863,2214,4077,10
2022-10-04,1호선,서울역,50224,48333,98557,10
2022-10-04,경의선,서울역,5252,6910,12162,10
2022-10-04,경부선,가산디지털단지,20024,23256,43280,10
2022-10-04,경부선,서울역,8243,2453,10696,10
2022-10-04,9호선,고속터미널,13292,16572,29864,10
2022-10-04,8호선,잠실(송파구청),14397,17095,31492,10
2022-10-04,7호선,가산디지털단지,49041,49461,98502,10
2022-10-04,7호선,고속터미널,17370,14342,31712,10
2022-10-05,9호선,고속터미널,13457,16981,30438,10
2022-10-05,경부선,서울역,6626,2210,8836,10
2022-10-05,경부선,가산디지털단지,20542,23488,44030,10
2022-10-05,경의선,서울역,5181,6741,11922,10
2022-10-05,경의선,홍대입구,2003,2361,4364,10
2022-10-05,1호선,서울역,49946,49324,99270,10
2022-10-05,2호선,잠실(송파구청),78384,78633,157017,10
2022-10-05,2호선,선릉,64345,57040,121385,10
2022-10-05,2호선,강남,86317,83360,169677,10
2022-10-05,2호선,사당,42509,45793,88302,10
2022-10-05,2호선,신림,61384,59000,120384,10
2022-10-05,2호선,구로디지털단지,65173,65277,130450,10
2022-10-05,2호선,홍대입구,60363,63588,123951,10
2022-10-05,3호선,고속터미널,41822,39959,81781,10
2022-10-05,공항철도 1호선,서울역,9422,8480,17902,10
2022-10-05,공항철도 1호선,홍대입구,11122,11445,22567,10
2022-10-05,분당선,선릉,15329,23204,38533,10
2022-10-05,신림선,신림,1629,2274,3903,10
2022-10-05,4호선,서울역,13252,19188,32440,10
2022-10-05,4호선,사당,28265,23940,52205,10
2022-10-05,7호선,고속터미널,15883,14047,29930,10
2022-10-05,7호선,가산디지털단지,49375,49908,99283,10
2022-10-05,8호선,잠실(송파구청),15556,18397,33953,10
2022-10-06,9호선,고속터미널,14225,17806,32031,10
2022-10-06,경부선,가산디지털단지,20052,23527,43579,10
2022-10-06,경부선,서울역,7522,2593,10115,10
2022-10-06,2호선,잠실(송파구청),78863,79245,158108,10
2022-10-06,2호선,선릉,65166,57796,122962,10
2022-10-06,2호선,강남,87747,84654,172401,10
2022-10-06,2호선,사당,42963,46793,89756,10
2022-10-06,2호선,신림,61790,58887,120677,10
2022-10-06,2호선,구로디지털단지,65767,65678,131445,10
2022-10-06,2호선,홍대입구,61038,65735,126773,10
2022-10-06,3호선,고속터미널,44224,42404,86628,10
2022-10-06,경의선,서울역,5377,7083,12460,10
2022-10-06,경의선,홍대입구,2053,2434,4487,10
2022-10-06,공항철도 1호선,서울역,10402,9008,19410,10
2022-10-06,공항철도 1호선,홍대입구,11526,11743,23269,10
2022-10-06,분당선,선릉,15384,23491,38875,10
2022-10-06,신림선,신림,1666,2335,4001,10
2022-10-06,1호선,서울역,51791,51553,103344,10
2022-10-06,4호선,서울역,13508,20153,33661,10
2022-10-06,4호선,사당,28709,24512,53221,10
2022-10-06,7호선,고속터미널,17011,14407,31418,10
2022-10-06,7호선,가산디지털단지,48875,49603,98478,10
2022-10-06,8호선,잠실(송파구청),15757,18940,34697,10
2022-10-07,2호선,홍대입구,71077,80895,151972,10
2022-10-07,1호선,서울역,59379,59698,119077,10
2022-10-07,2호선,강남,93385,92171,185556,10
2022-10-07,2호선,선릉,64638,57412,122050,10
2022-10-07,2호선,잠실(송파구청),91463,91438,182901,10
2022-10-07,2호선,구로디지털단지,66811,66768,133579,10
2022-10-07,2호선,신림,64672,61855,126527,10
2022-10-07,2호선,사당,45843,51538,97381,10
2022-10-07,경부선,가산디지털단지,20117,23149,43266,10
2022-10-07,경부선,서울역,10881,3908,14789,10
2022-10-07,신림선,신림,1669,2305,3974,10
2022-10-07,9호선,고속터미널,17713,24709,42422,10
2022-10-07,분당선,선릉,15069,23061,38130,10
2022-10-07,공항철도 1호선,홍대입구,13730,14370,28100,10
2022-10-07,공항철도 1호선,서울역,13317,11889,25206,10
2022-10-07,경의선,홍대입구,2296,2953,5249,10
2022-10-07,경의선,서울역,5434,7329,12763,10
2022-10-07,8호선,잠실(송파구청),17818,21557,39375,10
2022-10-07,7호선,가산디지털단지,49335,48956,98291,10
2022-10-07,7호선,고속터미널,20522,16206,36728,10
2022-10-07,4호선,사당,31191,26447,57638,10
2022-10-07,4호선,서울역,13726,24213,37939,10
2022-10-07,3호선,고속터미널,56017,58994,115011,10
2022-10-08,4호선,사당,27892,24340,52232,10
2022-10-08,4호선,서울역,7748,20536,28284,10
2022-10-08,3호선,고속터미널,63442,66498,129940,10
2022-10-08,2호선,홍대입구,81131,93317,174448,10
2022-10-08,2호선,구로디지털단지,40125,38904,79029,10
2022-10-08,2호선,신림,52330,48875,101205,10
2022-10-08,2호선,사당,37167,42820,79987,10
2022-10-08,2호선,강남,60050,60129,120179,10
2022-10-08,2호선,선릉,27656,24279,51935,10
2022-10-08,2호선,잠실(송파구청),88521,84715,173236,10
2022-10-08,1호선,서울역,48060,50364,98424,10
2022-10-08,신림선,신림,1650,2546,4196,10
2022-10-08,분당선,선릉,5725,8943,14668,10
2022-10-08,공항철도 1호선,홍대입구,17025,17021,34046,10
2022-10-08,공항철도 1호선,서울역,12825,12547,25372,10
2022-10-08,경의선,홍대입구,2826,4037,6863,10
2022-10-08,경의선,서울역,1835,2123,3958,10
2022-10-08,경부선,가산디지털단지,7954,10724,18678,10
2022-10-08,경부선,서울역,11789,3543,15332,10
2022-10-08,9호선,고속터미널,20349,29947,50296,10
2022-10-08,8호선,잠실(송파구청),16709,19139,35848,10
2022-10-08,7호선,가산디지털단지,17010,15362,32372,10
2022-10-08,7호선,고속터미널,19784,14672,34456,10
2022-10-09,1호선,서울역,35676,34219,69895,10
2022-10-09,2호선,잠실(송파구청),66142,61755,127897,10
2022-10-09,2호선,선릉,14335,12178,26513,10
2022-10-09,2호선,강남,34302,34233,68535,10
2022-10-09,2호선,사당,24191,26357,50548,10
2022-10-09,2호선,신림,36863,35054,71917,10
2022-10-09,2호선,구로디지털단지,26429,25510,51939,10
2022-10-09,2호선,홍대입구,61902,64325,126227,10
2022-10-09,3호선,고속터미널,47948,46516,94464,10
2022-10-09,4호선,서울역,5415,14830,20245,10
2022-10-09,4호선,사당,17170,15488,32658,10
2022-10-09,7호선,고속터미널,13818,8794,22612,10
2022-10-09,7호선,가산디지털단지,11669,10117,21786,10
2022-10-09,8호선,잠실(송파구청),13632,15068,28700,10
2022-10-09,9호선,고속터미널,11616,18645,30261,10
2022-10-09,경부선,서울역,10141,2563,12704,10
2022-10-09,경부선,가산디지털단지,4805,6812,11617,10
2022-10-09,경의선,서울역,1287,1234,2521,10
2022-10-09,경의선,홍대입구,1721,2369,4090,10
2022-10-09,공항철도 1호선,서울역,10967,9645,20612,10
2022-10-09,공항철도 1호선,홍대입구,12555,12361,24916,10
2022-10-09,분당선,선릉,3057,4744,7801,10
2022-10-09,신림선,신림,1012,1326,2338,10
2022-10-10,신림선,신림,1003,1444,2447,10
2022-10-10,1호선,서울역,38354,36260,74614,10
2022-10-10,2호선,잠실(송파구청),60295,56211,116506,10
2022-10-10,2호선,선릉,17638,15726,33364,10
2022-10-10,2호선,강남,35743,34488,70231,10
2022-10-10,2호선,사당,23163,25510,48673,10
2022-10-10,2호선,신림,35960,35034,70994,10
2022-10-10,2호선,구로디지털단지,27098,26658,53756,10
2022-10-10,2호선,홍대입구,55596,55575,111171,10
2022-10-10,3호선,고속터미널,54671,48454,103125,10
2022-10-10,4호선,서울역,5402,14006,19408,10
2022-10-10,4호선,사당,15971,14634,30605,10
2022-10-10,7호선,고속터미널,16498,9243,25741,10
2022-10-10,7호선,가산디지털단지,13530,12505,26035,10
2022-10-10,8호선,잠실(송파구청),13181,14244,27425,10
2022-10-10,9호선,고속터미널,13663,19777,33440,10
2022-10-10,경부선,서울역,10298,2418,12716,10
2022-10-10,경부선,가산디지털단지,5474,7695,13169,10
2022-10-10,경의선,서울역,1680,1353,3033,10
2022-10-10,경의선,홍대입구,1692,2161,3853,10
2022-10-10,공항철도 1호선,서울역,10860,10145,21005,10
2022-10-10,공항철도 1호선,홍대입구,11210,10497,21707,10
2022-10-10,분당선,선릉,3463,5439,8902,10
2022-10-11,2호선,선릉,64198,57000,121198,10
2022-10-11,1호선,서울역,52941,50452,103393,10
2022-10-11,2호선,잠실(송파구청),78421,78658,157079,10
2022-10-11,2호선,강남,84385,81412,165797,10
2022-10-11,2호선,사당,40842,44832,85674,10
2022-10-11,2호선,신림,60329,58338,118667,10
2022-10-11,2호선,구로디지털단지,64450,64615,129065,10
2022-10-11,2호선,홍대입구,60584,64011,124595,10
2022-10-11,3호선,고속터미널,44584,41952,86536,10
2022-10-11,4호선,서울역,13009,19574,32583,10
2022-10-11,4호선,사당,27988,23753,51741,10
2022-10-11,7호선,고속터미널,17274,14389,31663,10
2022-10-11,7호선,가산디지털단지,49363,49606,98969,10
2022-10-11,8호선,잠실(송파구청),15286,17975,33261,10
2022-10-11,9호선,고속터미널,13640,17419,31059,10
2022-10-11,경부선,서울역,9066,2705,11771,10
2022-10-11,경부선,가산디지털단지,19931,23301,43232,10
2022-10-11,경의선,서울역,5286,6558,11844,10
2022-10-11,경의선,홍대입구,1970,2248,4218,10
2022-10-11,공항철도 1호선,서울역,10683,9350,20033,10
2022-10-11,공항철도 1호선,홍대입구,11439,11497,22936,10
2022-10-11,분당선,선릉,15297,23094,38391,10
2022-10-11,신림선,신림,1734,2350,4084,10
2022-10-12,1호선,서울역,51393,50516,101909,10
2022-10-12,2호선,잠실(송파구청),78799,78746,157545,10
2022-10-12,2호선,선릉,65211,58215,123426,10
2022-10-12,2호선,강남,85370,82250,167620,10
2022-10-12,분당선,선릉,15372,22430,37802,10
2022-10-12,2호선,사당,42677,46009,88686,10
2022-10-12,2호선,신림,61935,59507,121442,10
2022-10-12,2호선,구로디지털단지,65597,65806,131403,10
2022-10-12,2호선,홍대입구,60641,65133,125774,10
2022-10-12,3호선,고속터미널,42921,40773,83694,10
2022-10-12,4호선,서울역,13708,20398,34106,10
2022-10-12,신림선,신림,1671,2286,3957,10
2022-10-12,4호선,사당,28210,24310,52520,10
2022-10-12,7호선,고속터미널,16204,14201,30405,10
2022-10-12,7호선,가산디지털단지,49590,49902,99492,10
2022-10-12,8호선,잠실(송파구청),15270,18294,33564,10
2022-10-12,9호선,고속터미널,13859,17209,31068,10
2022-10-12,경부선,서울역,7644,2473,10117,10
2022-10-12,경부선,가산디지털단지,20136,23573,43709,10
2022-10-12,경의선,서울역,5449,6978,12427,10
2022-10-12,경의선,홍대입구,2171,2478,4649,10
2022-10-12,공항철도 1호선,서울역,10339,8942,19281,10
2022-10-12,공항철도 1호선,홍대입구,11638,11591,23229,10
2022-10-13,1호선,서울역,53544,51467,105011,10
2022-10-13,2호선,잠실(송파구청),79420,80033,159453,10
2022-10-13,2호선,선릉,64542,57649,122191,10
2022-10-13,2호선,강남,86509,83742,170251,10
2022-10-13,2호선,사당,43713,48287,92000,10
2022-10-13,2호선,신림,62705,59501,122206,10
2022-10-13,2호선,구로디지털단지,66129,66108,132237,10
2022-10-13,2호선,홍대입구,63310,67468,130778,10
2022-10-13,3호선,고속터미널,44510,41921,86431,10
2022-10-13,4호선,서울역,13969,21132,35101,10
2022-10-13,4호선,사당,29738,25404,55142,10
2022-10-13,7호선,고속터미널,16896,14444,31340,10
2022-10-13,7호선,가산디지털단지,49231,50069,99300,10
2022-10-13,8호선,잠실(송파구청),15477,18716,34193,10
2022-10-13,9호선,고속터미널,14386,17852,32238,10
2022-10-13,경부선,서울역,8190,2444,10634,10
2022-10-13,경부선,가산디지털단지,20333,23479,43812,10
2022-10-13,경의선,서울역,5512,7042,12554,10
2022-10-13,경의선,홍대입구,2101,2412,4513,10
2022-10-13,공항철도 1호선,서울역,11955,9653,21608,10
2022-10-13,공항철도 1호선,홍대입구,12064,12445,24509,10
2022-10-13,분당선,선릉,15244,23224,38468,10
2022-10-13,신림선,신림,1720,2357,4077,10
2022-10-14,2호선,홍대입구,68452,77263,145715,10
2022-10-14,2호선,구로디지털단지,66503,66182,132685,10
2022-10-14,2호선,신림,63684,60864,124548,10
2022-10-14,2호선,사당,45395,50280,95675,10
2022-10-14,2호선,강남,91148,89826,180974,10
2022-10-14,2호선,선릉,64253,57308,121561,10
2022-10-14,2호선,잠실(송파구청),87415,87346,174761,10
2022-10-14,1호선,서울역,58607,58245,116852,10
2022-10-14,신림선,신림,1740,2374,4114,10
2022-10-14,3호선,고속터미널,52072,52406,104478,10
2022-10-14,분당선,선릉,14914,22940,37854,10
2022-10-14,공항철도 1호선,홍대입구,13683,13834,27517,10
2022-10-14,공항철도 1호선,서울역,13066,12107,25173,10
2022-10-14,경의선,홍대입구,2346,2891,5237,10
2022-10-14,경의선,서울역,5423,7256,12679,10
2022-10-14,경부선,가산디지털단지,20076,23157,43233,10
2022-10-14,경부선,서울역,10888,3436,14324,10
2022-10-14,9호선,고속터미널,16151,21594,37745,10
2022-10-14,8호선,잠실(송파구청),16930,21050,37980,10
2022-10-14,7호선,가산디지털단지,49414,49209,98623,10
2022-10-14,7호선,고속터미널,19378,15654,35032,10
2022-10-14,4호선,사당,30288,26521,56809,10
2022-10-14,4호선,서울역,13639,23405,37044,10
2022-10-15,신림선,신림,1386,1819,3205,10
2022-10-15,분당선,선릉,5980,9250,15230,10
2022-10-15,공항철도 1호선,홍대입구,15425,15091,30516,10
2022-10-15,공항철도 1호선,서울역,11859,11395,23254,10
2022-10-15,경의선,홍대입구,2338,3064,5402,10
2022-10-15,경의선,서울역,1848,1943,3791,10
2022-10-15,9호선,고속터미널,16375,23863,40238,10
2022-10-15,경부선,서울역,11271,3282,14553,10
2022-10-15,경부선,가산디지털단지,7761,10080,17841,10
2022-10-15,1호선,서울역,44214,44965,89179,10
2022-10-15,2호선,잠실(송파구청),83383,79321,162704,10
2022-10-15,2호선,선릉,27955,24730,52685,10
2022-10-15,2호선,강남,60818,60772,121590,10
2022-10-15,2호선,사당,38311,43009,81320,10
2022-10-15,2호선,신림,51574,48803,100377,10
2022-10-15,2호선,구로디지털단지,39954,38617,78571,10
2022-10-15,2호선,홍대입구,73201,82442,155643,10
2022-10-15,3호선,고속터미널,56313,56897,113210,10
2022-10-15,4호선,서울역,7654,19954,27608,10
2022-10-15,4호선,사당,25578,23467,49045,10
2022-10-15,7호선,고속터미널,17439,13478,30917,10
2022-10-15,7호선,가산디지털단지,16807,15252,32059,10
2022-10-15,8호선,잠실(송파구청),15615,18671,34286,10
2022-10-16,9호선,고속터미널,13427,18994,32421,10
2022-10-16,8호선,잠실(송파구청),11834,13462,25296,10
2022-10-16,7호선,가산디지털단지,12294,11391,23685,10
2022-10-16,7호선,고속터미널,14693,9522,24215,10
2022-10-16,4호선,사당,18464,17218,35682,10
2022-10-16,4호선,서울역,5763,14606,20369,10
2022-10-16,3호선,고속터미널,47638,44253,91891,10
2022-10-16,2호선,홍대입구,57163,56775,113938,10
2022-10-16,2호선,구로디지털단지,28799,27857,56656,10
2022-10-16,2호선,신림,37966,36702,74668,10
2022-10-16,2호선,사당,26710,28683,55393,10
2022-10-16,2호선,강남,34385,33049,67434,10
2022-10-16,2호선,선릉,14857,12814,27671,10
2022-10-16,2호선,잠실(송파구청),59202,54296,113498,10
2022-10-16,신림선,신림,1084,1461,2545,10
2022-10-16,분당선,선릉,3224,4718,7942,10
2022-10-16,공항철도 1호선,홍대입구,12600,11711,24311,10
2022-10-16,공항철도 1호선,서울역,12294,9949,22243,10
2022-10-16,경의선,홍대입구,1860,2346,4206,10
2022-10-16,경의선,서울역,1439,1265,2704,10
2022-10-16,경부선,가산디지털단지,5690,7631,13321,10
2022-10-16,경부선,서울역,10418,2460,12878,10
2022-10-16,1호선,서울역,37204,34868,72072,10
2022-10-17,경부선,서울역,7972,2428,10400,10
2022-10-17,경부선,가산디지털단지,19831,23253,43084,10
2022-10-17,경의선,서울역,5365,7032,12397,10
2022-10-17,경의선,홍대입구,1808,2133,3941,10
2022-10-17,공항철도 1호선,서울역,10599,9574,20173,10
2022-10-17,공항철도 1호선,홍대입구,11059,11011,22070,10
2022-10-17,분당선,선릉,15147,22741,37888,10
2022-10-17,신림선,신림,1628,2201,3829,10
2022-10-17,1호선,서울역,52535,50584,103119,10
2022-10-17,2호선,잠실(송파구청),74460,73594,148054,10
2022-10-17,2호선,선릉,62906,56057,118963,10
2022-10-17,2호선,강남,82718,79979,162697,10
2022-10-17,2호선,사당,39695,43073,82768,10
2022-10-17,2호선,신림,59343,57150,116493,10
2022-10-17,2호선,구로디지털단지,63490,63571,127061,10
2022-10-17,2호선,홍대입구,59728,62380,122108,10
2022-10-17,3호선,고속터미널,38338,36663,75001,10
2022-10-17,4호선,서울역,13366,20085,33451,10
2022-10-17,4호선,사당,26728,22829,49557,10
2022-10-17,7호선,고속터미널,16846,13893,30739,10
2022-10-17,7호선,가산디지털단지,49322,49492,98814,10
2022-10-17,8호선,잠실(송파구청),14679,17023,31702,10
2022-10-17,9호선,고속터미널,13038,16790,29828,10
2022-10-18,공항철도 1호선,서울역,10287,9037,19324,10
2022-10-18,공항철도 1호선,홍대입구,11544,11332,22876,10
2022-10-18,1호선,서울역,51698,50819,102517,10
2022-10-18,2호선,잠실(송파구청),81187,80742,161929,10
2022-10-18,분당선,선릉,15453,23201,38654,10
2022-10-18,2호선,선릉,64779,57614,122393,10
2022-10-18,2호선,강남,85710,82544,168254,10
2022-10-18,2호선,사당,42106,45664,87770,10
2022-10-18,2호선,신림,60891,58419,119310,10
2022-10-18,2호선,구로디지털단지,65316,65271,130587,10
2022-10-18,2호선,홍대입구,61261,64147,125408,10
2022-10-18,3호선,고속터미널,42966,41064,84030,10
2022-10-18,4호선,서울역,13523,19938,33461,10
2022-10-18,4호선,사당,28050,24154,52204,10
2022-10-18,7호선,고속터미널,16256,14339,30595,10
2022-10-18,7호선,가산디지털단지,49531,49755,99286,10
2022-10-18,8호선,잠실(송파구청),15834,18732,34566,10
2022-10-18,9호선,고속터미널,13477,17030,30507,10
2022-10-18,경부선,서울역,7258,2238,9496,10
2022-10-18,경부선,가산디지털단지,20191,23395,43586,10
2022-10-18,경의선,서울역,5297,7001,12298,10
2022-10-18,경의선,홍대입구,1940,2299,4239,10
2022-10-18,신림선,신림,1724,2346,4070,10
2022-10-19,7호선,고속터미널,16208,14358,30566,10
2022-10-19,7호선,가산디지털단지,49342,49728,99070,10
2022-10-19,8호선,잠실(송파구청),15746,19320,35066,10
2022-10-19,9호선,고속터미널,13775,17638,31413,10
2022-10-19,경부선,서울역,7339,2390,9729,10
2022-10-19,경부선,가산디지털단지,20066,23224,43290,10
2022-10-19,경의선,서울역,5508,6983,12491,10
2022-10-19,경의선,홍대입구,2026,2392,4418,10
2022-10-19,공항철도 1호선,서울역,10414,9087,19501,10
2022-10-19,공항철도 1호선,홍대입구,11395,11728,23123,10
2022-10-19,분당선,선릉,15660,24231,39891,10
2022-10-19,신림선,신림,1818,2331,4149,10
2022-10-19,1호선,서울역,52174,51606,103780,10
2022-10-19,2호선,잠실(송파구청),81890,82639,164529,10
2022-10-19,2호선,선릉,65208,57347,122555,10
2022-10-19,2호선,강남,84873,79642,164515,10
2022-10-19,2호선,사당,42631,46553,89184,10
2022-10-19,2호선,신림,61561,59901,121462,10
2022-10-19,2호선,구로디지털단지,64987,65431,130418,10
2022-10-19,2호선,홍대입구,62024,65120,127144,10
2022-10-19,3호선,고속터미널,43541,41007,84548,10
2022-10-19,4호선,서울역,13702,20923,34625,10
2022-10-19,4호선,사당,28451,24497,52948,10
2022-10-20,공항철도 1호선,홍대입구,11879,12325,24204,10
2022-10-20,공항철도 1호선,서울역,11280,9483,20763,10
2022-10-20,1호선,서울역,53565,52283,105848,10
2022-10-20,2호선,잠실(송파구청),81226,81542,162768,10
2022-10-20,2호선,선릉,64849,57638,122487,10
2022-10-20,2호선,강남,85930,82926,168856,10
2022-10-20,2호선,사당,44067,47842,91909,10
2022-10-20,2호선,신림,61695,59124,120819,10
2022-10-20,2호선,구로디지털단지,65653,65655,131308,10
2022-10-20,2호선,홍대입구,63454,67865,131319,10
2022-10-20,3호선,고속터미널,44256,41924,86180,10
2022-10-20,4호선,서울역,13767,20971,34738,10
2022-10-20,4호선,사당,29112,25047,54159,10
2022-10-20,7호선,고속터미널,16640,14049,30689,10
2022-10-20,7호선,가산디지털단지,49132,49677,98809,10
2022-10-20,8호선,잠실(송파구청),15441,18380,33821,10
2022-10-20,9호선,고속터미널,14126,17958,32084,10
2022-10-20,경부선,서울역,8100,2422,10522,10
2022-10-20,경부선,가산디지털단지,20158,23424,43582,10
2022-10-20,경의선,서울역,5438,7001,12439,10
2022-10-20,경의선,홍대입구,2187,2635,4822,10
2022-10-20,분당선,선릉,15432,23458,38890,10
2022-10-20,신림선,신림,1645,2350,3995,10
2022-10-21,신림선,신림,1803,2401,4204,10
2022-10-21,분당선,선릉,14897,22770,37667,10
2022-10-21,공항철도 1호선,홍대입구,13591,14118,27709,10
2022-10-21,공항철도 1호선,서울역,13261,11803,25064,10
2022-10-21,경의선,홍대입구,2517,2972,5489,10
2022-10-21,경의선,서울역,5495,7237,12732,10
2022-10-21,경부선,가산디지털단지,19902,22844,42746,10
2022-10-21,경부선,서울역,10957,3312,14269,10
2022-10-21,9호선,고속터미널,16449,21932,38381,10
2022-10-21,8호선,잠실(송파구청),16612,20472,37084,10
2022-10-21,7호선,가산디지털단지,48166,48123,96289,10
2022-10-21,7호선,고속터미널,19874,15826,35700,10
2022-10-21,4호선,사당,30896,26776,57672,10
2022-10-21,4호선,서울역,13766,23543,37309,10
2022-10-21,3호선,고속터미널,53025,54225,107250,10
2022-10-21,2호선,홍대입구,70336,80354,150690,10
2022-10-21,2호선,구로디지털단지,66146,65908,132054,10
2022-10-21,2호선,신림,63607,60971,124578,10
2022-10-21,2호선,사당,45719,50895,96614,10
2022-10-21,2호선,강남,90659,90025,180684,10
2022-10-21,2호선,선릉,63198,56153,119351,10
2022-10-21,2호선,잠실(송파구청),92358,92188,184546,10
2022-10-21,1호선,서울역,58988,57555,116543,10
2022-10-22,경부선,가산디지털단지,7543,10086,17629,10
2022-10-22,경부선,서울역,12005,2950,14955,10
2022-10-22,9호선,고속터미널,17542,24958,42500,10
2022-10-22,8호선,잠실(송파구청),15017,18220,33237,10
2022-10-22,7호선,가산디지털단지,17063,15382,32445,10
2022-10-22,7호선,고속터미널,18094,13377,31471,10
2022-10-22,4호선,사당,26680,23828,50508,10
2022-10-22,4호선,서울역,11260,21503,32763,10
2022-10-22,3호선,고속터미널,58580,58170,116750,10
2022-10-22,2호선,홍대입구,77774,88649,166423,10
2022-10-22,2호선,구로디지털단지,40137,39630,79767,10
2022-10-22,2호선,신림,50926,48434,99360,10
2022-10-22,2호선,사당,38425,44468,82893,10
2022-10-22,2호선,강남,61669,62662,124331,10
2022-10-22,2호선,선릉,28302,25050,53352,10
2022-10-22,2호선,잠실(송파구청),88494,84960,173454,10
2022-10-22,1호선,서울역,57200,50709,107909,10
2022-10-22,경의선,서울역,2498,2227,4725,10
2022-10-22,경의선,홍대입구,2538,3126,5664,10
2022-10-22,공항철도 1호선,서울역,12827,11698,24525,10
2022-10-22,공항철도 1호선,홍대입구,15866,16070,31936,10
2022-10-22,분당선,선릉,5848,9176,15024,10
2022-10-22,신림선,신림,1397,1949,3346,10
2022-10-23,7호선,고속터미널,15698,9616,25314,10
2022-10-23,7호선,가산디지털단지,13112,11779,24891,10
2022-10-23,8호선,잠실(송파구청),11612,13397,25009,10
2022-10-23,신림선,신림,1134,1566,2700,10
2022-10-23,9호선,고속터미널,13988,19859,33847,10
2022-10-23,분당선,선릉,3251,4856,8107,10
2022-10-23,공항철도 1호선,홍대입구,12841,11742,24583,10
2022-10-23,공항철도 1호선,서울역,11361,10282,21643,10
2022-10-23,경의선,홍대입구,1937,2460,4397,10
2022-10-23,경의선,서울역,1506,1367,2873,10
2022-10-23,경부선,서울역,10350,2442,12792,10
2022-10-23,경부선,가산디지털단지,5613,7689,13302,10
2022-10-23,1호선,서울역,36000,35934,71934,10
2022-10-23,2호선,잠실(송파구청),63895,59443,123338,10
2022-10-23,2호선,선릉,15084,13162,28246,10
2022-10-23,2호선,강남,35186,33713,68899,10
2022-10-23,2호선,사당,27078,29942,57020,10
2022-10-23,2호선,신림,38155,36846,75001,10
2022-10-23,2호선,구로디지털단지,27870,26941,54811,10
2022-10-23,2호선,홍대입구,59761,59904,119665,10
2022-10-23,3호선,고속터미널,49547,45914,95461,10
2022-10-23,4호선,서울역,6014,15654,21668,10
2022-10-23,4호선,사당,19239,17711,36950,10
2022-10-24,신림선,신림,1651,2297,3948,10
2022-10-24,분당선,선릉,14993,22782,37775,10
2022-10-24,공항철도 1호선,홍대입구,10983,10896,21879,10
2022-10-24,공항철도 1호선,서울역,10846,9690,20536,10
2022-10-24,경의선,홍대입구,1792,2095,3887,10
2022-10-24,경의선,서울역,5196,6981,12177,10
2022-10-24,경부선,가산디지털단지,19736,23115,42851,10
2022-10-24,경부선,서울역,8207,2492,10699,10
2022-10-24,9호선,고속터미널,13377,17561,30938,10
2022-10-24,8호선,잠실(송파구청),15044,17672,32716,10
2022-10-24,7호선,가산디지털단지,49088,49293,98381,10
2022-10-24,7호선,고속터미널,16740,14008,30748,10
2022-10-24,4호선,사당,26674,22605,49279,10
2022-10-24,4호선,서울역,13232,20028,33260,10
2022-10-24,3호선,고속터미널,42758,41500,84258,10
2022-10-24,2호선,홍대입구,58323,60797,119120,10
2022-10-24,2호선,구로디지털단지,63444,63447,126891,10
2022-10-24,2호선,신림,59287,56797,116084,10
2022-10-24,2호선,사당,39141,42921,82062,10
2022-10-24,2호선,강남,82761,79641,162402,10
2022-10-24,2호선,선릉,63740,56252,119992,10
2022-10-24,2호선,잠실(송파구청),76574,76707,153281,10
2022-10-24,1호선,서울역,52086,50671,102757,10
2022-10-25,1호선,서울역,52070,51386,103456,10
2022-10-25,2호선,강남,86204,82248,168452,10
2022-10-25,2호선,선릉,66301,58574,124875,10
2022-10-25,2호선,잠실(송파구청),80974,81024,161998,10
2022-10-25,신림선,신림,1680,2317,3997,10
2022-10-25,분당선,선릉,15553,23483,39036,10
2022-10-25,공항철도 1호선,홍대입구,11482,11673,23155,10
2022-10-25,공항철도 1호선,서울역,10403,8921,19324,10
2022-10-25,경의선,홍대입구,1955,2263,4218,10
2022-10-25,경의선,서울역,5415,6988,12403,10
2022-10-25,경부선,가산디지털단지,20431,23387,43818,10
2022-10-25,경부선,서울역,7253,2285,9538,10
2022-10-25,9호선,고속터미널,13630,17400,31030,10
2022-10-25,8호선,잠실(송파구청),15324,17867,33191,10
2022-10-25,7호선,가산디지털단지,49624,50021,99645,10
2022-10-25,7호선,고속터미널,15961,14027,29988,10
2022-10-25,4호선,사당,30212,24848,55060,10
2022-10-25,4호선,서울역,13415,19510,32925,10
2022-10-25,3호선,고속터미널,42925,40375,83300,10
2022-10-25,2호선,홍대입구,61178,64113,125291,10
2022-10-25,2호선,구로디지털단지,65189,65112,130301,10
2022-10-25,2호선,신림,61099,58815,119914,10
2022-10-25,2호선,사당,43617,46985,90602,10
2022-10-26,공항철도 1호선,홍대입구,11667,11898,23565,10
2022-10-26,분당선,선릉,15522,23599,39121,10
2022-10-26,신림선,신림,1718,2321,4039,10
2022-10-26,4호선,사당,29150,24524,53674,10
2022-10-26,4호선,서울역,13818,20759,34577,10
2022-10-26,3호선,고속터미널,43541,40750,84291,10
2022-10-26,2호선,홍대입구,62835,66440,129275,10
2022-10-26,2호선,구로디지털단지,65315,65329,130644,10
2022-10-26,2호선,신림,62469,60204,122673,10
2022-10-26,2호선,사당,42807,46692,89499,10
2022-10-26,2호선,강남,85789,82544,168333,10
2022-10-26,2호선,선릉,65739,57979,123718,10
2022-10-26,2호선,잠실(송파구청),83791,84129,167920,10
2022-10-26,경의선,홍대입구,2082,2361,4443,10
2022-10-26,경의선,서울역,5376,6922,12298,10
2022-10-26,경부선,가산디지털단지,20321,23461,43782,10
2022-10-26,경부선,서울역,7808,2328,10136,10
2022-10-26,9호선,고속터미널,13813,17441,31254,10
2022-10-26,8호선,잠실(송파구청),15537,18510,34047,10
2022-10-26,7호선,가산디지털단지,49100,49572,98672,10
2022-10-26,7호선,고속터미널,16191,14169,30360,10
2022-10-26,1호선,서울역,53323,52499,105822,10
2022-10-26,공항철도 1호선,서울역,10783,9036,19819,10
2022-10-27,공항철도 1호선,서울역,11611,9567,21178,10
2022-10-27,공항철도 1호선,홍대입구,12164,12365,24529,10
2022-10-27,분당선,선릉,15173,23338,38511,10
2022-10-27,신림선,신림,1730,2305,4035,10
2022-10-27,경의선,홍대입구,2049,2513,4562,10
2022-10-27,경의선,서울역,5531,7053,12584,10
2022-10-27,경부선,가산디지털단지,20190,23456,43646,10
2022-10-27,경부선,서울역,8481,2585,11066,10
2022-10-27,9호선,고속터미널,14670,18030,32700,10
2022-10-27,8호선,잠실(송파구청),15585,18947,34532,10
2022-10-27,7호선,가산디지털단지,48587,49285,97872,10
2022-10-27,7호선,고속터미널,16994,14231,31225,10
2022-10-27,4호선,사당,29716,24807,54523,10
2022-10-27,4호선,서울역,13936,21583,35519,10
2022-10-27,3호선,고속터미널,45106,42348,87454,10
2022-10-27,2호선,홍대입구,65167,69114,134281,10
2022-10-27,2호선,구로디지털단지,65766,65429,131195,10
2022-10-27,2호선,신림,62353,59790,122143,10
2022-10-27,2호선,사당,43466,47697,91163,10
2022-10-27,2호선,강남,86413,83154,169567,10
2022-10-27,2호선,선릉,64921,57902,122823,10
2022-10-27,2호선,잠실(송파구청),83713,83963,167676,10
2022-10-27,1호선,서울역,54756,53221,107977,10
2022-10-28,1호선,서울역,61206,60155,121361,10
2022-10-28,2호선,잠실(송파구청),95408,95061,190469,10
2022-10-28,2호선,선릉,63366,56452,119818,10
2022-10-28,2호선,강남,91725,90765,182490,10
2022-10-28,2호선,사당,45253,50532,95785,10
2022-10-28,2호선,신림,64641,62306,126947,10
2022-10-28,2호선,구로디지털단지,66329,65898,132227,10
2022-10-28,2호선,홍대입구,73720,85831,159551,10
2022-10-28,3호선,고속터미널,54990,54840,109830,10
2022-10-28,4호선,서울역,14092,24588,38680,10
2022-10-28,4호선,사당,31632,26912,58544,10
2022-10-28,7호선,고속터미널,20732,15819,36551,10
2022-10-28,7호선,가산디지털단지,48021,47875,95896,10
2022-10-28,8호선,잠실(송파구청),16832,20964,37796,10
2022-10-28,9호선,고속터미널,16889,22606,39495,10
2022-10-28,경부선,서울역,11578,3481,15059,10
2022-10-28,경부선,가산디지털단지,19802,22991,42793,10
2022-10-28,경의선,서울역,5555,7262,12817,10
2022-10-28,경의선,홍대입구,2388,3003,5391,10
2022-10-28,공항철도 1호선,서울역,13512,11989,25501,10
2022-10-28,공항철도 1호선,홍대입구,14159,14686,28845,10
2022-10-28,분당선,선릉,14924,22819,37743,10
2022-10-28,신림선,신림,1721,2361,4082,10
2022-10-29,1호선,서울역,56563,52503,109066,10
2022-10-29,2호선,잠실(송파구청),91587,88028,179615,10
2022-10-29,2호선,선릉,27838,24797,52635,10
2022-10-29,2호선,강남,61621,63943,125564,10
2022-10-29,2호선,사당,38749,44432,83181,10
2022-10-29,2호선,신림,53290,50135,103425,10
2022-10-29,2호선,구로디지털단지,40806,39366,80172,10
2022-10-29,2호선,홍대입구,84196,102651,186847,10
2022-10-29,3호선,고속터미널,59658,59574,119232,10
2022-10-29,4호선,서울역,10227,22706,32933,10
2022-10-29,4호선,사당,28340,25123,53463,10
2022-10-29,7호선,고속터미널,19097,13350,32447,10
2022-10-29,7호선,가산디지털단지,16576,14957,31533,10
2022-10-29,8호선,잠실(송파구청),15783,19212,34995,10
2022-10-29,9호선,고속터미널,16821,24611,41432,10
2022-10-29,경부선,서울역,12728,3238,15966,10
2022-10-29,경부선,가산디지털단지,7636,9897,17533,10
2022-10-29,경의선,서울역,2247,2218,4465,10
2022-10-29,경의선,홍대입구,2872,4026,6898,10
2022-10-29,공항철도 1호선,서울역,12942,12140,25082,10
2022-10-29,공항철도 1호선,홍대입구,17602,17729,35331,10
2022-10-29,분당선,선릉,5969,9373,15342,10
2022-10-29,신림선,신림,1438,2022,3460,10
2022-10-30,2호선,잠실(송파구청),63695,59307,123002,10
2022-10-30,2호선,선릉,15502,13086,28588,10
2022-10-30,2호선,강남,36245,33716,69961,10
2022-10-30,2호선,사당,25900,28675,54575,10
2022-10-30,2호선,신림,38348,37358,75706,10
2022-10-30,2호선,구로디지털단지,27357,26993,54350,10
2022-10-30,2호선,홍대입구,62517,57812,120329,10
2022-10-30,3호선,고속터미널,48668,46693,95361,10
2022-10-30,4호선,서울역,5887,16513,22400,10
2022-10-30,4호선,사당,18637,17045,35682,10
2022-10-30,신림선,신림,1102,1655,2757,10
2022-10-30,7호선,고속터미널,16774,9916,26690,10
2022-10-30,7호선,가산디지털단지,11863,10989,22852,10
2022-10-30,8호선,잠실(송파구청),11442,12786,24228,10
2022-10-30,9호선,고속터미널,13394,19832,33226,10
2022-10-30,경부선,서울역,10972,2642,13614,10
2022-10-30,경부선,가산디지털단지,5596,7332,12928,10
2022-10-30,경의선,서울역,1518,1479,2997,10
2022-10-30,경의선,홍대입구,2097,2436,4533,10
2022-10-30,공항철도 1호선,서울역,11725,11249,22974,10
2022-10-30,공항철도 1호선,홍대입구,13147,11628,24775,10
2022-10-30,분당선,선릉,3256,4964,8220,10
2022-10-30,1호선,서울역,38311,39081,77392,10
2022-10-31,7호선,고속터미널,17079,14181,31260,10
2022-10-31,신림선,신림,1642,2245,3887,10
2022-10-31,분당선,선릉,14721,22689,37410,10
2022-10-31,7호선,가산디지털단지,48261,48639,96900,10
2022-10-31,8호선,잠실(송파구청),14537,17019,31556,10
2022-10-31,1호선,서울역,51812,49852,101664,10
2022-10-31,공항철도 1호선,홍대입구,11105,10764,21869,10
2022-10-31,공항철도 1호선,서울역,10671,9516,20187,10
2022-10-31,경의선,홍대입구,1851,2227,4078,10
2022-10-31,경의선,서울역,5414,6988,12402,10
2022-10-31,경부선,가산디지털단지,19639,22733,42372,10
2022-10-31,경부선,서울역,8673,2526,11199,10
2022-10-31,9호선,고속터미널,13060,17198,30258,10
2022-10-31,2호선,잠실(송파구청),73660,73843,147503,10
2022-10-31,2호선,선릉,62463,55437,117900,10
2022-10-31,2호선,강남,79691,76872,156563,10
2022-10-31,2호선,사당,38605,42642,81247,10
2022-10-31,2호선,신림,58839,56576,115415,10
2022-10-31,2호선,구로디지털단지,62453,62483,124936,10
2022-10-31,2호선,홍대입구,57913,61461,119374,10
2022-10-31,3호선,고속터미널,42015,40727,82742,10
2022-10-31,4호선,서울역,13221,19920,33141,10
2022-10-31,4호선,사당,26783,22649,49432,10
2022-11-01,7호선,고속터미널,15911,13797,29708,11
2022-11-01,신림선,신림,1692,2252,3944,11
2022-11-01,분당선,선릉,15185,23042,38227,11
2022-11-01,공항철도 1호선,홍대입구,11147,11123,22270,11
2022-11-01,공항철도 1호선,서울역,9538,8607,18145,11
2022-11-01,경의선,홍대입구,1951,2246,4197,11
2022-11-01,경의선,서울역,5398,6822,12220,11
2022-11-01,경부선,가산디지털단지,20078,23507,43585,11
2022-11-01,경부선,서울역,6504,2154,8658,11
2022-11-01,9호선,고속터미널,12863,16656,29519,11
2022-11-01,8호선,잠실(송파구청),14485,17120,31605,11
2022-11-01,7호선,가산디지털단지,48893,49190,98083,11
2022-11-01,1호선,서울역,50185,48097,98282,11
2022-11-01,2호선,잠실(송파구청),74001,74239,148240,11
2022-11-01,2호선,선릉,64058,56658,120716,11
2022-11-01,2호선,강남,81819,78721,160540,11
2022-11-01,2호선,사당,40214,44296,84510,11
2022-11-01,2호선,신림,59646,57503,117149,11
2022-11-01,2호선,구로디지털단지,64022,63796,127818,11
2022-11-01,2호선,홍대입구,59513,62132,121645,11
2022-11-01,3호선,고속터미널,40259,38727,78986,11
2022-11-01,4호선,서울역,13298,19385,32683,11
2022-11-01,4호선,사당,27619,23385,51004,11
2022-11-02,공항철도 1호선,서울역,9975,8792,18767,11
2022-11-02,공항철도 1호선,홍대입구,11398,11470,22868,11
2022-11-02,분당선,선릉,15484,23067,38551,11
2022-11-02,신림선,신림,1709,2316,4025,11
2022-11-02,2호선,구로디지털단지,64199,63889,128088,11
2022-11-02,2호선,홍대입구,60105,63347,123452,11
2022-11-02,3호선,고속터미널,41213,39392,80605,11
2022-11-02,4호선,서울역,13582,20190,33772,11
2022-11-02,4호선,사당,28232,23795,52027,11
2022-11-02,1호선,서울역,50193,49702,99895,11
2022-11-02,2호선,잠실(송파구청),76137,76461,152598,11
2022-11-02,2호선,선릉,64161,56780,120941,11
2022-11-02,2호선,강남,82572,79724,162296,11
2022-11-02,2호선,사당,41240,44990,86230,11
2022-11-02,2호선,신림,60903,58629,119532,11
2022-11-02,7호선,고속터미널,15655,13710,29365,11
2022-11-02,7호선,가산디지털단지,48777,49183,97960,11
2022-11-02,8호선,잠실(송파구청),14846,17638,32484,11
2022-11-02,9호선,고속터미널,13026,16629,29655,11
2022-11-02,경부선,서울역,6859,2208,9067,11
2022-11-02,경부선,가산디지털단지,20232,23195,43427,11
2022-11-02,경의선,서울역,5355,6840,12195,11
2022-11-02,경의선,홍대입구,1963,2156,4119,11
2022-11-03,신림선,신림,1656,2347,4003,11
2022-11-03,7호선,고속터미널,16462,13869,30331,11
2022-11-03,7호선,가산디지털단지,48839,49172,98011,11
2022-11-03,8호선,잠실(송파구청),14938,17793,32731,11
2022-11-03,9호선,고속터미널,13856,17390,31246,11
2022-11-03,경부선,서울역,7565,2547,10112,11
2022-11-03,경부선,가산디지털단지,19992,23014,43006,11
2022-11-03,1호선,서울역,52637,50876,103513,11
2022-11-03,2호선,잠실(송파구청),75566,76213,151779,11
2022-11-03,2호선,선릉,63620,56795,120415,11
2022-11-03,2호선,강남,84018,81368,165386,11
2022-11-03,2호선,사당,42175,46346,88521,11
2022-11-03,2호선,신림,60457,57757,118214,11
2022-11-03,2호선,구로디지털단지,64328,64001,128329,11
2022-11-03,2호선,홍대입구,62497,66206,128703,11
2022-11-03,3호선,고속터미널,43358,41509,84867,11
2022-11-03,4호선,서울역,13567,20491,34058,11
2022-11-03,4호선,사당,28618,24325,52943,11
2022-11-03,분당선,선릉,15104,22870,37974,11
2022-11-03,공항철도 1호선,홍대입구,11465,11726,23191,11
2022-11-03,공항철도 1호선,서울역,11224,9272,20496,11
2022-11-03,경의선,홍대입구,1906,2309,4215,11
2022-11-03,경의선,서울역,5367,6870,12237,11
2022-11-04,신림선,신림,1695,2318,4013,11
2022-11-04,분당선,선릉,14582,22242,36824,11
2022-11-04,공항철도 1호선,홍대입구,12787,13674,26461,11
2022-11-04,공항철도 1호선,서울역,13042,11894,24936,11
2022-11-04,경의선,홍대입구,2085,2566,4651,11
2022-11-04,경의선,서울역,5366,6948,12314,11
2022-11-04,경부선,가산디지털단지,19462,22846,42308,11
2022-11-04,경부선,서울역,10538,3660,14198,11
2022-11-04,9호선,고속터미널,15545,22300,37845,11
2022-11-04,8호선,잠실(송파구청),16233,19678,35911,11
2022-11-04,7호선,가산디지털단지,48849,48216,97065,11
2022-11-04,7호선,고속터미널,20073,15815,35888,11
2022-11-04,1호선,서울역,59662,59072,118734,11
2022-11-04,2호선,잠실(송파구청),83473,83698,167171,11
2022-11-04,2호선,선릉,62282,55237,117519,11
2022-11-04,2호선,강남,88889,88337,177226,11
2022-11-04,2호선,사당,43651,48813,92464,11
2022-11-04,2호선,신림,63145,60652,123797,11
2022-11-04,2호선,구로디지털단지,64654,64559,129213,11
2022-11-04,2호선,홍대입구,68539,76695,145234,11
2022-11-04,3호선,고속터미널,53308,55282,108590,11
2022-11-04,4호선,서울역,13176,23395,36571,11
2022-11-04,4호선,사당,30371,26145,56516,11
2022-11-05,1호선,서울역,46683,46301,92984,11
2022-11-05,2호선,잠실(송파구청),76217,74064,150281,11
2022-11-05,2호선,선릉,27425,24010,51435,11
2022-11-05,2호선,강남,59847,59447,119294,11
2022-11-05,2호선,사당,36403,42475,78878,11
2022-11-05,2호선,신림,49838,47289,97127,11
2022-11-05,2호선,구로디지털단지,38035,37220,75255,11
2022-11-05,2호선,홍대입구,75495,85241,160736,11
2022-11-05,신림선,신림,1396,2003,3399,11
2022-11-05,분당선,선릉,5522,8891,14413,11
2022-11-05,공항철도 1호선,홍대입구,14937,15382,30319,11
2022-11-05,공항철도 1호선,서울역,12257,11706,23963,11
2022-11-05,경의선,홍대입구,2236,2910,5146,11
2022-11-05,3호선,고속터미널,56560,58118,114678,11
2022-11-05,경의선,서울역,1731,2001,3732,11
2022-11-05,4호선,서울역,7607,19535,27142,11
2022-11-05,경부선,가산디지털단지,7284,9951,17235,11
2022-11-05,경부선,서울역,11037,2876,13913,11
2022-11-05,9호선,고속터미널,15578,23306,38884,11
2022-11-05,8호선,잠실(송파구청),14440,17099,31539,11
2022-11-05,7호선,가산디지털단지,16828,15221,32049,11
2022-11-05,7호선,고속터미널,18024,13467,31491,11
2022-11-05,4호선,사당,25861,22873,48734,11
2022-11-06,4호선,서울역,5854,15529,21383,11
2022-11-06,4호선,사당,18949,16834,35783,11
2022-11-06,경의선,서울역,1406,1412,2818,11
2022-11-06,경의선,홍대입구,1880,2388,4268,11
2022-11-06,경부선,가산디지털단지,5757,7677,13434,11
2022-11-06,경부선,서울역,9040,2446,11486,11
2022-11-06,신림선,신림,1118,1649,2767,11
2022-11-06,7호선,고속터미널,16324,9678,26002,11
2022-11-06,7호선,가산디지털단지,12660,11468,24128,11
2022-11-06,8호선,잠실(송파구청),11658,13484,25142,11
2022-11-06,3호선,고속터미널,49738,46007,95745,11
2022-11-06,분당선,선릉,3209,4981,8190,11
2022-11-06,공항철도 1호선,홍대입구,12331,11377,23708,11
2022-11-06,공항철도 1호선,서울역,10892,11046,21938,11
2022-11-06,9호선,고속터미널,13074,18708,31782,11
2022-11-06,1호선,서울역,35989,37105,73094,11
2022-11-06,2호선,잠실(송파구청),57172,54136,111308,11
2022-11-06,2호선,선릉,15407,13250,28657,11
2022-11-06,2호선,강남,34701,33554,68255,11
2022-11-06,2호선,사당,25762,28491,54253,11
2022-11-06,2호선,신림,37842,36484,74326,11
2022-11-06,2호선,구로디지털단지,27950,27027,54977,11
2022-11-06,2호선,홍대입구,56992,57106,114098,11
2022-11-07,신림선,신림,1613,2287,3900,11
2022-11-07,분당선,선릉,14693,22430,37123,11
2022-11-07,공항철도 1호선,홍대입구,10856,10680,21536,11
2022-11-07,공항철도 1호선,서울역,10440,9174,19614,11
2022-11-07,경의선,홍대입구,1778,1976,3754,11
2022-11-07,경의선,서울역,5129,7145,12274,11
2022-11-07,경부선,가산디지털단지,17760,21286,39046,11
2022-11-07,경부선,서울역,5731,2221,7952,11
2022-11-07,9호선,고속터미널,13765,19457,33222,11
2022-11-07,8호선,잠실(송파구청),14167,16568,30735,11
2022-11-07,7호선,가산디지털단지,50769,50322,101091,11
2022-11-07,7호선,고속터미널,18949,14796,33745,11
2022-11-07,4호선,사당,28055,23583,51638,11
2022-11-07,4호선,서울역,13586,19948,33534,11
2022-11-07,3호선,고속터미널,45742,44638,90380,11
2022-11-07,2호선,홍대입구,55672,58553,114225,11
2022-11-07,2호선,구로디지털단지,63405,62675,126080,11
2022-11-07,2호선,신림,58370,56087,114457,11
2022-11-07,2호선,사당,40165,43682,83847,11
2022-11-07,2호선,강남,80522,76888,157410,11
2022-11-07,2호선,선릉,61742,54812,116554,11
2022-11-07,2호선,잠실(송파구청),69077,68784,137861,11
2022-11-07,1호선,서울역,52389,47370,99759,11
2022-11-08,1호선,서울역,50378,48616,98994,11
2022-11-08,2호선,잠실(송파구청),77519,76146,153665,11
2022-11-08,2호선,선릉,63623,56622,120245,11
2022-11-08,2호선,강남,83517,80476,163993,11
2022-11-08,2호선,사당,41965,45754,87719,11
2022-11-08,2호선,신림,60338,57997,118335,11
2022-11-08,2호선,구로디지털단지,64215,64023,128238,11
2022-11-08,2호선,홍대입구,58230,61641,119871,11
2022-11-08,3호선,고속터미널,41926,40071,81997,11
2022-11-08,4호선,서울역,13315,19161,32476,11
2022-11-08,4호선,사당,28549,23796,52345,11
2022-11-08,7호선,고속터미널,16594,14450,31044,11
2022-11-08,7호선,가산디지털단지,49547,50050,99597,11
2022-11-08,8호선,잠실(송파구청),15133,17662,32795,11
2022-11-08,9호선,고속터미널,13120,16794,29914,11
2022-11-08,경부선,서울역,7022,2225,9247,11
2022-11-08,경부선,가산디지털단지,19688,22495,42183,11
2022-11-08,경의선,서울역,5304,6913,12217,11
2022-11-08,경의선,홍대입구,1887,2214,4101,11
2022-11-08,공항철도 1호선,서울역,9778,8785,18563,11
2022-11-08,공항철도 1호선,홍대입구,11015,11122,22137,11
2022-11-08,분당선,선릉,15208,22983,38191,11
2022-11-08,신림선,신림,1722,2276,3998,11
2022-11-09,1호선,서울역,50576,49559,100135,11
2022-11-09,2호선,잠실(송파구청),78955,77253,156208,11
2022-11-09,2호선,선릉,63460,56106,119566,11
2022-11-09,2호선,강남,82637,79904,162541,11
2022-11-09,2호선,사당,42027,45763,87790,11
2022-11-09,2호선,신림,60827,58630,119457,11
2022-11-09,2호선,구로디지털단지,64226,64191,128417,11
2022-11-09,2호선,홍대입구,59814,63201,123015,11
2022-11-09,3호선,고속터미널,41841,40042,81883,11
2022-11-09,4호선,서울역,13283,19575,32858,11
2022-11-09,4호선,사당,28688,24082,52770,11
2022-11-09,7호선,고속터미널,16188,14086,30274,11
2022-11-09,7호선,가산디지털단지,48801,49198,97999,11
2022-11-09,8호선,잠실(송파구청),15445,17879,33324,11
2022-11-09,9호선,고속터미널,13397,16850,30247,11
2022-11-09,경부선,서울역,7035,2179,9214,11
2022-11-09,경부선,가산디지털단지,19940,22774,42714,11
2022-11-09,경의선,서울역,5303,6922,12225,11
2022-11-09,경의선,홍대입구,1906,2192,4098,11
2022-11-09,공항철도 1호선,서울역,10190,8608,18798,11
2022-11-09,공항철도 1호선,홍대입구,11174,11389,22563,11
2022-11-09,분당선,선릉,14931,22728,37659,11
2022-11-09,신림선,신림,1685,2380,4065,11
2022-11-10,1호선,서울역,53405,51659,105064,11
2022-11-10,2호선,잠실(송파구청),80178,78452,158630,11
2022-11-10,2호선,선릉,63532,56445,119977,11
2022-11-10,2호선,강남,83928,81305,165233,11
2022-11-10,2호선,사당,42882,46964,89846,11
2022-11-10,2호선,신림,60949,58474,119423,11
2022-11-10,2호선,구로디지털단지,64320,64232,128552,11
2022-11-10,2호선,홍대입구,61666,66019,127685,11
2022-11-10,3호선,고속터미널,44057,42078,86135,11
2022-11-10,4호선,서울역,13428,20469,33897,11
2022-11-10,4호선,사당,28889,24603,53492,11
2022-11-10,7호선,고속터미널,17504,14778,32282,11
2022-11-10,7호선,가산디지털단지,48752,49394,98146,11
2022-11-10,8호선,잠실(송파구청),15356,18490,33846,11
2022-11-10,9호선,고속터미널,13820,17559,31379,11
2022-11-10,경부선,서울역,7951,2506,10457,11
2022-11-10,경부선,가산디지털단지,19921,23061,42982,11
2022-11-10,경의선,서울역,5323,6891,12214,11
2022-11-10,경의선,홍대입구,1912,2311,4223,11
2022-11-10,공항철도 1호선,서울역,11141,9315,20456,11
2022-11-10,공항철도 1호선,홍대입구,11381,11686,23067,11
2022-11-10,분당선,선릉,15118,22698,37816,11
2022-11-10,신림선,신림,1678,2279,3957,11
2022-11-11,1호선,서울역,58928,59230,118158,11
2022-11-11,2호선,잠실(송파구청),82645,82898,165543,11
2022-11-11,2호선,강남,88704,87536,176240,11
2022-11-11,2호선,사당,44963,50360,95323,11
2022-11-11,2호선,신림,63592,60718,124310,11
2022-11-11,2호선,구로디지털단지,65389,64871,130260,11
2022-11-11,2호선,홍대입구,70202,80243,150445,11
2022-11-11,3호선,고속터미널,53189,55364,108553,11
2022-11-11,4호선,서울역,13450,23267,36717,11
2022-11-11,4호선,사당,31103,26834,57937,11
2022-11-11,7호선,고속터미널,20661,16095,36756,11
2022-11-11,7호선,가산디지털단지,47382,47311,94693,11
2022-11-11,8호선,잠실(송파구청),16065,19090,35155,11
2022-11-11,9호선,고속터미널,16243,22664,38907,11
2022-11-11,경부선,서울역,10706,3488,14194,11
2022-11-11,경부선,가산디지털단지,19214,22114,41328,11
2022-11-11,경의선,서울역,5498,7193,12691,11
2022-11-11,경의선,홍대입구,2191,2602,4793,11
2022-11-11,공항철도 1호선,서울역,13222,12075,25297,11
2022-11-11,공항철도 1호선,홍대입구,13938,14689,28627,11
2022-11-11,분당선,선릉,14666,22346,37012,11
2022-11-11,신림선,신림,1780,2350,4130,11
2022-11-11,2호선,선릉,61307,54797,116104,11
2022-11-12,2호선,강남,59066,58874,117940,11
2022-11-12,2호선,선릉,26502,23573,50075,11
2022-11-12,2호선,잠실(송파구청),73601,70101,143702,11
2022-11-12,1호선,서울역,50491,49980,100471,11
2022-11-12,3호선,고속터미널,56868,57846,114714,11
2022-11-12,7호선,고속터미널,18533,13550,32083,11
2022-11-12,7호선,가산디지털단지,15888,13940,29828,11
2022-11-12,8호선,잠실(송파구청),15111,16812,31923,11
2022-11-12,9호선,고속터미널,14781,23207,37988,11
2022-11-12,경부선,서울역,11522,3224,14746,11
2022-11-12,경부선,가산디지털단지,6727,9379,16106,11
2022-11-12,경의선,서울역,1950,1917,3867,11
2022-11-12,경의선,홍대입구,2008,2637,4645,11
2022-11-12,공항철도 1호선,서울역,12282,11668,23950,11
2022-11-12,공항철도 1호선,홍대입구,14849,15384,30233,11
2022-11-12,분당선,선릉,5670,8713,14383,11
2022-11-12,신림선,신림,1377,1907,3284,11
2022-11-12,4호선,사당,25386,22505,47891,11
2022-11-12,4호선,서울역,8657,20761,29418,11
2022-11-12,2호선,홍대입구,72976,80976,153952,11
2022-11-12,2호선,구로디지털단지,36790,36056,72846,11
2022-11-12,2호선,신림,48768,46510,95278,11
2022-11-12,2호선,사당,36721,41386,78107,11
2022-11-13,신림선,신림,997,1486,2483,11
2022-11-13,1호선,서울역,36262,35316,71578,11
2022-11-13,2호선,잠실(송파구청),55872,52006,107878,11
2022-11-13,2호선,선릉,14994,13054,28048,11
2022-11-13,2호선,강남,34995,33403,68398,11
2022-11-13,2호선,사당,24709,27232,51941,11
2022-11-13,2호선,신림,36489,35642,72131,11
2022-11-13,2호선,구로디지털단지,27401,26287,53688,11
2022-11-13,2호선,홍대입구,57651,58403,116054,11
2022-11-13,3호선,고속터미널,48711,44825,93536,11
2022-11-13,4호선,서울역,5965,14909,20874,11
2022-11-13,4호선,사당,18443,16687,35130,11
2022-11-13,7호선,고속터미널,16324,9433,25757,11
2022-11-13,7호선,가산디지털단지,12214,11154,23368,11
2022-11-13,8호선,잠실(송파구청),11098,12771,23869,11
2022-11-13,9호선,고속터미널,12779,18269,31048,11
2022-11-13,경부선,서울역,10736,2383,13119,11
2022-11-13,경부선,가산디지털단지,5379,7387,12766,11
2022-11-13,경의선,서울역,1302,1204,2506,11
2022-11-13,경의선,홍대입구,1773,2089,3862,11
2022-11-13,공항철도 1호선,서울역,11491,10610,22101,11
2022-11-13,공항철도 1호선,홍대입구,12421,11695,24116,11
2022-11-13,분당선,선릉,3116,4790,7906,11
2022-11-14,7호선,고속터미널,17218,14180,31398,11
2022-11-14,분당선,선릉,14409,21931,36340,11
2022-11-14,공항철도 1호선,홍대입구,10759,10886,21645,11
2022-11-14,공항철도 1호선,서울역,10742,9579,20321,11
2022-11-14,경의선,홍대입구,1740,2040,3780,11
2022-11-14,경의선,서울역,5342,6845,12187,11
2022-11-14,신림선,신림,1564,2152,3716,11
2022-11-14,경부선,가산디지털단지,19415,22380,41795,11
2022-11-14,경부선,서울역,8540,2496,11036,11
2022-11-14,7호선,가산디지털단지,48560,48468,97028,11
2022-11-14,8호선,잠실(송파구청),14834,17317,32151,11
2022-11-14,9호선,고속터미널,12564,16342,28906,11
2022-11-14,2호선,잠실(송파구청),72559,72952,145511,11
2022-11-14,2호선,선릉,61520,55025,116545,11
2022-11-14,2호선,강남,80945,77622,158567,11
2022-11-14,2호선,사당,38702,42820,81522,11
2022-11-14,2호선,신림,58253,56003,114256,11
2022-11-14,2호선,구로디지털단지,62547,62603,125150,11
2022-11-14,2호선,홍대입구,57414,60199,117613,11
2022-11-14,1호선,서울역,52325,49644,101969,11
2022-11-14,3호선,고속터미널,37672,36302,73974,11
2022-11-14,4호선,서울역,12902,19154,32056,11
2022-11-14,4호선,사당,27246,22517,49763,11
2022-11-15,분당선,선릉,14902,22683,37585,11
2022-11-15,공항철도 1호선,홍대입구,10821,11026,21847,11
2022-11-15,공항철도 1호선,서울역,9889,8538,18427,11
2022-11-15,경의선,홍대입구,1877,2135,4012,11
2022-11-15,경의선,서울역,5182,6690,11872,11
2022-11-15,경부선,가산디지털단지,19824,22953,42777,11
2022-11-15,경부선,서울역,7093,2240,9333,11
2022-11-15,9호선,고속터미널,13066,16800,29866,11
2022-11-15,신림선,신림,1702,2225,3927,11
2022-11-15,1호선,서울역,50826,48685,99511,11
2022-11-15,2호선,잠실(송파구청),74638,74816,149454,11
2022-11-15,2호선,선릉,63183,55839,119022,11
2022-11-15,2호선,강남,83743,80377,164120,11
2022-11-15,2호선,사당,41027,44892,85919,11
2022-11-15,2호선,신림,60013,57679,117692,11
2022-11-15,2호선,구로디지털단지,64020,63759,127779,11
2022-11-15,2호선,홍대입구,58392,61111,119503,11
2022-11-15,3호선,고속터미널,42208,40033,82241,11
2022-11-15,4호선,서울역,13001,19087,32088,11
2022-11-15,4호선,사당,28112,24540,52652,11
2022-11-15,7호선,고속터미널,16342,14431,30773,11
2022-11-15,7호선,가산디지털단지,48951,49140,98091,11
2022-11-15,8호선,잠실(송파구청),15226,17675,32901,11
2022-11-16,신림선,신림,1704,2312,4016,11
2022-11-16,분당선,선릉,15052,22546,37598,11
2022-11-16,공항철도 1호선,홍대입구,11511,11470,22981,11
2022-11-16,공항철도 1호선,서울역,10346,9043,19389,11
2022-11-16,경의선,홍대입구,1878,2286,4164,11
2022-11-16,경의선,서울역,5209,6867,12076,11
2022-11-16,경부선,가산디지털단지,19764,22870,42634,11
2022-11-16,경부선,서울역,7271,2330,9601,11
2022-11-16,9호선,고속터미널,13501,17269,30770,11
2022-11-16,8호선,잠실(송파구청),15328,18199,33527,11
2022-11-16,7호선,가산디지털단지,48995,49011,98006,11
2022-11-16,7호선,고속터미널,16420,14197,30617,11
2022-11-16,4호선,사당,28955,24952,53907,11
2022-11-16,4호선,서울역,13150,20357,33507,11
2022-11-16,3호선,고속터미널,42202,40380,82582,11
2022-11-16,2호선,홍대입구,61386,65159,126545,11
2022-11-16,2호선,구로디지털단지,64233,64152,128385,11
2022-11-16,2호선,신림,60733,58743,119476,11
2022-11-16,2호선,사당,42091,46026,88117,11
2022-11-16,2호선,강남,83765,80933,164698,11
2022-11-16,2호선,선릉,62903,56078,118981,11
2022-11-16,2호선,잠실(송파구청),75697,75617,151314,11
2022-11-16,1호선,서울역,51174,50582,101756,11
2022-11-17,1호선,서울역,52524,52124,104648,11
2022-11-17,2호선,잠실(송파구청),78201,78361,156562,11
2022-11-17,2호선,선릉,62097,55217,117314,11
2022-11-17,2호선,강남,82969,80427,163396,11
2022-11-17,2호선,사당,42042,46036,88078,11
2022-11-17,2호선,신림,61140,60186,121326,11
2022-11-17,2호선,구로디지털단지,63672,63534,127206,11
2022-11-17,2호선,홍대입구,64777,68706,133483,11
2022-11-17,3호선,고속터미널,43876,42693,86569,11
2022-11-17,4호선,서울역,13140,21472,34612,11
2022-11-17,4호선,사당,28750,24435,53185,11
2022-11-17,7호선,고속터미널,16888,14155,31043,11
2022-11-17,7호선,가산디지털단지,48174,48382,96556,11
2022-11-17,8호선,잠실(송파구청),15716,18392,34108,11
2022-11-17,9호선,고속터미널,14169,18216,32385,11
2022-11-17,경부선,서울역,7951,2598,10549,11
2022-11-17,경부선,가산디지털단지,19777,22751,42528,11
2022-11-17,경의선,서울역,5244,6684,11928,11
2022-11-17,경의선,홍대입구,2082,2471,4553,11
2022-11-17,공항철도 1호선,서울역,11212,9917,21129,11
2022-11-17,공항철도 1호선,홍대입구,12304,12463,24767,11
2022-11-17,분당선,선릉,14735,22426,37161,11
2022-11-17,신림선,신림,1605,2148,3753,11
2022-11-18,1호선,서울역,59914,59000,118914,11
2022-11-18,신림선,신림,1543,2367,3910,11
2022-11-18,분당선,선릉,14365,21906,36271,11
2022-11-18,공항철도 1호선,홍대입구,13444,14154,27598,11
2022-11-18,공항철도 1호선,서울역,13478,12363,25841,11
2022-11-18,경의선,홍대입구,2179,2873,5052,11
2022-11-18,경의선,서울역,5356,7068,12424,11
2022-11-18,경부선,가산디지털단지,19358,22188,41546,11
2022-11-18,경부선,서울역,11372,3793,15165,11
2022-11-18,9호선,고속터미널,16505,23023,39528,11
2022-11-18,8호선,잠실(송파구청),16774,19659,36433,11
2022-11-18,7호선,가산디지털단지,47491,47145,94636,11
2022-11-18,7호선,고속터미널,20642,16232,36874,11
2022-11-18,4호선,사당,30936,26932,57868,11
2022-11-18,4호선,서울역,13749,24601,38350,11
2022-11-18,3호선,고속터미널,54133,56241,110374,11
2022-11-18,2호선,홍대입구,70716,81493,152209,11
2022-11-18,2호선,구로디지털단지,64143,63902,128045,11
2022-11-18,2호선,신림,64419,60639,125058,11
2022-11-18,2호선,사당,44754,49738,94492,11
2022-11-18,2호선,강남,89703,88349,178052,11
2022-11-18,2호선,선릉,60902,54434,115336,11
2022-11-18,2호선,잠실(송파구청),82590,83145,165735,11
2022-11-19,1호선,서울역,52881,48650,101531,11
2022-11-19,2호선,잠실(송파구청),76022,74042,150064,11
2022-11-19,신림선,신림,1353,1734,3087,11
2022-11-19,2호선,선릉,28284,24638,52922,11
2022-11-19,2호선,강남,60075,61029,121104,11
2022-11-19,2호선,사당,37049,42756,79805,11
2022-11-19,2호선,신림,50121,48157,98278,11
2022-11-19,2호선,구로디지털단지,38581,38257,76838,11
2022-11-19,2호선,홍대입구,77828,90561,168389,11
2022-11-19,3호선,고속터미널,58131,58076,116207,11
2022-11-19,4호선,서울역,9438,21604,31042,11
2022-11-19,4호선,사당,26222,23452,49674,11
2022-11-19,7호선,고속터미널,18524,13936,32460,11
2022-11-19,7호선,가산디지털단지,16176,14456,30632,11
2022-11-19,8호선,잠실(송파구청),15403,17776,33179,11
2022-11-19,9호선,고속터미널,16054,23785,39839,11
2022-11-19,경부선,서울역,12754,3148,15902,11
2022-11-19,경부선,가산디지털단지,7525,9776,17301,11
2022-11-19,경의선,서울역,2274,2070,4344,11
2022-11-19,경의선,홍대입구,2330,3175,5505,11
2022-11-19,공항철도 1호선,서울역,13047,12172,25219,11
2022-11-19,공항철도 1호선,홍대입구,15676,16415,32091,11
2022-11-19,분당선,선릉,5819,9499,15318,11
2022-11-20,1호선,서울역,39184,37959,77143,11
2022-11-20,2호선,잠실(송파구청),57508,54629,112137,11
2022-11-20,2호선,선릉,16262,14018,30280,11
2022-11-20,2호선,강남,37499,36148,73647,11
2022-11-20,2호선,사당,25586,29010,54596,11
2022-11-20,2호선,신림,37803,37146,74949,11
2022-11-20,2호선,구로디지털단지,27629,26829,54458,11
2022-11-20,2호선,홍대입구,61635,61396,123031,11
2022-11-20,3호선,고속터미널,50145,46328,96473,11
2022-11-20,4호선,서울역,6113,17611,23724,11
2022-11-20,4호선,사당,18842,17195,36037,11
2022-11-20,7호선,고속터미널,16819,10430,27249,11
2022-11-20,7호선,가산디지털단지,12031,11066,23097,11
2022-11-20,8호선,잠실(송파구청),11500,12758,24258,11
2022-11-20,9호선,고속터미널,13801,19732,33533,11
2022-11-20,경부선,서울역,11458,2593,14051,11
2022-11-20,경부선,가산디지털단지,5322,7342,12664,11
2022-11-20,경의선,서울역,1510,1376,2886,11
2022-11-20,경의선,홍대입구,1970,2392,4362,11
2022-11-20,공항철도 1호선,서울역,12077,11079,23156,11
2022-11-20,공항철도 1호선,홍대입구,13348,12125,25473,11
2022-11-20,분당선,선릉,3508,5145,8653,11
2022-11-20,신림선,신림,1077,1529,2606,11
2022-11-21,신림선,신림,1677,2247,3924,11
2022-11-21,1호선,서울역,52397,50716,103113,11
2022-11-21,분당선,선릉,14752,22306,37058,11
2022-11-21,2호선,잠실(송파구청),72924,73355,146279,11
2022-11-21,공항철도 1호선,홍대입구,11208,11398,22606,11
2022-11-21,공항철도 1호선,서울역,10894,9626,20520,11
2022-11-21,경의선,홍대입구,1973,2271,4244,11
2022-11-21,경의선,서울역,5284,6730,12014,11
2022-11-21,경부선,가산디지털단지,19443,22849,42292,11
2022-11-21,경부선,서울역,9395,2604,11999,11
2022-11-21,9호선,고속터미널,13434,18003,31437,11
2022-11-21,8호선,잠실(송파구청),14686,16959,31645,11
2022-11-21,7호선,가산디지털단지,48263,48114,96377,11
2022-11-21,7호선,고속터미널,17742,14502,32244,11
2022-11-21,4호선,사당,27046,22823,49869,11
2022-11-21,4호선,서울역,12715,19564,32279,11
2022-11-21,3호선,고속터미널,42336,40529,82865,11
2022-11-21,2호선,홍대입구,58934,61753,120687,11
2022-11-21,2호선,구로디지털단지,61973,61838,123811,11
2022-11-21,2호선,신림,58056,56139,114195,11
2022-11-21,2호선,사당,39122,43215,82337,11
2022-11-21,2호선,강남,81922,78908,160830,11
2022-11-21,2호선,선릉,61652,55365,117017,11
2022-11-22,신림선,신림,1703,2349,4052,11
2022-11-22,공항철도 1호선,서울역,10159,8869,19028,11
2022-11-22,경의선,홍대입구,1981,2377,4358,11
2022-11-22,경의선,서울역,5326,6781,12107,11
2022-11-22,경부선,가산디지털단지,19705,22799,42504,11
2022-11-22,경부선,서울역,7278,2211,9489,11
2022-11-22,9호선,고속터미널,13285,17106,30391,11
2022-11-22,8호선,잠실(송파구청),14769,17324,32093,11
2022-11-22,7호선,가산디지털단지,48694,48971,97665,11
2022-11-22,7호선,고속터미널,16684,14341,31025,11
2022-11-22,4호선,사당,28198,23817,52015,11
2022-11-22,4호선,서울역,13276,19128,32404,11
2022-11-22,3호선,고속터미널,41673,39531,81204,11
2022-11-22,2호선,홍대입구,60527,63566,124093,11
2022-11-22,2호선,구로디지털단지,64021,63875,127896,11
2022-11-22,2호선,신림,59962,57739,117701,11
2022-11-22,2호선,사당,41505,45182,86687,11
2022-11-22,2호선,강남,84540,81768,166308,11
2022-11-22,2호선,선릉,63775,57122,120897,11
2022-11-22,2호선,잠실(송파구청),75449,76174,151623,11
2022-11-22,1호선,서울역,52251,49543,101794,11
2022-11-22,공항철도 1호선,홍대입구,11389,11508,22897,11
2022-11-22,분당선,선릉,15407,23164,38571,11
2022-11-23,공항철도 1호선,서울역,10349,9148,19497,11
2022-11-23,공항철도 1호선,홍대입구,11686,11609,23295,11
2022-11-23,분당선,선릉,15236,23071,38307,11
2022-11-23,신림선,신림,1732,2335,4067,11
2022-11-23,경의선,홍대입구,1995,2405,4400,11
2022-11-23,경의선,서울역,5243,6866,12109,11
2022-11-23,경부선,가산디지털단지,19899,22758,42657,11
2022-11-23,경부선,서울역,7461,2339,9800,11
2022-11-23,9호선,고속터미널,13550,17389,30939,11
2022-11-23,8호선,잠실(송파구청),15760,18343,34103,11
2022-11-23,7호선,가산디지털단지,48665,48943,97608,11
2022-11-23,7호선,고속터미널,16567,14312,30879,11
2022-11-23,4호선,사당,28920,24453,53373,11
2022-11-23,4호선,서울역,13443,20205,33648,11
2022-11-23,3호선,고속터미널,42316,40258,82574,11
2022-11-23,2호선,홍대입구,61996,65648,127644,11
2022-11-23,2호선,구로디지털단지,64389,64235,128624,11
2022-11-23,2호선,신림,61337,58903,120240,11
2022-11-23,2호선,사당,41831,46078,87909,11
2022-11-23,2호선,강남,85083,81840,166923,11
2022-11-23,2호선,선릉,64521,57612,122133,11
2022-11-23,2호선,잠실(송파구청),78381,78491,156872,11
2022-11-23,1호선,서울역,52196,50180,102376,11
2022-11-24,1호선,서울역,54880,52078,106958,11
2022-11-24,2호선,잠실(송파구청),79264,79091,158355,11
2022-11-24,2호선,선릉,64569,57332,121901,11
2022-11-24,2호선,강남,86436,83073,169509,11
2022-11-24,2호선,사당,42627,46531,89158,11
2022-11-24,2호선,신림,61640,59493,121133,11
2022-11-24,2호선,구로디지털단지,64619,64585,129204,11
2022-11-24,2호선,홍대입구,62529,67075,129604,11
2022-11-24,3호선,고속터미널,45488,43496,88984,11
2022-11-24,4호선,서울역,13584,21423,35007,11
2022-11-24,4호선,사당,29032,24604,53636,11
2022-11-24,7호선,고속터미널,17703,14754,32457,11
2022-11-24,7호선,가산디지털단지,48630,48655,97285,11
2022-11-24,8호선,잠실(송파구청),15651,18089,33740,11
2022-11-24,9호선,고속터미널,14403,18433,32836,11
2022-11-24,경부선,서울역,8422,2567,10989,11
2022-11-24,경부선,가산디지털단지,19770,22802,42572,11
2022-11-24,경의선,서울역,5493,7129,12622,11
2022-11-24,경의선,홍대입구,1946,2346,4292,11
2022-11-24,공항철도 1호선,서울역,11599,9308,20907,11
2022-11-24,공항철도 1호선,홍대입구,11741,12161,23902,11
2022-11-24,분당선,선릉,15248,23058,38306,11
2022-11-24,신림선,신림,1747,2348,4095,11
2022-11-25,1호선,서울역,61510,59273,120783,11
2022-11-25,2호선,잠실(송파구청),83868,84288,168156,11
2022-11-25,2호선,선릉,62606,55706,118312,11
2022-11-25,2호선,강남,90988,89390,180378,11
2022-11-25,2호선,사당,45809,51557,97366,11
2022-11-25,2호선,신림,63378,60700,124078,11
2022-11-25,2호선,구로디지털단지,64690,64243,128933,11
2022-11-25,2호선,홍대입구,69938,78976,148914,11
2022-11-25,3호선,고속터미널,54422,56710,111132,11
2022-11-25,4호선,서울역,14021,24730,38751,11
2022-11-25,4호선,사당,31891,28052,59943,11
2022-11-25,7호선,고속터미널,20901,16255,37156,11
2022-11-25,신림선,신림,1855,2390,4245,11
2022-11-25,7호선,가산디지털단지,47795,47535,95330,11
2022-11-25,8호선,잠실(송파구청),16571,19745,36316,11
2022-11-25,9호선,고속터미널,16674,23455,40129,11
2022-11-25,경부선,서울역,11602,3362,14964,11
2022-11-25,경부선,가산디지털단지,19580,22566,42146,11
2022-11-25,경의선,서울역,5260,6939,12199,11
2022-11-25,경의선,홍대입구,2138,2698,4836,11
2022-11-25,공항철도 1호선,서울역,13356,12327,25683,11
2022-11-25,공항철도 1호선,홍대입구,13510,14009,27519,11
2022-11-25,분당선,선릉,14664,22481,37145,11
2022-11-26,4호선,서울역,8239,21291,29530,11
2022-11-26,7호선,고속터미널,18189,13960,32149,11
2022-11-26,경부선,서울역,12120,3117,15237,11
2022-11-26,1호선,서울역,49419,47949,97368,11
2022-11-26,2호선,잠실(송파구청),80222,78114,158336,11
2022-11-26,2호선,선릉,28242,24732,52974,11
2022-11-26,2호선,강남,62174,62902,125076,11
2022-11-26,2호선,사당,39269,43692,82961,11
2022-11-26,2호선,신림,50448,48451,98899,11
2022-11-26,2호선,구로디지털단지,38805,38478,77283,11
2022-11-26,2호선,홍대입구,78448,88489,166937,11
2022-11-26,3호선,고속터미널,59108,59698,118806,11
2022-11-26,4호선,사당,25591,24092,49683,11
2022-11-26,7호선,가산디지털단지,16343,14689,31032,11
2022-11-26,8호선,잠실(송파구청),15842,18073,33915,11
2022-11-26,9호선,고속터미널,16378,24956,41334,11
2022-11-26,경부선,가산디지털단지,7176,10018,17194,11
2022-11-26,경의선,서울역,1764,1866,3630,11
2022-11-26,경의선,홍대입구,2128,3007,5135,11
2022-11-26,공항철도 1호선,서울역,12427,11832,24259,11
2022-11-26,공항철도 1호선,홍대입구,15060,15712,30772,11
2022-11-26,분당선,선릉,5906,9159,15065,11
2022-11-26,신림선,신림,1293,1904,3197,11
2022-11-27,1호선,서울역,37098,36697,73795,11
2022-11-27,2호선,잠실(송파구청),58247,54472,112719,11
2022-11-27,2호선,선릉,15251,12929,28180,11
2022-11-27,2호선,강남,35616,34378,69994,11
2022-11-27,2호선,사당,25399,27994,53393,11
2022-11-27,2호선,신림,37316,36425,73741,11
2022-11-27,2호선,구로디지털단지,26365,25692,52057,11
2022-11-27,2호선,홍대입구,59512,59305,118817,11
2022-11-27,3호선,고속터미널,49712,46632,96344,11
2022-11-27,4호선,서울역,5669,15971,21640,11
2022-11-27,신림선,신림,1048,1576,2624,11
2022-11-27,분당선,선릉,3112,4676,7788,11
2022-11-27,공항철도 1호선,홍대입구,12622,11289,23911,11
2022-11-27,공항철도 1호선,서울역,11331,10587,21918,11
2022-11-27,경의선,홍대입구,1916,2210,4126,11
2022-11-27,경의선,서울역,1402,1334,2736,11
2022-11-27,경부선,가산디지털단지,5293,7270,12563,11
2022-11-27,경부선,서울역,11024,2487,13511,11
2022-11-27,9호선,고속터미널,13221,19001,32222,11
2022-11-27,8호선,잠실(송파구청),11644,13177,24821,11
2022-11-27,7호선,가산디지털단지,11845,10928,22773,11
2022-11-27,7호선,고속터미널,16639,10304,26943,11
2022-11-27,4호선,사당,18647,17193,35840,11
2022-11-28,신림선,신림,1616,2269,3885,11
2022-11-28,3호선,고속터미널,42534,40796,83330,11
2022-11-28,4호선,서울역,12698,19415,32113,11
2022-11-28,2호선,홍대입구,54421,56932,111353,11
2022-11-28,2호선,구로디지털단지,60632,60635,121267,11
2022-11-28,2호선,신림,57263,55511,112774,11
2022-11-28,2호선,사당,38039,41569,79608,11
2022-11-28,2호선,강남,79398,76476,155874,11
2022-11-28,2호선,선릉,62144,54724,116868,11
2022-11-28,2호선,잠실(송파구청),71828,71072,142900,11
2022-11-28,1호선,서울역,52074,49506,101580,11
2022-11-28,4호선,사당,26433,22425,48858,11
2022-11-28,7호선,고속터미널,17532,14256,31788,11
2022-11-28,7호선,가산디지털단지,48571,47769,96340,11
2022-11-28,8호선,잠실(송파구청),15347,17007,32354,11
2022-11-28,9호선,고속터미널,13176,17518,30694,11
2022-11-28,경부선,서울역,8791,2617,11408,11
2022-11-28,경부선,가산디지털단지,18767,21838,40605,11
2022-11-28,경의선,서울역,4913,6233,11146,11
2022-11-28,경의선,홍대입구,1577,1997,3574,11
2022-11-28,공항철도 1호선,서울역,10621,9432,20053,11
2022-11-28,공항철도 1호선,홍대입구,9891,10262,20153,11
2022-11-28,분당선,선릉,15133,22432,37565,11
2022-11-29,4호선,사당,28353,24198,52551,11
2022-11-29,4호선,서울역,13207,19468,32675,11
2022-11-29,3호선,고속터미널,42063,40297,82360,11
2022-11-29,2호선,홍대입구,59423,61063,120486,11
2022-11-29,2호선,구로디지털단지,63771,63687,127458,11
2022-11-29,2호선,신림,59970,57594,117564,11
2022-11-29,2호선,사당,41212,44688,85900,11
2022-11-29,2호선,강남,83555,80083,163638,11
2022-11-29,2호선,선릉,63823,56826,120649,11
2022-11-29,2호선,잠실(송파구청),79128,79025,158153,11
2022-11-29,1호선,서울역,51236,48225,99461,11
2022-11-29,신림선,신림,1719,2386,4105,11
2022-11-29,분당선,선릉,15470,23197,38667,11
2022-11-29,공항철도 1호선,홍대입구,10415,10890,21305,11
2022-11-29,공항철도 1호선,서울역,9688,8155,17843,11
2022-11-29,경의선,홍대입구,1805,2183,3988,11
2022-11-29,경의선,서울역,4853,6415,11268,11
2022-11-29,경부선,가산디지털단지,19156,22399,41555,11
2022-11-29,경부선,서울역,7340,2216,9556,11
2022-11-29,9호선,고속터미널,12977,16783,29760,11
2022-11-29,8호선,잠실(송파구청),15529,18124,33653,11
2022-11-29,7호선,가산디지털단지,49179,48953,98132,11
2022-11-29,7호선,고속터미널,16696,14306,31002,11
2022-11-30,4호선,사당,27977,23698,51675,11
2022-11-30,4호선,서울역,13158,19023,32181,11
2022-11-30,3호선,고속터미널,41396,38893,80289,11
2022-11-30,1호선,서울역,49894,47287,97181,11
2022-11-30,2호선,잠실(송파구청),77705,77480,155185,11
2022-11-30,2호선,선릉,59660,55611,115271,11
2022-11-30,2호선,강남,72597,76810,149407,11
2022-11-30,2호선,사당,39999,42917,82916,11
2022-11-30,2호선,신림,58975,54903,113878,11
2022-11-30,2호선,구로디지털단지,60811,61376,122187,11
2022-11-30,2호선,홍대입구,57812,60375,118187,11
2022-11-30,신림선,신림,1718,2435,4153,11
2022-11-30,분당선,선릉,16237,22374,38611,11
2022-11-30,공항철도 1호선,홍대입구,10521,11035,21556,11
2022-11-30,공항철도 1호선,서울역,9835,8466,18301,11
2022-11-30,경의선,홍대입구,1702,2098,3800,11
2022-11-30,경의선,서울역,4654,6098,10752,11
2022-11-30,경부선,가산디지털단지,18149,21734,39883,11
2022-11-30,경부선,서울역,6979,2171,9150,11
2022-11-30,9호선,고속터미널,13114,16651,29765,11
2022-11-30,8호선,잠실(송파구청),15923,18784,34707,11
2022-11-30,7호선,가산디지털단지,48223,48362,96585,11
2022-11-30,7호선,고속터미널,15742,13733,29475,11
2022-12-01,신림선,신림,1640,2338,3978,12
2022-12-01,경의선,홍대입구,1746,2116,3862,12
2022-12-01,경의선,서울역,4680,5953,10633,12
2022-12-01,경부선,가산디지털단지,18541,21486,40027,12
2022-12-01,경부선,서울역,7365,2314,9679,12
2022-12-01,9호선,고속터미널,13236,16870,30106,12
2022-12-01,8호선,잠실(송파구청),15974,18655,34629,12
2022-12-01,7호선,가산디지털단지,48080,48066,96146,12
2022-12-01,7호선,고속터미널,16275,13828,30103,12
2022-12-01,4호선,사당,28276,23770,52046,12
2022-12-01,공항철도 1호선,서울역,10449,8799,19248,12
2022-12-01,공항철도 1호선,홍대입구,10713,11290,22003,12
2022-12-01,분당선,선릉,14879,22571,37450,12
2022-12-01,4호선,서울역,12983,19630,32613,12
2022-12-01,3호선,고속터미널,43141,40767,83908,12
2022-12-01,2호선,홍대입구,59070,62679,121749,12
2022-12-01,2호선,구로디지털단지,61997,61289,123286,12
2022-12-01,2호선,신림,58749,56580,115329,12
2022-12-01,2호선,사당,40102,44190,84292,12
2022-12-01,2호선,강남,81369,78715,160084,12
2022-12-01,2호선,선릉,62077,55312,117389,12
2022-12-01,2호선,잠실(송파구청),75721,76247,151968,12
2022-12-01,1호선,서울역,50274,47936,98210,12
2022-12-02,신림선,신림,1811,2456,4267,12
2022-12-02,분당선,선릉,14752,22662,37414,12
2022-12-02,공항철도 1호선,홍대입구,12456,13074,25530,12
2022-12-02,공항철도 1호선,서울역,12562,10715,23277,12
2022-12-02,경의선,홍대입구,1971,2454,4425,12
2022-12-02,경의선,서울역,4749,6155,10904,12
2022-12-02,경부선,가산디지털단지,18988,21789,40777,12
2022-12-02,경부선,서울역,9742,2962,12704,12
2022-12-02,9호선,고속터미널,15996,21734,37730,12
2022-12-02,8호선,잠실(송파구청),17144,20276,37420,12
2022-12-02,7호선,가산디지털단지,48417,47785,96202,12
2022-12-02,7호선,고속터미널,20121,15728,35849,12
2022-12-02,4호선,사당,32676,27810,60486,12
2022-12-02,4호선,서울역,13479,20935,34414,12
2022-12-02,3호선,고속터미널,54480,55103,109583,12
2022-12-02,2호선,홍대입구,65653,74125,139778,12
2022-12-02,2호선,구로디지털단지,63798,63447,127245,12
2022-12-02,2호선,신림,62254,60081,122335,12
2022-12-02,2호선,사당,45829,50143,95972,12
2022-12-02,2호선,강남,87433,85915,173348,12
2022-12-02,2호선,선릉,62688,55127,117815,12
2022-12-02,2호선,잠실(송파구청),81436,81843,163279,12
2022-12-02,1호선,서울역,56380,55408,111788,12
2022-12-03,1호선,서울역,43273,43138,86411,12
2022-12-03,2호선,잠실(송파구청),76307,74591,150898,12
2022-12-03,2호선,선릉,26869,23492,50361,12
2022-12-03,2호선,강남,60929,60698,121627,12
2022-12-03,2호선,사당,38646,43386,82032,12
2022-12-03,2호선,신림,49644,47198,96842,12
2022-12-03,2호선,구로디지털단지,37591,37204,74795,12
2022-12-03,2호선,홍대입구,74179,82462,156641,12
2022-12-03,3호선,고속터미널,58489,57572,116061,12
2022-12-03,4호선,서울역,7668,18644,26312,12
2022-12-03,4호선,사당,26159,23896,50055,12
2022-12-03,신림선,신림,1256,1650,2906,12
2022-12-03,분당선,선릉,5630,8674,14304,12
2022-12-03,공항철도 1호선,홍대입구,14191,14266,28457,12
2022-12-03,공항철도 1호선,서울역,11657,11016,22673,12
2022-12-03,경의선,홍대입구,2035,2779,4814,12
2022-12-03,경의선,서울역,1629,1659,3288,12
2022-12-03,경부선,가산디지털단지,7004,9401,16405,12
2022-12-03,경부선,서울역,10349,2770,13119,12
2022-12-03,9호선,고속터미널,15557,23330,38887,12
2022-12-03,8호선,잠실(송파구청),16122,18343,34465,12
2022-12-03,7호선,가산디지털단지,16142,14452,30594,12
2022-12-03,7호선,고속터미널,18574,13822,32396,12
2022-12-04,신림선,신림,1028,1486,2514,12
2022-12-04,분당선,선릉,3119,4652,7771,12
2022-12-04,공항철도 1호선,홍대입구,11788,10989,22777,12
2022-12-04,공항철도 1호선,서울역,10788,9972,20760,12
2022-12-04,경의선,홍대입구,1652,2171,3823,12
2022-12-04,경의선,서울역,1154,1109,2263,12
2022-12-04,경부선,가산디지털단지,4859,6969,11828,12
2022-12-04,경부선,서울역,9710,2338,12048,12
2022-12-04,9호선,고속터미널,12740,18792,31532,12
2022-12-04,8호선,잠실(송파구청),12492,13542,26034,12
2022-12-04,7호선,가산디지털단지,12253,10931,23184,12
2022-12-04,7호선,고속터미널,15169,9778,24947,12
2022-12-04,4호선,사당,17646,16336,33982,12
2022-12-04,4호선,서울역,5221,14230,19451,12
2022-12-04,3호선,고속터미널,48488,46063,94551,12
2022-12-04,2호선,홍대입구,56542,55513,112055,12
2022-12-04,2호선,구로디지털단지,25856,25364,51220,12
2022-12-04,2호선,신림,36529,35352,71881,12
2022-12-04,2호선,사당,24777,27217,51994,12
2022-12-04,2호선,강남,34183,32736,66919,12
2022-12-04,2호선,선릉,14521,12409,26930,12
2022-12-04,2호선,잠실(송파구청),56586,53147,109733,12
2022-12-04,1호선,서울역,34521,33377,67898,12
2022-12-05,2호선,잠실(송파구청),75818,75344,151162,12
2022-12-05,2호선,선릉,62024,55021,117045,12
2022-12-05,2호선,강남,81026,77629,158655,12
2022-12-05,2호선,사당,38438,41986,80424,12
2022-12-05,2호선,신림,57933,56032,113965,12
2022-12-05,2호선,구로디지털단지,61913,61678,123591,12
2022-12-05,2호선,홍대입구,57334,59687,117021,12
2022-12-05,3호선,고속터미널,43652,41361,85013,12
2022-12-05,4호선,서울역,12629,18799,31428,12
2022-12-05,4호선,사당,27009,22414,49423,12
2022-12-05,7호선,고속터미널,16773,13830,30603,12
2022-12-05,7호선,가산디지털단지,49039,48629,97668,12
2022-12-05,8호선,잠실(송파구청),15582,18487,34069,12
2022-12-05,9호선,고속터미널,13185,17343,30528,12
2022-12-05,경부선,서울역,8121,2507,10628,12
2022-12-05,경부선,가산디지털단지,18627,21969,40596,12
2022-12-05,경의선,서울역,4920,6397,11317,12
2022-12-05,경의선,홍대입구,1684,1993,3677,12
2022-12-05,공항철도 1호선,서울역,10497,9360,19857,12
2022-12-05,공항철도 1호선,홍대입구,10666,10824,21490,12
2022-12-05,분당선,선릉,14809,22433,37242,12
2022-12-05,신림선,신림,1751,2342,4093,12
2022-12-05,1호선,서울역,50578,48790,99368,12
2022-12-06,1호선,서울역,49796,48317,98113,12
2022-12-06,2호선,잠실(송파구청),78178,78341,156519,12
2022-12-06,2호선,선릉,63495,56490,119985,12
2022-12-06,2호선,강남,82634,79125,161759,12
2022-12-06,2호선,사당,41023,44414,85437,12
2022-12-06,2호선,신림,59149,57020,116169,12
2022-12-06,2호선,구로디지털단지,63176,62852,126028,12
2022-12-06,2호선,홍대입구,57865,59433,117298,12
2022-12-06,3호선,고속터미널,41932,39911,81843,12
2022-12-06,4호선,서울역,12878,18617,31495,12
2022-12-06,4호선,사당,27905,23713,51618,12
2022-12-06,7호선,고속터미널,16001,14258,30259,12
2022-12-06,7호선,가산디지털단지,49048,49146,98194,12
2022-12-06,8호선,잠실(송파구청),15600,18628,34228,12
2022-12-06,9호선,고속터미널,13141,16800,29941,12
2022-12-06,경부선,서울역,6993,2184,9177,12
2022-12-06,경부선,가산디지털단지,19127,22177,41304,12
2022-12-06,경의선,서울역,4737,5938,10675,12
2022-12-06,경의선,홍대입구,1791,2005,3796,12
2022-12-06,공항철도 1호선,서울역,9764,8636,18400,12
2022-12-06,공항철도 1호선,홍대입구,10823,10678,21501,12
2022-12-06,분당선,선릉,15422,23201,38623,12
2022-12-06,신림선,신림,1755,2334,4089,12
2022-12-07,1호선,서울역,51041,49129,100170,12
2022-12-07,2호선,잠실(송파구청),78937,79428,158365,12
2022-12-07,2호선,선릉,64374,57190,121564,12
2022-12-07,2호선,강남,83619,80040,163659,12
2022-12-07,2호선,사당,42339,46495,88834,12
2022-12-07,2호선,신림,60825,58605,119430,12
2022-12-07,2호선,구로디지털단지,64509,64379,128888,12
2022-12-07,2호선,홍대입구,60478,63347,123825,12
2022-12-07,3호선,고속터미널,43104,40476,83580,12
2022-12-07,4호선,서울역,13068,19066,32134,12
2022-12-07,4호선,사당,28968,24669,53637,12
2022-12-07,7호선,고속터미널,16195,14259,30454,12
2022-12-07,7호선,가산디지털단지,49195,49381,98576,12
2022-12-07,8호선,잠실(송파구청),16153,18926,35079,12
2022-12-07,9호선,고속터미널,13559,17172,30731,12
2022-12-07,경부선,서울역,7426,2147,9573,12
2022-12-07,경부선,가산디지털단지,19467,22583,42050,12
2022-12-07,경의선,서울역,4964,6328,11292,12
2022-12-07,경의선,홍대입구,1831,2164,3995,12
2022-12-07,공항철도 1호선,서울역,10096,8617,18713,12
2022-12-07,공항철도 1호선,홍대입구,11041,11222,22263,12
2022-12-07,분당선,선릉,15361,23229,38590,12
2022-12-07,신림선,신림,1738,2485,4223,12
2022-12-08,분당선,선릉,15396,23449,38845,12
2022-12-08,공항철도 1호선,홍대입구,11663,11860,23523,12
2022-12-08,공항철도 1호선,서울역,10903,8980,19883,12
2022-12-08,경의선,홍대입구,2035,2440,4475,12
2022-12-08,경의선,서울역,5010,6484,11494,12
2022-12-08,경부선,가산디지털단지,19850,22694,42544,12
2022-12-08,경부선,서울역,7738,2377,10115,12
2022-12-08,9호선,고속터미널,13929,17725,31654,12
2022-12-08,8호선,잠실(송파구청),16079,19344,35423,12
2022-12-08,7호선,가산디지털단지,48583,49151,97734,12
2022-12-08,7호선,고속터미널,16281,14053,30334,12
2022-12-08,2호선,강남,86079,82864,168943,12
2022-12-08,4호선,사당,29935,25698,55633,12
2022-12-08,4호선,서울역,13453,20639,34092,12
2022-12-08,3호선,고속터미널,44825,42602,87427,12
2022-12-08,2호선,홍대입구,62304,65514,127818,12
2022-12-08,2호선,구로디지털단지,64828,64330,129158,12
2022-12-08,2호선,신림,61130,58463,119593,12
2022-12-08,2호선,사당,44229,48631,92860,12
2022-12-08,2호선,선릉,65063,58250,123313,12
2022-12-08,2호선,잠실(송파구청),81636,81110,162746,12
2022-12-08,1호선,서울역,53010,51617,104627,12
2022-12-08,신림선,신림,1756,2297,4053,12
2022-12-09,분당선,선릉,14827,23087,37914,12
2022-12-09,공항철도 1호선,홍대입구,13340,14038,27378,12
2022-12-09,공항철도 1호선,서울역,13315,11927,25242,12
2022-12-09,경의선,홍대입구,2094,2701,4795,12
2022-12-09,경의선,서울역,5015,6739,11754,12
2022-12-09,경부선,가산디지털단지,19835,22683,42518,12
2022-12-09,경부선,서울역,11007,3382,14389,12
2022-12-09,7호선,고속터미널,20008,16335,36343,12
2022-12-09,7호선,가산디지털단지,48644,48227,96871,12
2022-12-09,8호선,잠실(송파구청),17317,20868,38185,12
2022-12-09,9호선,고속터미널,16112,22019,38131,12
2022-12-09,2호선,사당,47490,52689,100179,12
2022-12-09,2호선,신림,63441,61266,124707,12
2022-12-09,2호선,구로디지털단지,65576,65285,130861,12
2022-12-09,2호선,홍대입구,69556,78965,148521,12
2022-12-09,신림선,신림,1806,2489,4295,12
2022-12-09,3호선,고속터미널,53176,53472,106648,12
2022-12-09,1호선,서울역,59613,58184,117797,12
2022-12-09,2호선,잠실(송파구청),85409,85161,170570,12
2022-12-09,2호선,선릉,63225,56349,119574,12
2022-12-09,2호선,강남,90741,89844,180585,12
2022-12-09,4호선,서울역,14016,23804,37820,12
2022-12-09,4호선,사당,32205,28503,60708,12
2022-12-10,신림선,신림,1294,1847,3141,12
2022-12-10,1호선,서울역,47754,46993,94747,12
2022-12-10,2호선,잠실(송파구청),83473,80580,164053,12
2022-12-10,2호선,선릉,27993,24454,52447,12
2022-12-10,2호선,강남,62334,62517,124851,12
2022-12-10,2호선,사당,43298,47979,91277,12
2022-12-10,2호선,신림,51253,49196,100449,12
2022-12-10,2호선,구로디지털단지,40030,39280,79310,12
2022-12-10,2호선,홍대입구,78039,88179,166218,12
2022-12-10,3호선,고속터미널,60342,59009,119351,12
2022-12-10,7호선,고속터미널,18488,13840,32328,12
2022-12-10,7호선,가산디지털단지,16487,14846,31333,12
2022-12-10,8호선,잠실(송파구청),16630,19256,35886,12
2022-12-10,9호선,고속터미널,16153,23481,39634,12
2022-12-10,경부선,서울역,10952,3041,13993,12
2022-12-10,경부선,가산디지털단지,7174,9687,16861,12
2022-12-10,경의선,서울역,1745,1769,3514,12
2022-12-10,경의선,홍대입구,2234,2881,5115,12
2022-12-10,4호선,서울역,7931,19894,27825,12
2022-12-10,4호선,사당,28672,26618,55290,12
2022-12-10,공항철도 1호선,서울역,12359,11422,23781,12
2022-12-10,공항철도 1호선,홍대입구,15293,16030,31323,12
2022-12-10,분당선,선릉,5776,9128,14904,12
2022-12-11,3호선,고속터미널,48758,45841,94599,12
2022-12-11,4호선,서울역,5658,14977,20635,12
2022-12-11,4호선,사당,18975,18067,37042,12
2022-12-11,7호선,고속터미널,15216,10103,25319,12
2022-12-11,7호선,가산디지털단지,11989,11045,23034,12
2022-12-11,1호선,서울역,35831,35429,71260,12
2022-12-11,2호선,잠실(송파구청),59042,55065,114107,12
2022-12-11,2호선,선릉,15369,12858,28227,12
2022-12-11,2호선,강남,36684,34644,71328,12
2022-12-11,2호선,사당,27757,30012,57769,12
2022-12-11,2호선,신림,37752,36695,74447,12
2022-12-11,2호선,구로디지털단지,27616,26791,54407,12
2022-12-11,신림선,신림,1119,1571,2690,12
2022-12-11,경의선,서울역,1277,1241,2518,12
2022-12-11,8호선,잠실(송파구청),12488,13441,25929,12
2022-12-11,경부선,가산디지털단지,5341,7298,12639,12
2022-12-11,분당선,선릉,3238,4978,8216,12
2022-12-11,공항철도 1호선,홍대입구,12085,11091,23176,12
2022-12-11,공항철도 1호선,서울역,11544,10138,21682,12
2022-12-11,경의선,홍대입구,1794,2025,3819,12
2022-12-11,경부선,서울역,10282,2462,12744,12
2022-12-11,9호선,고속터미널,12770,18335,31105,12
2022-12-11,2호선,홍대입구,59926,58917,118843,12
2022-12-12,3호선,고속터미널,44308,42041,86349,12
2022-12-12,2호선,홍대입구,57798,59421,117219,12
2022-12-12,2호선,구로디지털단지,61890,61388,123278,12
2022-12-12,2호선,신림,58370,56383,114753,12
2022-12-12,2호선,사당,40593,43441,84034,12
2022-12-12,2호선,강남,83018,78768,161786,12
2022-12-12,2호선,선릉,62349,55418,117767,12
2022-12-12,2호선,잠실(송파구청),78496,77584,156080,12
2022-12-12,1호선,서울역,53062,50958,104020,12
2022-12-12,경부선,가산디지털단지,18913,22211,41124,12
2022-12-12,신림선,신림,1795,2406,4201,12
2022-12-12,분당선,선릉,14829,22593,37422,12
2022-12-12,7호선,고속터미널,16794,14089,30883,12
2022-12-12,7호선,가산디지털단지,49259,48341,97600,12
2022-12-12,8호선,잠실(송파구청),16263,18341,34604,12
2022-12-12,9호선,고속터미널,13419,17470,30889,12
2022-12-12,경부선,서울역,8291,2527,10818,12
2022-12-12,공항철도 1호선,홍대입구,10904,10904,21808,12
2022-12-12,공항철도 1호선,서울역,10989,9379,20368,12
2022-12-12,경의선,홍대입구,1676,2018,3694,12
2022-12-12,경의선,서울역,4881,6431,11312,12
2022-12-12,4호선,서울역,13041,19494,32535,12
2022-12-12,4호선,사당,28015,23172,51187,12
2022-12-13,8호선,잠실(송파구청),17333,19916,37249,12
2022-12-13,분당선,선릉,15681,23299,38980,12
2022-12-13,신림선,신림,1881,2508,4389,12
2022-12-13,공항철도 1호선,홍대입구,11080,11388,22468,12
2022-12-13,공항철도 1호선,서울역,10473,9105,19578,12
2022-12-13,경의선,홍대입구,1807,2220,4027,12
2022-12-13,경의선,서울역,4875,6421,11296,12
2022-12-13,경부선,가산디지털단지,19562,22838,42400,12
2022-12-13,경부선,서울역,7651,2369,10020,12
2022-12-13,9호선,고속터미널,13571,17622,31193,12
2022-12-13,1호선,서울역,53234,50857,104091,12
2022-12-13,2호선,잠실(송파구청),83919,82861,166780,12
2022-12-13,2호선,선릉,64967,57449,122416,12
2022-12-13,2호선,강남,87279,82833,170112,12
2022-12-13,2호선,사당,43568,46849,90417,12
2022-12-13,2호선,신림,61175,59243,120418,12
2022-12-13,2호선,구로디지털단지,65091,64505,129596,12
2022-12-13,2호선,홍대입구,61976,63524,125500,12
2022-12-13,3호선,고속터미널,45112,42351,87463,12
2022-12-13,4호선,서울역,13686,20075,33761,12
2022-12-13,4호선,사당,29613,25348,54961,12
2022-12-13,7호선,고속터미널,17006,14557,31563,12
2022-12-13,7호선,가산디지털단지,51338,49879,101217,12
2022-12-14,7호선,고속터미널,15924,13779,29703,12
2022-12-14,7호선,가산디지털단지,48776,48653,97429,12
2022-12-14,신림선,신림,1769,2515,4284,12
2022-12-14,8호선,잠실(송파구청),17163,19908,37071,12
2022-12-14,9호선,고속터미널,13503,17297,30800,12
2022-12-14,경부선,서울역,7247,2334,9581,12
2022-12-14,경부선,가산디지털단지,18532,21977,40509,12
2022-12-14,분당선,선릉,14982,22829,37811,12
2022-12-14,공항철도 1호선,홍대입구,10968,11334,22302,12
2022-12-14,공항철도 1호선,서울역,10551,8965,19516,12
2022-12-14,4호선,사당,28857,24422,53279,12
2022-12-14,4호선,서울역,13090,20113,33203,12
2022-12-14,3호선,고속터미널,43460,41017,84477,12
2022-12-14,2호선,홍대입구,61065,63516,124581,12
2022-12-14,2호선,구로디지털단지,62422,62617,125039,12
2022-12-14,2호선,신림,60558,58344,118902,12
2022-12-14,2호선,사당,42217,45942,88159,12
2022-12-14,2호선,강남,84487,80771,165258,12
2022-12-14,2호선,선릉,63470,56534,120004,12
2022-12-14,2호선,잠실(송파구청),84861,84899,169760,12
2022-12-14,1호선,서울역,51393,49508,100901,12
2022-12-14,경의선,서울역,4532,5928,10460,12
2022-12-14,경의선,홍대입구,1804,2072,3876,12
2022-12-15,8호선,잠실(송파구청),18501,21633,40134,12
2022-12-15,7호선,가산디지털단지,50199,49248,99447,12
2022-12-15,7호선,고속터미널,17758,14998,32756,12
2022-12-15,4호선,사당,29911,26088,55999,12
2022-12-15,4호선,서울역,13782,21639,35421,12
2022-12-15,3호선,고속터미널,46599,43697,90296,12
2022-12-15,2호선,홍대입구,63710,67152,130862,12
2022-12-15,2호선,구로디지털단지,65062,65105,130167,12
2022-12-15,2호선,신림,61561,60035,121596,12
2022-12-15,2호선,사당,44799,48542,93341,12
2022-12-15,2호선,강남,88071,83672,171743,12
2022-12-15,2호선,선릉,66218,58292,124510,12
2022-12-15,2호선,잠실(송파구청),86526,86382,172908,12
2022-12-15,1호선,서울역,55622,53440,109062,12
2022-12-15,신림선,신림,1793,2489,4282,12
2022-12-15,분당선,선릉,15881,23844,39725,12
2022-12-15,공항철도 1호선,홍대입구,11528,12083,23611,12
2022-12-15,공항철도 1호선,서울역,11607,10076,21683,12
2022-12-15,경의선,홍대입구,1864,2243,4107,12
2022-12-15,경의선,서울역,4786,6357,11143,12
2022-12-15,경부선,가산디지털단지,19485,22649,42134,12
2022-12-15,경부선,서울역,8767,2655,11422,12
2022-12-15,9호선,고속터미널,13763,18014,31777,12
2022-12-16,2호선,신림,64017,61947,125964,12
2022-12-16,2호선,구로디지털단지,65874,65611,131485,12
2022-12-16,2호선,홍대입구,72345,81703,154048,12
2022-12-16,3호선,고속터미널,56414,56160,112574,12
2022-12-16,4호선,서울역,13548,24453,38001,12
2022-12-16,4호선,사당,32540,28551,61091,12
2022-12-16,2호선,사당,48516,53693,102209,12
2022-12-16,2호선,강남,93738,92254,185992,12
2022-12-16,2호선,선릉,62983,56532,119515,12
2022-12-16,2호선,잠실(송파구청),94732,93866,188598,12
2022-12-16,분당선,선릉,14882,22993,37875,12
2022-12-16,공항철도 1호선,홍대입구,13198,14234,27432,12
2022-12-16,공항철도 1호선,서울역,13478,12269,25747,12
2022-12-16,경의선,홍대입구,2048,2724,4772,12
2022-12-16,경의선,서울역,4827,6449,11276,12
2022-12-16,1호선,서울역,59873,58758,118631,12
2022-12-16,7호선,고속터미널,20722,15966,36688,12
2022-12-16,7호선,가산디지털단지,48241,48096,96337,12
2022-12-16,8호선,잠실(송파구청),19362,23358,42720,12
2022-12-16,9호선,고속터미널,16434,22602,39036,12
2022-12-16,경부선,서울역,11663,3622,15285,12
2022-12-16,경부선,가산디지털단지,18655,21983,40638,12
2022-12-16,신림선,신림,1890,2551,4441,12
2022-12-17,1호선,서울역,49738,47889,97627,12
2022-12-17,2호선,잠실(송파구청),91194,88310,179504,12
2022-12-17,2호선,선릉,28644,25639,54283,12
2022-12-17,2호선,강남,67123,67304,134427,12
2022-12-17,2호선,사당,44641,47459,92100,12
2022-12-17,2호선,신림,53029,50582,103611,12
2022-12-17,2호선,구로디지털단지,40854,40127,80981,12
2022-12-17,2호선,홍대입구,83018,92537,175555,12
2022-12-17,3호선,고속터미널,63306,62062,125368,12
2022-12-17,4호선,서울역,8800,21145,29945,12
2022-12-17,4호선,사당,27743,26925,54668,12
2022-12-17,7호선,고속터미널,19320,13965,33285,12
2022-12-17,7호선,가산디지털단지,17084,15085,32169,12
2022-12-17,8호선,잠실(송파구청),19548,22252,41800,12
2022-12-17,9호선,고속터미널,16428,24465,40893,12
2022-12-17,경부선,서울역,12315,3187,15502,12
2022-12-17,경부선,가산디지털단지,7127,9599,16726,12
2022-12-17,경의선,서울역,1735,1878,3613,12
2022-12-17,경의선,홍대입구,2186,2869,5055,12
2022-12-17,공항철도 1호선,서울역,12722,12234,24956,12
2022-12-17,공항철도 1호선,홍대입구,15841,16630,32471,12
2022-12-17,분당선,선릉,6103,9663,15766,12
2022-12-17,신림선,신림,1399,1943,3342,12
2022-12-18,2호선,잠실(송파구청),62747,59103,121850,12
2022-12-18,2호선,선릉,15693,13251,28944,12
2022-12-18,2호선,강남,37047,35020,72067,12
2022-12-18,2호선,사당,26385,28408,54793,12
2022-12-18,2호선,신림,37348,36190,73538,12
2022-12-18,2호선,구로디지털단지,26293,26197,52490,12
2022-12-18,2호선,홍대입구,59736,58790,118526,12
2022-12-18,1호선,서울역,35939,35850,71789,12
2022-12-18,신림선,신림,1049,1494,2543,12
2022-12-18,3호선,고속터미널,50549,47113,97662,12
2022-12-18,4호선,서울역,5524,15864,21388,12
2022-12-18,4호선,사당,18155,17374,35529,12
2022-12-18,7호선,고속터미널,14358,9552,23910,12
2022-12-18,7호선,가산디지털단지,11474,10169,21643,12
2022-12-18,8호선,잠실(송파구청),14160,15342,29502,12
2022-12-18,9호선,고속터미널,12213,18100,30313,12
2022-12-18,경부선,서울역,10423,2622,13045,12
2022-12-18,경부선,가산디지털단지,4551,6611,11162,12
2022-12-18,경의선,서울역,1190,1109,2299,12
2022-12-18,경의선,홍대입구,1642,2133,3775,12
2022-12-18,공항철도 1호선,서울역,11594,10423,22017,12
2022-12-18,공항철도 1호선,홍대입구,12304,11650,23954,12
2022-12-18,분당선,선릉,3202,4817,8019,12
2022-12-19,2호선,사당,39538,43097,82635,12
2022-12-19,2호선,강남,83915,80623,164538,12
2022-12-19,2호선,선릉,61508,54534,116042,12
2022-12-19,2호선,잠실(송파구청),81136,81219,162355,12
2022-12-19,1호선,서울역,51494,48234,99728,12
2022-12-19,신림선,신림,1765,2352,4117,12
2022-12-19,분당선,선릉,14597,22175,36772,12
2022-12-19,공항철도 1호선,홍대입구,11500,11407,22907,12
2022-12-19,공항철도 1호선,서울역,11021,9385,20406,12
2022-12-19,경의선,홍대입구,1743,2100,3843,12
2022-12-19,경의선,서울역,4467,5875,10342,12
2022-12-19,경부선,가산디지털단지,18059,20468,38527,12
2022-12-19,경부선,서울역,9149,2521,11670,12
2022-12-19,9호선,고속터미널,13451,17828,31279,12
2022-12-19,8호선,잠실(송파구청),16704,18907,35611,12
2022-12-19,7호선,가산디지털단지,48258,48213,96471,12
2022-12-19,7호선,고속터미널,17181,14208,31389,12
2022-12-19,4호선,사당,26452,23041,49493,12
2022-12-19,4호선,서울역,12751,20349,33100,12
2022-12-19,3호선,고속터미널,45149,42907,88056,12
2022-12-19,2호선,홍대입구,61653,63654,125307,12
2022-12-19,2호선,구로디지털단지,61393,60855,122248,12
2022-12-19,2호선,신림,57160,55141,112301,12
2022-12-20,공항철도 1호선,서울역,10704,9326,20030,12
2022-12-20,공항철도 1호선,홍대입구,12162,12144,24306,12
2022-12-20,분당선,선릉,15550,23422,38972,12
2022-12-20,신림선,신림,1774,2370,4144,12
2022-12-20,1호선,서울역,52974,50839,103813,12
2022-12-20,2호선,잠실(송파구청),88822,88236,177058,12
2022-12-20,2호선,선릉,65754,58524,124278,12
2022-12-20,2호선,강남,89876,86168,176044,12
2022-12-20,2호선,사당,43302,47283,90585,12
2022-12-20,2호선,신림,60825,59129,119954,12
2022-12-20,2호선,구로디지털단지,64927,64712,129639,12
2022-12-20,2호선,홍대입구,67560,70830,138390,12
2022-12-20,3호선,고속터미널,47556,45012,92568,12
2022-12-20,4호선,서울역,13287,20792,34079,12
2022-12-20,4호선,사당,29091,24871,53962,12
2022-12-20,7호선,고속터미널,17335,14475,31810,12
2022-12-20,7호선,가산디지털단지,49462,49407,98869,12
2022-12-20,8호선,잠실(송파구청),17744,20937,38681,12
2022-12-20,9호선,고속터미널,14483,18497,32980,12
2022-12-20,경부선,서울역,8546,2565,11111,12
2022-12-20,경부선,가산디지털단지,19211,21913,41124,12
2022-12-20,경의선,서울역,4736,6160,10896,12
2022-12-20,경의선,홍대입구,1870,2348,4218,12
2022-12-21,4호선,서울역,14298,22923,37221,12
2022-12-21,3호선,고속터미널,47784,45093,92877,12
2022-12-21,2호선,홍대입구,68543,72697,141240,12
2022-12-21,2호선,구로디지털단지,66512,66264,132776,12
2022-12-21,2호선,신림,62173,59984,122157,12
2022-12-21,2호선,사당,43891,47969,91860,12
2022-12-21,2호선,강남,91154,87972,179126,12
2022-12-21,2호선,선릉,66594,58992,125586,12
2022-12-21,2호선,잠실(송파구청),91160,92312,183472,12
2022-12-21,1호선,서울역,56474,53942,110416,12
2022-12-21,신림선,신림,1790,2485,4275,12
2022-12-21,분당선,선릉,15841,24660,40501,12
2022-12-21,공항철도 1호선,홍대입구,12726,12989,25715,12
2022-12-21,공항철도 1호선,서울역,11860,9929,21789,12
2022-12-21,경부선,가산디지털단지,19725,23048,42773,12
2022-12-21,경부선,서울역,9517,2825,12342,12
2022-12-21,9호선,고속터미널,14838,18937,33775,12
2022-12-21,경의선,서울역,4841,6470,11311,12
2022-12-21,8호선,잠실(송파구청),19172,23010,42182,12
2022-12-21,7호선,가산디지털단지,50710,51467,102177,12
2022-12-21,7호선,고속터미널,18026,15025,33051,12
2022-12-21,경의선,홍대입구,2022,2579,4601,12
2022-12-21,4호선,사당,29115,25439,54554,12
2022-12-22,2호선,잠실(송파구청),92683,92661,185344,12
2022-12-22,1호선,서울역,57310,54458,111768,12
2022-12-22,분당선,선릉,15500,23423,38923,12
2022-12-22,공항철도 1호선,홍대입구,13304,13672,26976,12
2022-12-22,공항철도 1호선,서울역,12191,10769,22960,12
2022-12-22,신림선,신림,1912,2498,4410,12
2022-12-22,경의선,홍대입구,1907,2361,4268,12
2022-12-22,경의선,서울역,4533,6160,10693,12
2022-12-22,경부선,가산디지털단지,18821,22026,40847,12
2022-12-22,경부선,서울역,9557,2902,12459,12
2022-12-22,9호선,고속터미널,15285,20048,35333,12
2022-12-22,8호선,잠실(송파구청),19614,22908,42522,12
2022-12-22,7호선,가산디지털단지,49097,49531,98628,12
2022-12-22,7호선,고속터미널,17390,14564,31954,12
2022-12-22,4호선,사당,26587,25030,51617,12
2022-12-22,4호선,서울역,13855,23351,37206,12
2022-12-22,3호선,고속터미널,50583,47894,98477,12
2022-12-22,2호선,홍대입구,71942,76454,148396,12
2022-12-22,2호선,구로디지털단지,64899,64275,129174,12
2022-12-22,2호선,신림,61663,59182,120845,12
2022-12-22,2호선,사당,47416,48218,95634,12
2022-12-22,2호선,강남,92812,90005,182817,12
2022-12-22,2호선,선릉,65956,58637,124593,12
2022-12-23,공항철도 1호선,서울역,13324,11879,25203,12
2022-12-23,공항철도 1호선,홍대입구,13730,14500,28230,12
2022-12-23,분당선,선릉,14242,21510,35752,12
2022-12-23,신림선,신림,1802,2562,4364,12
2022-12-23,경의선,홍대입구,1924,2589,4513,12
2022-12-23,경의선,서울역,4350,6071,10421,12
2022-12-23,경부선,가산디지털단지,16957,20180,37137,12
2022-12-23,경부선,서울역,11295,3627,14922,12
2022-12-23,9호선,고속터미널,16067,23493,39560,12
2022-12-23,8호선,잠실(송파구청),19714,22878,42592,12
2022-12-23,7호선,가산디지털단지,45960,44378,90338,12
2022-12-23,7호선,고속터미널,18683,15166,33849,12
2022-12-23,4호선,사당,30126,25305,55431,12
2022-12-23,4호선,서울역,13182,23631,36813,12
2022-12-23,3호선,고속터미널,56927,55799,112726,12
2022-12-23,2호선,홍대입구,74466,82599,157065,12
2022-12-23,2호선,구로디지털단지,60686,60008,120694,12
2022-12-23,2호선,신림,61857,59183,121040,12
2022-12-23,2호선,사당,42355,47574,89929,12
2022-12-23,2호선,강남,89981,88721,178702,12
2022-12-23,2호선,선릉,60406,53097,113503,12
2022-12-23,2호선,잠실(송파구청),93015,92289,185304,12
2022-12-23,1호선,서울역,58160,56540,114700,12
2022-12-24,신림선,신림,1307,1791,3098,12
2022-12-24,분당선,선릉,4658,6922,11580,12
2022-12-24,공항철도 1호선,홍대입구,15650,15902,31552,12
2022-12-24,공항철도 1호선,서울역,11538,10784,22322,12
2022-12-24,경의선,홍대입구,2077,2894,4971,12
2022-12-24,경의선,서울역,1313,1340,2653,12
2022-12-24,경부선,가산디지털단지,5783,8189,13972,12
2022-12-24,경부선,서울역,9695,3035,12730,12
2022-12-24,9호선,고속터미널,13866,21117,34983,12
2022-12-24,8호선,잠실(송파구청),20381,22842,43223,12
2022-12-24,7호선,가산디지털단지,14471,12967,27438,12
2022-12-24,7호선,고속터미널,13977,10711,24688,12
2022-12-24,4호선,사당,21355,18567,39922,12
2022-12-24,4호선,서울역,6935,17750,24685,12
2022-12-24,3호선,고속터미널,54145,53084,107229,12
2022-12-24,2호선,홍대입구,80425,91893,172318,12
2022-12-24,2호선,구로디지털단지,35104,34871,69975,12
2022-12-24,2호선,신림,47901,46196,94097,12
2022-12-24,2호선,사당,29811,32411,62222,12
2022-12-24,2호선,강남,52596,52775,105371,12
2022-12-24,2호선,선릉,22836,19897,42733,12
2022-12-24,2호선,잠실(송파구청),90148,87317,177465,12
2022-12-24,1호선,서울역,41027,41093,82120,12
2022-12-25,신림선,신림,1042,1558,2600,12
2022-12-25,1호선,서울역,35763,34745,70508,12
2022-12-25,분당선,선릉,2631,3964,6595,12
2022-12-25,공항철도 1호선,홍대입구,14471,13843,28314,12
2022-12-25,공항철도 1호선,서울역,11585,10070,21655,12
2022-12-25,경의선,홍대입구,2107,2868,4975,12
2022-12-25,경의선,서울역,1155,1131,2286,12
2022-12-25,경부선,가산디지털단지,4787,6571,11358,12
2022-12-25,경부선,서울역,10288,2757,13045,12
2022-12-25,2호선,잠실(송파구청),80504,76681,157185,12
2022-12-25,2호선,선릉,13256,11070,24326,12
2022-12-25,2호선,강남,35990,35245,71235,12
2022-12-25,2호선,사당,22343,25266,47609,12
2022-12-25,2호선,신림,38625,37650,76275,12
2022-12-25,2호선,구로디지털단지,26439,26092,52531,12
2022-12-25,2호선,홍대입구,78282,81194,159476,12
2022-12-25,3호선,고속터미널,45197,42730,87927,12
2022-12-25,4호선,서울역,5790,15770,21560,12
2022-12-25,4호선,사당,17113,15438,32551,12
2022-12-25,7호선,고속터미널,12406,7990,20396,12
2022-12-25,7호선,가산디지털단지,11097,9891,20988,12
2022-12-25,8호선,잠실(송파구청),17041,18905,35946,12
2022-12-25,9호선,고속터미널,11527,17929,29456,12
2022-12-26,2호선,선릉,59607,52588,112195,12
2022-12-26,2호선,강남,83556,80559,164115,12
2022-12-26,2호선,사당,38025,42209,80234,12
2022-12-26,분당선,선릉,14002,21268,35270,12
2022-12-26,공항철도 1호선,홍대입구,12499,12319,24818,12
2022-12-26,공항철도 1호선,서울역,12266,10462,22728,12
2022-12-26,경의선,홍대입구,1829,2267,4096,12
2022-12-26,경의선,서울역,4555,5916,10471,12
2022-12-26,2호선,신림,57151,54808,111959,12
2022-12-26,2호선,구로디지털단지,60104,60315,120419,12
2022-12-26,2호선,홍대입구,66387,68312,134699,12
2022-12-26,3호선,고속터미널,47166,44251,91417,12
2022-12-26,4호선,서울역,11918,20286,32204,12
2022-12-26,4호선,사당,26078,22261,48339,12
2022-12-26,7호선,고속터미널,17354,13964,31318,12
2022-12-26,7호선,가산디지털단지,45869,45386,91255,12
2022-12-26,8호선,잠실(송파구청),16885,19433,36318,12
2022-12-26,9호선,고속터미널,13600,18390,31990,12
2022-12-26,경부선,서울역,9421,2967,12388,12
2022-12-26,경부선,가산디지털단지,17545,20452,37997,12
2022-12-26,신림선,신림,1717,2284,4001,12
2022-12-26,1호선,서울역,53674,50761,104435,12
2022-12-26,2호선,잠실(송파구청),82026,81866,163892,12
2022-12-27,경의선,서울역,4378,5915,10293,12
2022-12-27,경의선,홍대입구,1841,2335,4176,12
2022-12-27,공항철도 1호선,서울역,11281,9971,21252,12
2022-12-27,공항철도 1호선,홍대입구,13108,13161,26269,12
2022-12-27,분당선,선릉,14672,22642,37314,12
2022-12-27,신림선,신림,1775,2475,4250,12
2022-12-27,1호선,서울역,52705,50977,103682,12
2022-12-27,2호선,잠실(송파구청),86525,85445,171970,12
2022-12-27,2호선,선릉,63038,55955,118993,12
2022-12-27,2호선,강남,88608,85511,174119,12
2022-12-27,2호선,홍대입구,68991,72839,141830,12
2022-12-27,2호선,구로디지털단지,63494,63119,126613,12
2022-12-27,2호선,신림,59300,57090,116390,12
2022-12-27,2호선,사당,42083,46218,88301,12
2022-12-27,경부선,가산디지털단지,18223,21056,39279,12
2022-12-27,경부선,서울역,8464,2604,11068,12
2022-12-27,9호선,고속터미널,13753,18594,32347,12
2022-12-27,8호선,잠실(송파구청),17303,20128,37431,12
2022-12-27,7호선,가산디지털단지,47305,47206,94511,12
2022-12-27,7호선,고속터미널,17107,14383,31490,12
2022-12-27,4호선,사당,28002,24165,52167,12
2022-12-27,4호선,서울역,12761,21128,33889,12
2022-12-27,3호선,고속터미널,46683,44169,90852,12
2022-12-28,경부선,서울역,8791,2862,11653,12
2022-12-28,경부선,가산디지털단지,17747,20892,38639,12
2022-12-28,경의선,서울역,4436,6083,10519,12
2022-12-28,경의선,홍대입구,1925,2529,4454,12
2022-12-28,공항철도 1호선,서울역,11467,9763,21230,12
2022-12-28,공항철도 1호선,홍대입구,13194,13351,26545,12
2022-12-28,분당선,선릉,14643,22116,36759,12
2022-12-28,신림선,신림,1802,2508,4310,12
2022-12-28,9호선,고속터미널,14100,18822,32922,12
2022-12-28,8호선,잠실(송파구청),17859,20836,38695,12
2022-12-28,7호선,가산디지털단지,46736,46800,93536,12
2022-12-28,7호선,고속터미널,16763,14368,31131,12
2022-12-28,4호선,사당,28580,24546,53126,12
2022-12-28,4호선,서울역,12721,21373,34094,12
2022-12-28,3호선,고속터미널,47453,45284,92737,12
2022-12-28,2호선,홍대입구,70902,74952,145854,12
2022-12-28,2호선,구로디지털단지,62800,62918,125718,12
2022-12-28,2호선,신림,60019,57923,117942,12
2022-12-28,2호선,사당,42759,46690,89449,12
2022-12-28,2호선,강남,88892,85526,174418,12
2022-12-28,2호선,선릉,62371,55738,118109,12
2022-12-28,2호선,잠실(송파구청),87877,87032,174909,12
2022-12-28,1호선,서울역,53531,51826,105357,12
2022-12-29,3호선,고속터미널,48082,48214,96296,12
2022-12-29,분당선,선릉,13855,21128,34983,12
2022-12-29,공항철도 1호선,홍대입구,13982,14334,28316,12
2022-12-29,공항철도 1호선,서울역,11864,10206,22070,12
2022-12-29,경의선,홍대입구,2042,2617,4659,12
2022-12-29,경의선,서울역,4373,5713,10086,12
2022-12-29,경부선,가산디지털단지,17270,20242,37512,12
2022-12-29,경부선,서울역,9245,3065,12310,12
2022-12-29,9호선,고속터미널,13920,19164,33084,12
2022-12-29,8호선,잠실(송파구청),17800,20789,38589,12
2022-12-29,7호선,가산디지털단지,44264,44781,89045,12
2022-12-29,7호선,고속터미널,16803,13895,30698,12
2022-12-29,4호선,사당,27825,24395,52220,12
2022-12-29,4호선,서울역,12108,21626,33734,12
2022-12-29,1호선,서울역,52937,52354,105291,12
2022-12-29,2호선,잠실(송파구청),88054,86376,174430,12
2022-12-29,2호선,선릉,60198,53443,113641,12
2022-12-29,2호선,강남,86670,84321,170991,12
2022-12-29,2호선,사당,41645,45815,87460,12
2022-12-29,신림선,신림,1713,2362,4075,12
2022-12-29,2호선,신림,59783,56904,116687,12
2022-12-29,2호선,구로디지털단지,62330,61679,124009,12
2022-12-29,2호선,홍대입구,72405,77545,149950,12
2022-12-30,경부선,서울역,9456,3514,12970,12
2022-12-30,경부선,가산디지털단지,14913,17876,32789,12
2022-12-30,경의선,서울역,4169,5575,9744,12
2022-12-30,경의선,홍대입구,2219,2941,5160,12
2022-12-30,공항철도 1호선,서울역,12721,11793,24514,12
2022-12-30,공항철도 1호선,홍대입구,15047,15564,30611,12
2022-12-30,9호선,고속터미널,15249,23148,38397,12
2022-12-30,8호선,잠실(송파구청),18534,21654,40188,12
2022-12-30,7호선,가산디지털단지,39248,38543,77791,12
2022-12-30,7호선,고속터미널,18528,15141,33669,12
2022-12-30,4호선,사당,27149,24077,51226,12
2022-12-30,4호선,서울역,11108,21448,32556,12
2022-12-30,3호선,고속터미널,53139,58303,111442,12
2022-12-30,2호선,홍대입구,78557,86930,165487,12
2022-12-30,2호선,구로디지털단지,58852,57865,116717,12
2022-12-30,2호선,신림,61387,57944,119331,12
2022-12-30,2호선,사당,40262,44340,84602,12
2022-12-30,2호선,강남,83723,83171,166894,12
2022-12-30,2호선,선릉,52250,46636,98886,12
2022-12-30,2호선,잠실(송파구청),87390,86873,174263,12
2022-12-30,1호선,서울역,53890,54534,108424,12
2022-12-30,신림선,신림,1782,2370,4152,12
2022-12-30,분당선,선릉,11875,18108,29983,12
2022-12-31,경부선,서울역,7993,2689,10682,12
2022-12-31,8호선,잠실(송파구청),14674,17134,31808,12
2022-12-31,1호선,서울역,36443,38215,74658,12
2022-12-31,공항철도 1호선,서울역,9809,9596,19405,12
2022-12-31,공항철도 1호선,홍대입구,13251,13542,26793,12
2022-12-31,분당선,선릉,4179,5746,9925,12
2022-12-31,신림선,신림,1213,1620,2833,12
2022-12-31,2호선,잠실(송파구청),70079,70016,140095,12
2022-12-31,2호선,선릉,19436,16901,36337,12
2022-12-31,2호선,강남,46282,47782,94064,12
2022-12-31,2호선,사당,26659,29567,56226,12
2022-12-31,2호선,신림,44447,41471,85918,12
2022-12-31,2호선,구로디지털단지,32056,31437,63493,12
2022-12-31,2호선,홍대입구,67708,82213,149921,12
2022-12-31,4호선,사당,18319,16580,34899,12
2022-12-31,7호선,고속터미널,12451,10173,22624,12
2022-12-31,7호선,가산디지털단지,12945,11183,24128,12
2022-12-31,9호선,고속터미널,11920,18942,30862,12
2022-12-31,경의선,서울역,1218,1307,2525,12
2022-12-31,경의선,홍대입구,1876,2567,4443,12
2022-12-31,3호선,고속터미널,44757,48206,92963,12
2022-12-31,4호선,서울역,6142,15594,21736,12
2022-12-31,경부선,가산디지털단지,5579,7299,12878,12
2023-01-01,2호선,홍대입구,54612,48205,102817,1
2023-01-01,1호선,서울역,31924,26931,58855,1
2023-01-01,2호선,잠실(송파구청),41697,38173,79870,1
2023-01-01,2호선,선릉,9630,8387,18017,1
2023-01-01,2호선,강남,25422,23857,49279,1
2023-01-01,2호선,사당,17273,18477,35750,1
2023-01-01,2호선,신림,29161,30749,59910,1
2023-01-01,2호선,구로디지털단지,20191,21323,41514,1
2023-01-01,3호선,고속터미널,37312,28175,65487,1
2023-01-01,4호선,서울역,4436,11036,15472,1
2023-01-01,4호선,사당,12308,11527,23835,1
2023-01-01,7호선,고속터미널,12721,6267,18988,1
2023-01-01,7호선,가산디지털단지,8909,8303,17212,1
2023-01-01,8호선,잠실(송파구청),10049,10264,20313,1
2023-01-01,9호선,고속터미널,9865,11997,21862,1
2023-01-01,경부선,서울역,9930,1982,11912,1
2023-01-01,경부선,가산디지털단지,3957,6091,10048,1
2023-01-01,경의선,서울역,1024,894,1918,1
2023-01-01,경의선,홍대입구,1384,1649,3033,1
2023-01-01,공항철도 1호선,서울역,11013,8687,19700,1
2023-01-01,공항철도 1호선,홍대입구,9664,9190,18854,1
2023-01-01,분당선,선릉,2037,2883,4920,1
2023-01-01,신림선,신림,890,1327,2217,1
2023-01-02,2호선,잠실(송파구청),71411,71280,142691,1
2023-01-02,1호선,서울역,50330,44840,95170,1
2023-01-02,2호선,선릉,57510,51119,108629,1
2023-01-02,2호선,강남,82367,79312,161679,1
2023-01-02,2호선,사당,34575,38474,73049,1
2023-01-02,2호선,신림,54512,53064,107576,1
2023-01-02,2호선,구로디지털단지,59532,59060,118592,1
2023-01-02,2호선,홍대입구,58755,61451,120206,1
2023-01-02,3호선,고속터미널,42914,37929,80843,1
2023-01-02,4호선,서울역,11885,17536,29421,1
2023-01-02,4호선,사당,23627,19617,43244,1
2023-01-02,7호선,고속터미널,16987,13153,30140,1
2023-01-02,7호선,가산디지털단지,47291,46956,94247,1
2023-01-02,8호선,잠실(송파구청),15503,17563,33066,1
2023-01-02,9호선,고속터미널,12587,15587,28174,1
2023-01-02,경부선,서울역,8805,2259,11064,1
2023-01-02,경부선,가산디지털단지,17694,20710,38404,1
2023-01-02,경의선,서울역,4620,5788,10408,1
2023-01-02,경의선,홍대입구,1756,2193,3949,1
2023-01-02,공항철도 1호선,서울역,10751,8883,19634,1
2023-01-02,공항철도 1호선,홍대입구,11409,11359,22768,1
2023-01-02,분당선,선릉,13740,20779,34519,1
2023-01-02,신림선,신림,1625,2262,3887,1
2023-01-03,2호선,강남,86527,83225,169752,1
2023-01-03,2호선,선릉,61435,54267,115702,1
2023-01-03,2호선,잠실(송파구청),76191,75392,151583,1
2023-01-03,1호선,서울역,47511,44584,92095,1
2023-01-03,신림선,신림,1644,2333,3977,1
2023-01-03,분당선,선릉,14607,21624,36231,1
2023-01-03,공항철도 1호선,홍대입구,11517,11673,23190,1
2023-01-03,공항철도 1호선,서울역,9673,8018,17691,1
2023-01-03,경의선,홍대입구,1832,2227,4059,1
2023-01-03,경의선,서울역,4595,5706,10301,1
2023-01-03,경부선,가산디지털단지,18509,21531,40040,1
2023-01-03,경부선,서울역,6490,2036,8526,1
2023-01-03,9호선,고속터미널,12588,16032,28620,1
2023-01-03,8호선,잠실(송파구청),15822,18335,34157,1
2023-01-03,7호선,가산디지털단지,48684,48375,97059,1
2023-01-03,7호선,고속터미널,16313,13571,29884,1
2023-01-03,4호선,사당,25996,21543,47539,1
2023-01-03,4호선,서울역,12308,17745,30053,1
2023-01-03,3호선,고속터미널,41958,38915,80873,1
2023-01-03,2호선,홍대입구,60706,63745,124451,1
2023-01-03,2호선,구로디지털단지,62231,62166,124397,1
2023-01-03,2호선,신림,56932,55209,112141,1
2023-01-03,2호선,사당,38110,41019,79129,1
2023-01-04,2호선,잠실(송파구청),77538,76787,154325,1
2023-01-04,2호선,선릉,62688,55132,117820,1
2023-01-04,2호선,강남,87959,84343,172302,1
2023-01-04,2호선,사당,39538,43003,82541,1
2023-01-04,2호선,신림,57945,56218,114163,1
2023-01-04,2호선,구로디지털단지,63255,63026,126281,1
2023-01-04,2호선,홍대입구,62521,66112,128633,1
2023-01-04,3호선,고속터미널,41641,38979,80620,1
2023-01-04,4호선,서울역,12542,18176,30718,1
2023-01-04,4호선,사당,26396,21992,48388,1
2023-01-04,7호선,고속터미널,16529,14054,30583,1
2023-01-04,7호선,가산디지털단지,48855,48686,97541,1
2023-01-04,8호선,잠실(송파구청),16161,18746,34907,1
2023-01-04,9호선,고속터미널,12816,16410,29226,1
2023-01-04,경부선,서울역,6460,2099,8559,1
2023-01-04,경부선,가산디지털단지,18818,21919,40737,1
2023-01-04,경의선,서울역,4574,5792,10366,1
2023-01-04,경의선,홍대입구,1887,2310,4197,1
2023-01-04,공항철도 1호선,서울역,10065,8313,18378,1
2023-01-04,공항철도 1호선,홍대입구,12036,12248,24284,1
2023-01-04,분당선,선릉,14910,22514,37424,1
2023-01-04,신림선,신림,1677,2397,4074,1
2023-01-04,1호선,서울역,48352,45485,93837,1
2023-01-05,2호선,홍대입구,64146,67840,131986,1
2023-01-05,1호선,서울역,50843,47601,98444,1
2023-01-05,2호선,잠실(송파구청),79043,78243,157286,1
2023-01-05,2호선,선릉,63927,56438,120365,1
2023-01-05,2호선,강남,88972,85844,174816,1
2023-01-05,2호선,사당,41120,45073,86193,1
2023-01-05,3호선,고속터미널,43111,40709,83820,1
2023-01-05,4호선,서울역,12839,19503,32342,1
2023-01-05,4호선,사당,26902,22813,49715,1
2023-01-05,7호선,고속터미널,16751,14177,30928,1
2023-01-05,7호선,가산디지털단지,48913,48877,97790,1
2023-01-05,8호선,잠실(송파구청),16371,19207,35578,1
2023-01-05,9호선,고속터미널,13369,17161,30530,1
2023-01-05,경부선,서울역,7312,2275,9587,1
2023-01-05,경부선,가산디지털단지,19092,21934,41026,1
2023-01-05,경의선,서울역,4864,5967,10831,1
2023-01-05,경의선,홍대입구,1957,2341,4298,1
2023-01-05,공항철도 1호선,서울역,10116,8642,18758,1
2023-01-05,공항철도 1호선,홍대입구,12234,12571,24805,1
2023-01-05,분당선,선릉,15043,22793,37836,1
2023-01-05,신림선,신림,1732,2360,4092,1
2023-01-05,2호선,신림,58445,55982,114427,1
2023-01-05,2호선,구로디지털단지,63499,63296,126795,1
2023-01-06,2호선,홍대입구,71832,79396,151228,1
2023-01-06,2호선,구로디지털단지,64972,65023,129995,1
2023-01-06,2호선,신림,61972,60192,122164,1
2023-01-06,2호선,사당,43883,48031,91914,1
2023-01-06,2호선,강남,95400,93233,188633,1
2023-01-06,2호선,선릉,64266,56568,120834,1
2023-01-06,2호선,잠실(송파구청),82403,81368,163771,1
2023-01-06,1호선,서울역,56816,53589,110405,1
2023-01-06,신림선,신림,1749,2193,3942,1
2023-01-06,분당선,선릉,15100,22882,37982,1
2023-01-06,공항철도 1호선,홍대입구,13441,14331,27772,1
2023-01-06,공항철도 1호선,서울역,12331,10894,23225,1
2023-01-06,경의선,홍대입구,1968,2707,4675,1
2023-01-06,경의선,서울역,4765,6147,10912,1
2023-01-06,경부선,가산디지털단지,19217,22042,41259,1
2023-01-06,경부선,서울역,10149,2969,13118,1
2023-01-06,9호선,고속터미널,14910,20204,35114,1
2023-01-06,8호선,잠실(송파구청),17360,20109,37469,1
2023-01-06,7호선,가산디지털단지,48974,48291,97265,1
2023-01-06,7호선,고속터미널,18918,15142,34060,1
2023-01-06,4호선,사당,29570,25501,55071,1
2023-01-06,4호선,서울역,13087,21989,35076,1
2023-01-06,3호선,고속터미널,50255,49573,99828,1
2023-01-07,1호선,서울역,40036,39176,79212,1
2023-01-07,2호선,잠실(송파구청),73142,70990,144132,1
2023-01-07,2호선,선릉,25318,22320,47638,1
2023-01-07,2호선,강남,63016,63026,126042,1
2023-01-07,2호선,사당,35872,39432,75304,1
2023-01-07,2호선,신림,48319,47461,95780,1
2023-01-07,2호선,구로디지털단지,37429,36396,73825,1
2023-01-07,2호선,홍대입구,75742,85772,161514,1
2023-01-07,3호선,고속터미널,53748,51516,105264,1
2023-01-07,4호선,서울역,6588,16510,23098,1
2023-01-07,4호선,사당,23807,22070,45877,1
2023-01-07,7호선,고속터미널,16074,12405,28479,1
2023-01-07,7호선,가산디지털단지,14687,13045,27732,1
2023-01-07,8호선,잠실(송파구청),15286,17945,33231,1
2023-01-07,9호선,고속터미널,13984,20409,34393,1
2023-01-07,경부선,서울역,9706,2630,12336,1
2023-01-07,경부선,가산디지털단지,6347,8587,14934,1
2023-01-07,경의선,서울역,1440,1495,2935,1
2023-01-07,경의선,홍대입구,2153,2813,4966,1
2023-01-07,공항철도 1호선,서울역,11330,10652,21982,1
2023-01-07,공항철도 1호선,홍대입구,15139,15744,30883,1
2023-01-07,분당선,선릉,5348,8415,13763,1
2023-01-07,신림선,신림,1026,1046,2072,1
2023-01-08,1호선,서울역,31604,30308,61912,1
2023-01-08,2호선,잠실(송파구청),54259,51179,105438,1
2023-01-08,2호선,선릉,14040,11975,26015,1
2023-01-08,2호선,강남,35222,33598,68820,1
2023-01-08,2호선,사당,24608,26583,51191,1
2023-01-08,2호선,신림,36304,35982,72286,1
2023-01-08,2호선,구로디지털단지,26119,25402,51521,1
2023-01-08,2호선,홍대입구,59198,58828,118026,1
2023-01-08,신림선,신림,639,713,1352,1
2023-01-08,분당선,선릉,2972,4423,7395,1
2023-01-08,공항철도 1호선,홍대입구,12578,11617,24195,1
2023-01-08,공항철도 1호선,서울역,10337,9278,19615,1
2023-01-08,경의선,홍대입구,1803,2243,4046,1
2023-01-08,경의선,서울역,1063,1055,2118,1
2023-01-08,경부선,가산디지털단지,4816,6411,11227,1
2023-01-08,경부선,서울역,9558,2249,11807,1
2023-01-08,9호선,고속터미널,11111,16106,27217,1
2023-01-08,8호선,잠실(송파구청),11523,12842,24365,1
2023-01-08,7호선,가산디지털단지,10326,9317,19643,1
2023-01-08,7호선,고속터미널,13103,8955,22058,1
2023-01-08,4호선,사당,16893,16206,33099,1
2023-01-08,4호선,서울역,4907,12946,17853,1
2023-01-08,3호선,고속터미널,43047,41058,84105,1
2023-01-09,1호선,서울역,50596,48581,99177,1
2023-01-09,2호선,잠실(송파구청),74423,74258,148681,1
2023-01-09,2호선,선릉,63111,56111,119222,1
2023-01-09,2호선,강남,88781,85392,174173,1
2023-01-09,2호선,사당,38786,42636,81422,1
2023-01-09,2호선,신림,58447,56871,115318,1
2023-01-09,2호선,구로디지털단지,62805,62507,125312,1
2023-01-09,2호선,홍대입구,60614,62859,123473,1
2023-01-09,3호선,고속터미널,43105,40675,83780,1
2023-01-09,4호선,서울역,12663,19263,31926,1
2023-01-09,4호선,사당,26169,22206,48375,1
2023-01-09,7호선,고속터미널,17281,14199,31480,1
2023-01-09,7호선,가산디지털단지,49711,49487,99198,1
2023-01-09,8호선,잠실(송파구청),15496,17996,33492,1
2023-01-09,9호선,고속터미널,12987,17176,30163,1
2023-01-09,경부선,서울역,7899,2550,10449,1
2023-01-09,경부선,가산디지털단지,19091,22274,41365,1
2023-01-09,경의선,서울역,4801,6071,10872,1
2023-01-09,경의선,홍대입구,1827,2137,3964,1
2023-01-09,공항철도 1호선,서울역,10437,9218,19655,1
2023-01-09,공항철도 1호선,홍대입구,11780,11630,23410,1
2023-01-09,분당선,선릉,15031,22636,37667,1
2023-01-09,신림선,신림,1027,1052,2079,1
2023-01-10,신림선,신림,1138,1893,3031,1
2023-01-10,1호선,서울역,50864,48114,98978,1
2023-01-10,2호선,잠실(송파구청),79055,77900,156955,1
2023-01-10,2호선,선릉,65387,57807,123194,1
2023-01-10,2호선,강남,91736,88554,180290,1
2023-01-10,2호선,사당,41594,45442,87036,1
2023-01-10,2호선,신림,59474,57505,116979,1
2023-01-10,2호선,구로디지털단지,64505,64324,128829,1
2023-01-10,2호선,홍대입구,62395,65358,127753,1
2023-01-10,3호선,고속터미널,43327,40467,83794,1
2023-01-10,4호선,서울역,12760,19528,32288,1
2023-01-10,4호선,사당,27899,23523,51422,1
2023-01-10,7호선,고속터미널,16786,14119,30905,1
2023-01-10,7호선,가산디지털단지,49874,49788,99662,1
2023-01-10,8호선,잠실(송파구청),16138,18817,34955,1
2023-01-10,9호선,고속터미널,13210,17137,30347,1
2023-01-10,경부선,서울역,7364,2271,9635,1
2023-01-10,경부선,가산디지털단지,19595,22637,42232,1
2023-01-10,경의선,서울역,4832,6226,11058,1
2023-01-10,경의선,홍대입구,1929,2327,4256,1
2023-01-10,공항철도 1호선,서울역,10009,8896,18905,1
2023-01-10,공항철도 1호선,홍대입구,12404,12378,24782,1
2023-01-10,분당선,선릉,15431,23358,38789,1
2023-01-11,신림선,신림,1681,2346,4027,1
2023-01-11,분당선,선릉,15549,23461,39010,1
2023-01-11,공항철도 1호선,홍대입구,12492,12709,25201,1
2023-01-11,공항철도 1호선,서울역,10323,8857,19180,1
2023-01-11,1호선,서울역,51960,49633,101593,1
2023-01-11,2호선,잠실(송파구청),81384,80405,161789,1
2023-01-11,2호선,선릉,65464,58000,123464,1
2023-01-11,2호선,강남,92109,88644,180753,1
2023-01-11,2호선,사당,42090,46285,88375,1
2023-01-11,2호선,신림,60452,58021,118473,1
2023-01-11,2호선,구로디지털단지,64682,64589,129271,1
2023-01-11,2호선,홍대입구,63809,67613,131422,1
2023-01-11,경의선,홍대입구,1985,2426,4411,1
2023-01-11,경의선,서울역,4807,6214,11021,1
2023-01-11,경부선,가산디지털단지,19232,22243,41475,1
2023-01-11,경부선,서울역,7694,2375,10069,1
2023-01-11,9호선,고속터미널,13727,17421,31148,1
2023-01-11,8호선,잠실(송파구청),16142,18833,34975,1
2023-01-11,7호선,가산디지털단지,49860,49873,99733,1
2023-01-11,7호선,고속터미널,16829,14292,31121,1
2023-01-11,4호선,사당,28380,23872,52252,1
2023-01-11,4호선,서울역,12962,20382,33344,1
2023-01-11,3호선,고속터미널,43313,41024,84337,1
2023-01-12,2호선,홍대입구,65039,68878,133917,1
2023-01-12,2호선,구로디지털단지,65434,65406,130840,1
2023-01-12,2호선,신림,60169,58394,118563,1
2023-01-12,2호선,사당,43042,47771,90813,1
2023-01-12,2호선,강남,92599,89578,182177,1
2023-01-12,2호선,선릉,65659,58231,123890,1
2023-01-12,2호선,잠실(송파구청),81607,80943,162550,1
2023-01-12,신림선,신림,1804,2387,4191,1
2023-01-12,분당선,선릉,15324,23221,38545,1
2023-01-12,공항철도 1호선,홍대입구,12946,12964,25910,1
2023-01-12,공항철도 1호선,서울역,11246,9313,20559,1
2023-01-12,1호선,서울역,53634,50131,103765,1
2023-01-12,경의선,홍대입구,1952,2454,4406,1
2023-01-12,경의선,서울역,4826,6233,11059,1
2023-01-12,경부선,가산디지털단지,19527,22722,42249,1
2023-01-12,경부선,서울역,8132,2411,10543,1
2023-01-12,9호선,고속터미널,13908,18203,32111,1
2023-01-12,8호선,잠실(송파구청),16008,18748,34756,1
2023-01-12,7호선,가산디지털단지,49165,49720,98885,1
2023-01-12,7호선,고속터미널,17074,14580,31654,1
2023-01-12,4호선,사당,28609,24503,53112,1
2023-01-12,4호선,서울역,13018,20739,33757,1
2023-01-12,3호선,고속터미널,44749,42188,86937,1
2023-01-13,경의선,서울역,4619,6118,10737,1
2023-01-13,신림선,신림,1674,2467,4141,1
2023-01-13,경의선,홍대입구,1962,2468,4430,1
2023-01-13,공항철도 1호선,서울역,12860,11826,24686,1
2023-01-13,공항철도 1호선,홍대입구,13082,13997,27079,1
2023-01-13,분당선,선릉,15330,22924,38254,1
2023-01-13,1호선,서울역,57750,53984,111734,1
2023-01-13,2호선,잠실(송파구청),79171,79411,158582,1
2023-01-13,2호선,선릉,63076,56140,119216,1
2023-01-13,2호선,강남,95310,94536,189846,1
2023-01-13,2호선,사당,44347,49454,93801,1
2023-01-13,2호선,신림,60909,58963,119872,1
2023-01-13,2호선,구로디지털단지,64423,64545,128968,1
2023-01-13,2호선,홍대입구,66278,74786,141064,1
2023-01-13,3호선,고속터미널,50314,49668,99982,1
2023-01-13,4호선,서울역,13168,22734,35902,1
2023-01-13,4호선,사당,29403,26019,55422,1
2023-01-13,7호선,고속터미널,19019,14920,33939,1
2023-01-13,7호선,가산디지털단지,48248,47898,96146,1
2023-01-13,8호선,잠실(송파구청),16444,19715,36159,1
2023-01-13,9호선,고속터미널,14789,20328,35117,1
2023-01-13,경부선,서울역,10459,3331,13790,1
2023-01-13,경부선,가산디지털단지,19120,22059,41179,1
2023-01-14,1호선,서울역,41248,39152,80400,1
2023-01-14,2호선,잠실(송파구청),73274,71519,144793,1
2023-01-14,2호선,선릉,26136,22966,49102,1
2023-01-14,2호선,강남,64276,64958,129234,1
2023-01-14,2호선,사당,37050,40534,77584,1
2023-01-14,2호선,신림,48671,47077,95748,1
2023-01-14,2호선,구로디지털단지,37363,36869,74232,1
2023-01-14,2호선,홍대입구,74957,84771,159728,1
2023-01-14,3호선,고속터미널,54832,52910,107742,1
2023-01-14,4호선,서울역,7038,17201,24239,1
2023-01-14,4호선,사당,24193,22288,46481,1
2023-01-14,7호선,고속터미널,16560,12518,29078,1
2023-01-14,7호선,가산디지털단지,14771,13022,27793,1
2023-01-14,8호선,잠실(송파구청),15287,18315,33602,1
2023-01-14,9호선,고속터미널,14418,20749,35167,1
2023-01-14,경부선,서울역,10036,2893,12929,1
2023-01-14,경부선,가산디지털단지,6523,8731,15254,1
2023-01-14,경의선,서울역,1321,1469,2790,1
2023-01-14,경의선,홍대입구,2108,2876,4984,1
2023-01-14,공항철도 1호선,서울역,11048,10766,21814,1
2023-01-14,공항철도 1호선,홍대입구,15167,15712,30879,1
2023-01-14,분당선,선릉,5508,8481,13989,1
2023-01-14,신림선,신림,1244,1771,3015,1
2023-01-15,8호선,잠실(송파구청),11545,13186,24731,1
2023-01-15,신림선,신림,1019,1466,2485,1
2023-01-15,분당선,선릉,2964,4632,7596,1
2023-01-15,공항철도 1호선,홍대입구,13240,12382,25622,1
2023-01-15,공항철도 1호선,서울역,10619,9956,20575,1
2023-01-15,4호선,서울역,4845,13610,18455,1
2023-01-15,3호선,고속터미널,42770,41492,84262,1
2023-01-15,2호선,홍대입구,61543,59434,120977,1
2023-01-15,2호선,구로디지털단지,26133,25431,51564,1
2023-01-15,4호선,사당,16779,16062,32841,1
2023-01-15,2호선,잠실(송파구청),53163,50530,103693,1
2023-01-15,2호선,선릉,14781,12458,27239,1
2023-01-15,2호선,강남,36480,34750,71230,1
2023-01-15,2호선,사당,23789,26220,50009,1
2023-01-15,2호선,신림,36239,35132,71371,1
2023-01-15,경의선,홍대입구,1834,2422,4256,1
2023-01-15,경의선,서울역,1190,1060,2250,1
2023-01-15,경부선,가산디지털단지,4589,6312,10901,1
2023-01-15,경부선,서울역,9470,2473,11943,1
2023-01-15,9호선,고속터미널,10684,16242,26926,1
2023-01-15,7호선,고속터미널,13044,9184,22228,1
2023-01-15,1호선,서울역,32461,31903,64364,1
2023-01-15,7호선,가산디지털단지,10046,9123,19169,1
2023-01-16,1호선,서울역,51579,50217,101796,1
2023-01-16,분당선,선릉,15414,23069,38483,1
2023-01-16,공항철도 1호선,홍대입구,12276,11994,24270,1
2023-01-16,공항철도 1호선,서울역,10436,9722,20158,1
2023-01-16,신림선,신림,1716,2320,4036,1
2023-01-16,3호선,고속터미널,43027,41365,84392,1
2023-01-16,2호선,홍대입구,61627,63803,125430,1
2023-01-16,2호선,구로디지털단지,63654,63382,127036,1
2023-01-16,2호선,신림,58494,56221,114715,1
2023-01-16,2호선,사당,39125,43111,82236,1
2023-01-16,2호선,강남,90967,87223,178190,1
2023-01-16,2호선,선릉,63990,56728,120718,1
2023-01-16,경의선,홍대입구,1821,2346,4167,1
2023-01-16,2호선,잠실(송파구청),76248,76228,152476,1
2023-01-16,경의선,서울역,4722,6147,10869,1
2023-01-16,경부선,가산디지털단지,19136,22302,41438,1
2023-01-16,경부선,서울역,7789,2630,10419,1
2023-01-16,9호선,고속터미널,13240,17258,30498,1
2023-01-16,8호선,잠실(송파구청),15955,18499,34454,1
2023-01-16,7호선,가산디지털단지,49943,49799,99742,1
2023-01-16,7호선,고속터미널,17025,14266,31291,1
2023-01-16,4호선,사당,26657,22491,49148,1
2023-01-16,4호선,서울역,12766,20789,33555,1
2023-01-17,1호선,서울역,51345,49780,101125,1
2023-01-17,2호선,잠실(송파구청),77749,77177,154926,1
2023-01-17,2호선,선릉,65178,57893,123071,1
2023-01-17,2호선,강남,91973,88713,180686,1
2023-01-17,2호선,사당,41247,45545,86792,1
2023-01-17,2호선,신림,59695,57711,117406,1
2023-01-17,2호선,구로디지털단지,65092,65049,130141,1
2023-01-17,2호선,홍대입구,61518,64302,125820,1
2023-01-17,3호선,고속터미널,43950,42329,86279,1
2023-01-17,4호선,서울역,13178,20652,33830,1
2023-01-17,4호선,사당,27605,23441,51046,1
2023-01-17,7호선,고속터미널,16908,14550,31458,1
2023-01-17,7호선,가산디지털단지,50116,49990,100106,1
2023-01-17,8호선,잠실(송파구청),15781,18365,34146,1
2023-01-17,9호선,고속터미널,13325,17596,30921,1
2023-01-17,경부선,서울역,7665,2405,10070,1
2023-01-17,경부선,가산디지털단지,19304,22382,41686,1
2023-01-17,경의선,서울역,4767,6175,10942,1
2023-01-17,경의선,홍대입구,1898,2253,4151,1
2023-01-17,공항철도 1호선,서울역,9851,9498,19349,1
2023-01-17,공항철도 1호선,홍대입구,11887,11860,23747,1
2023-01-17,분당선,선릉,15736,23413,39149,1
2023-01-17,신림선,신림,1685,2327,4012,1
2023-01-18,2호선,홍대입구,63294,66159,129453,1
2023-01-18,2호선,구로디지털단지,65454,65202,130656,1
2023-01-18,2호선,신림,60555,58026,118581,1
2023-01-18,2호선,사당,41859,45796,87655,1
2023-01-18,2호선,강남,93293,89505,182798,1
2023-01-18,2호선,선릉,66218,58552,124770,1
2023-01-18,2호선,잠실(송파구청),80265,79202,159467,1
2023-01-18,1호선,서울역,52020,53151,105171,1
2023-01-18,3호선,고속터미널,44058,44435,88493,1
2023-01-18,4호선,서울역,13507,22299,35806,1
2023-01-18,4호선,사당,28175,24025,52200,1
2023-01-18,신림선,신림,1734,2355,4089,1
2023-01-18,분당선,선릉,15792,23851,39643,1
2023-01-18,공항철도 1호선,홍대입구,12069,11930,23999,1
2023-01-18,공항철도 1호선,서울역,10261,10131,20392,1
2023-01-18,경의선,홍대입구,1878,2304,4182,1
2023-01-18,경의선,서울역,4755,6128,10883,1
2023-01-18,경부선,가산디지털단지,19410,22542,41952,1
2023-01-18,경부선,서울역,7658,2797,10455,1
2023-01-18,9호선,고속터미널,13215,18099,31314,1
2023-01-18,8호선,잠실(송파구청),16583,19300,35883,1
2023-01-18,7호선,가산디지털단지,49838,49935,99773,1
2023-01-18,7호선,고속터미널,17160,15113,32273,1
2023-01-19,경의선,서울역,4692,6294,10986,1
2023-01-19,경의선,홍대입구,1842,2223,4065,1
2023-01-19,1호선,서울역,49630,53602,103232,1
2023-01-19,2호선,잠실(송파구청),77967,76849,154816,1
2023-01-19,2호선,선릉,65045,57368,122413,1
2023-01-19,2호선,강남,92999,85963,178962,1
2023-01-19,2호선,사당,41312,45337,86649,1
2023-01-19,2호선,신림,60416,57334,117750,1
2023-01-19,2호선,구로디지털단지,65220,64683,129903,1
2023-01-19,2호선,홍대입구,61760,65046,126806,1
2023-01-19,3호선,고속터미널,44517,53127,97644,1
2023-01-19,4호선,서울역,12916,22087,35003,1
2023-01-19,4호선,사당,27896,23394,51290,1
2023-01-19,7호선,고속터미널,16931,16083,33014,1
2023-01-19,7호선,가산디지털단지,49259,49304,98563,1
2023-01-19,8호선,잠실(송파구청),16208,19057,35265,1
2023-01-19,9호선,고속터미널,13546,21500,35046,1
2023-01-19,경부선,서울역,7145,3063,10208,1
2023-01-19,경부선,가산디지털단지,19594,22522,42116,1
2023-01-19,공항철도 1호선,서울역,10217,10745,20962,1
2023-01-19,공항철도 1호선,홍대입구,12029,11874,23903,1
2023-01-19,분당선,선릉,15365,23073,38438,1
2023-01-19,신림선,신림,1741,2291,4032,1
2023-01-20,경부선,가산디지털단지,16865,19490,36355,1
2023-01-20,경부선,서울역,7310,3649,10959,1
2023-01-20,4호선,서울역,11308,22167,33475,1
2023-01-20,8호선,잠실(송파구청),16305,18920,35225,1
2023-01-20,4호선,사당,26906,22752,49658,1
2023-01-20,공항철도 1호선,서울역,10632,12177,22809,1
2023-01-20,공항철도 1호선,홍대입구,12341,12383,24724,1
2023-01-20,2호선,홍대입구,63502,69815,133317,1
2023-01-20,1호선,서울역,47266,55932,103198,1
2023-01-20,7호선,가산디지털단지,44620,42494,87114,1
2023-01-20,2호선,잠실(송파구청),73699,74297,147996,1
2023-01-20,2호선,선릉,55330,47993,103323,1
2023-01-20,2호선,강남,85829,78607,164436,1
2023-01-20,2호선,사당,37619,42126,79745,1
2023-01-20,2호선,신림,60389,53528,113917,1
2023-01-20,2호선,구로디지털단지,61673,59268,120941,1
2023-01-20,신림선,신림,1791,2294,4085,1
2023-01-20,분당선,선릉,13272,19819,33091,1
2023-01-20,경의선,홍대입구,1951,2370,4321,1
2023-01-20,경의선,서울역,3975,5743,9718,1
2023-01-20,9호선,고속터미널,13130,29077,42207,1
2023-01-20,7호선,고속터미널,16041,18625,34666,1
2023-01-20,3호선,고속터미널,46583,77555,124138,1
2023-01-21,4호선,사당,11994,10117,22111,1
2023-01-21,4호선,서울역,3803,12683,16486,1
2023-01-21,3호선,고속터미널,24885,53180,78065,1
2023-01-21,2호선,홍대입구,41941,42496,84437,1
2023-01-21,2호선,구로디지털단지,20222,17366,37588,1
2023-01-21,2호선,신림,31027,23852,54879,1
2023-01-21,2호선,사당,15073,16635,31708,1
2023-01-21,2호선,강남,26049,25505,51554,1
2023-01-21,2호선,선릉,10036,7565,17601,1
2023-01-21,2호선,잠실(송파구청),37838,37151,74989,1
2023-01-21,1호선,서울역,25756,36839,62595,1
2023-01-21,신림선,신림,796,905,1701,1
2023-01-21,분당선,선릉,2237,2764,5001,1
2023-01-21,공항철도 1호선,홍대입구,8886,8047,16933,1
2023-01-21,공항철도 1호선,서울역,8106,10566,18672,1
2023-01-21,경의선,홍대입구,1303,1490,2793,1
2023-01-21,경의선,서울역,934,1175,2109,1
2023-01-21,경부선,가산디지털단지,4580,5012,9592,1
2023-01-21,경부선,서울역,5049,2608,7657,1
2023-01-21,9호선,고속터미널,6837,20576,27413,1
2023-01-21,8호선,잠실(송파구청),8588,10081,18669,1
2023-01-21,7호선,가산디지털단지,9298,7032,16330,1
2023-01-21,7호선,고속터미널,7965,10606,18571,1
2023-01-22,신림선,신림,559,842,1401,1
2023-01-22,분당선,선릉,1175,1621,2796,1
2023-01-22,공항철도 1호선,홍대입구,5690,5823,11513,1
2023-01-22,공항철도 1호선,서울역,9695,8309,18004,1
2023-01-22,경의선,홍대입구,794,1119,1913,1
2023-01-22,경의선,서울역,969,957,1926,1
2023-01-22,경부선,가산디지털단지,3662,5047,8709,1
2023-01-22,경부선,서울역,6866,1909,8775,1
2023-01-22,9호선,고속터미널,6569,8564,15133,1
2023-01-22,8호선,잠실(송파구청),6331,7348,13679,1
2023-01-22,7호선,가산디지털단지,6723,5879,12602,1
2023-01-22,7호선,고속터미널,11626,5864,17490,1
2023-01-22,4호선,사당,8781,7690,16471,1
2023-01-22,4호선,서울역,3573,9899,13472,1
2023-01-22,3호선,고속터미널,23792,23583,47375,1
2023-01-22,2호선,홍대입구,27722,30040,57762,1
2023-01-22,2호선,구로디지털단지,14552,14550,29102,1
2023-01-22,2호선,신림,21302,21899,43201,1
2023-01-22,2호선,사당,10306,11271,21577,1
2023-01-22,2호선,강남,13415,13505,26920,1
2023-01-22,2호선,선릉,5508,4711,10219,1
2023-01-22,2호선,잠실(송파구청),31563,29910,61473,1
2023-01-22,1호선,서울역,27050,28099,55149,1
2023-01-23,2호선,잠실(송파구청),50054,46759,96813,1
2023-01-23,2호선,선릉,8290,7788,16078,1
2023-01-23,2호선,강남,23045,23702,46747,1
2023-01-23,2호선,사당,16515,18729,35244,1
2023-01-23,2호선,신림,25568,29374,54942,1
2023-01-23,2호선,구로디지털단지,19271,21035,40306,1
2023-01-23,신림선,신림,832,1323,2155,1
2023-01-23,2호선,홍대입구,45068,50806,95874,1
2023-01-23,분당선,선릉,1875,2908,4783,1
2023-01-23,3호선,고속터미널,50031,29725,79756,1
2023-01-23,공항철도 1호선,홍대입구,8894,9878,18772,1
2023-01-23,공항철도 1호선,서울역,11862,6791,18653,1
2023-01-23,경의선,홍대입구,1191,1854,3045,1
2023-01-23,경의선,서울역,1151,881,2032,1
2023-01-23,경부선,가산디지털단지,4102,6726,10828,1
2023-01-23,경부선,서울역,9610,1489,11099,1
2023-01-23,9호선,고속터미널,12025,10492,22517,1
2023-01-23,8호선,잠실(송파구청),11905,13157,25062,1
2023-01-23,7호선,가산디지털단지,9399,9040,18439,1
2023-01-23,7호선,고속터미널,19887,6167,26054,1
2023-01-23,4호선,사당,12311,11393,23704,1
2023-01-23,4호선,서울역,3831,9666,13497,1
2023-01-23,1호선,서울역,34447,25474,59921,1
2023-01-24,1호선,서울역,32663,22422,55085,1
2023-01-24,2호선,잠실(송파구청),41913,40116,82029,1
2023-01-24,2호선,선릉,10221,9425,19646,1
2023-01-24,2호선,강남,24948,24263,49211,1
2023-01-24,2호선,사당,15127,17098,32225,1
2023-01-24,2호선,신림,24239,27325,51564,1
2023-01-24,2호선,구로디지털단지,18113,19156,37269,1
2023-01-24,2호선,홍대입구,39453,38788,78241,1
2023-01-24,3호선,고속터미널,53902,30018,83920,1
2023-01-24,4호선,서울역,3195,8173,11368,1
2023-01-24,4호선,사당,10966,10611,21577,1
2023-01-24,7호선,고속터미널,20412,6167,26579,1
2023-01-24,7호선,가산디지털단지,7698,7651,15349,1
2023-01-24,8호선,잠실(송파구청),10488,11407,21895,1
2023-01-24,9호선,고속터미널,11819,10618,22437,1
2023-01-24,경부선,서울역,11372,1642,13014,1
2023-01-24,경부선,가산디지털단지,3200,5376,8576,1
2023-01-24,경의선,서울역,968,708,1676,1
2023-01-24,경의선,홍대입구,954,1570,2524,1
2023-01-24,공항철도 1호선,서울역,11268,7138,18406,1
2023-01-24,공항철도 1호선,홍대입구,8089,8274,16363,1
2023-01-24,분당선,선릉,2245,3669,5914,1
2023-01-24,신림선,신림,756,1144,1900,1
2023-01-25,신림선,신림,1524,2277,3801,1
2023-01-25,분당선,선릉,13585,20368,33953,1
2023-01-25,공항철도 1호선,홍대입구,10482,11042,21524,1
2023-01-25,공항철도 1호선,서울역,11715,8694,20409,1
2023-01-25,경의선,홍대입구,1599,2107,3706,1
2023-01-25,경의선,서울역,4244,4508,8752,1
2023-01-25,경부선,가산디지털단지,16361,19184,35545,1
2023-01-25,경부선,서울역,10270,2213,12483,1
2023-01-25,9호선,고속터미널,13125,15144,28269,1
2023-01-25,8호선,잠실(송파구청),14435,16557,30992,1
2023-01-25,7호선,가산디지털단지,44991,44427,89418,1
2023-01-25,7호선,고속터미널,19138,12325,31463,1
2023-01-25,4호선,사당,22901,19599,42500,1
2023-01-25,4호선,서울역,11299,16149,27448,1
2023-01-25,3호선,고속터미널,45915,35985,81900,1
2023-01-25,2호선,홍대입구,55461,55250,110711,1
2023-01-25,2호선,구로디지털단지,56491,56696,113187,1
2023-01-25,2호선,신림,52200,51769,103969,1
2023-01-25,2호선,사당,32860,36634,69494,1
2023-01-25,2호선,강남,78496,75246,153742,1
2023-01-25,2호선,선릉,55891,49445,105336,1
2023-01-25,2호선,잠실(송파구청),66039,65833,131872,1
2023-01-25,1호선,서울역,48780,40081,88861,1
2023-01-26,2호선,사당,39321,43590,82911,1
2023-01-26,2호선,신림,58628,56891,115519,1
2023-01-26,2호선,구로디지털단지,65086,65113,130199,1
2023-01-26,2호선,홍대입구,64566,64769,129335,1
2023-01-26,3호선,고속터미널,44462,40385,84847,1
2023-01-26,4호선,서울역,13592,20873,34465,1
2023-01-26,4호선,사당,26342,22539,48881,1
2023-01-26,7호선,고속터미널,18233,14393,32626,1
2023-01-26,7호선,가산디지털단지,51308,51862,103170,1
2023-01-26,8호선,잠실(송파구청),16509,19406,35915,1
2023-01-26,9호선,고속터미널,13720,16938,30658,1
2023-01-26,경부선,서울역,9991,2607,12598,1
2023-01-26,경부선,가산디지털단지,19513,22745,42258,1
2023-01-26,경의선,서울역,4804,5986,10790,1
2023-01-26,경의선,홍대입구,1962,2454,4416,1
2023-01-26,공항철도 1호선,서울역,11806,9418,21224,1
2023-01-26,공항철도 1호선,홍대입구,12476,13123,25599,1
2023-01-26,분당선,선릉,15398,23440,38838,1
2023-01-26,신림선,신림,1714,2465,4179,1
2023-01-26,1호선,서울역,55577,48976,104553,1
2023-01-26,2호선,잠실(송파구청),76455,77494,153949,1
2023-01-26,2호선,선릉,63916,56817,120733,1
2023-01-26,2호선,강남,90595,88024,178619,1
2023-01-27,1호선,서울역,58008,53796,111804,1
2023-01-27,2호선,잠실(송파구청),83210,82242,165452,1
2023-01-27,2호선,선릉,63959,56924,120883,1
2023-01-27,2호선,강남,96333,94974,191307,1
2023-01-27,2호선,사당,43719,48505,92224,1
2023-01-27,2호선,신림,61285,59597,120882,1
2023-01-27,2호선,구로디지털단지,65495,65775,131270,1
2023-01-27,2호선,홍대입구,69998,73160,143158,1
2023-01-27,3호선,고속터미널,51455,48777,100232,1
2023-01-27,4호선,서울역,13415,22606,36021,1
2023-01-27,4호선,사당,29386,25945,55331,1
2023-01-27,7호선,고속터미널,19649,15267,34916,1
2023-01-27,7호선,가산디지털단지,50095,49587,99682,1
2023-01-27,8호선,잠실(송파구청),17621,20699,38320,1
2023-01-27,9호선,고속터미널,14608,19875,34483,1
2023-01-27,경부선,서울역,11557,3227,14784,1
2023-01-27,경부선,가산디지털단지,18880,22027,40907,1
2023-01-27,경의선,서울역,4589,6076,10665,1
2023-01-27,경의선,홍대입구,1951,2612,4563,1
2023-01-27,공항철도 1호선,서울역,12700,10781,23481,1
2023-01-27,공항철도 1호선,홍대입구,13207,14231,27438,1
2023-01-27,분당선,선릉,15245,22962,38207,1
2023-01-27,신림선,신림,1780,2486,4266,1
2023-01-28,1호선,서울역,38435,36946,75381,1
2023-01-28,2호선,잠실(송파구청),71860,69178,141038,1
2023-01-28,2호선,선릉,24979,21935,46914,1
2023-01-28,2호선,강남,64728,64541,129269,1
2023-01-28,2호선,사당,35163,38624,73787,1
2023-01-28,2호선,신림,47121,45410,92531,1
2023-01-28,2호선,구로디지털단지,36452,35856,72308,1
2023-01-28,2호선,홍대입구,76447,85763,162210,1
2023-01-28,3호선,고속터미널,54097,50906,105003,1
2023-01-28,4호선,서울역,6470,16206,22676,1
2023-01-28,4호선,사당,23356,21297,44653,1
2023-01-28,7호선,고속터미널,16282,12281,28563,1
2023-01-28,7호선,가산디지털단지,14658,12989,27647,1
2023-01-28,8호선,잠실(송파구청),14854,17374,32228,1
2023-01-28,9호선,고속터미널,13491,19952,33443,1
2023-01-28,경부선,서울역,9811,2627,12438,1
2023-01-28,경부선,가산디지털단지,6163,8360,14523,1
2023-01-28,경의선,서울역,1294,1399,2693,1
2023-01-28,경의선,홍대입구,2141,2829,4970,1
2023-01-28,공항철도 1호선,서울역,10701,10240,20941,1
2023-01-28,공항철도 1호선,홍대입구,15652,16388,32040,1
2023-01-28,분당선,선릉,5155,8235,13390,1
2023-01-28,신림선,신림,1313,1735,3048,1
2023-01-29,신림선,신림,1175,1558,2733,1
2023-01-29,1호선,서울역,30499,29544,60043,1
2023-01-29,2호선,잠실(송파구청),54977,52721,107698,1
2023-01-29,2호선,선릉,13576,11646,25222,1
2023-01-29,2호선,강남,37152,35054,72206,1
2023-01-29,2호선,사당,23518,25974,49492,1
2023-01-29,2호선,신림,35785,34561,70346,1
2023-01-29,2호선,구로디지털단지,26000,25154,51154,1
2023-01-29,2호선,홍대입구,62002,61608,123610,1
2023-01-29,3호선,고속터미널,41471,40193,81664,1
2023-01-29,4호선,서울역,5122,13201,18323,1
2023-01-29,4호선,사당,16625,15710,32335,1
2023-01-29,7호선,고속터미널,12274,8775,21049,1
2023-01-29,7호선,가산디지털단지,10077,9094,19171,1
2023-01-29,8호선,잠실(송파구청),11825,13037,24862,1
2023-01-29,9호선,고속터미널,10511,15521,26032,1
2023-01-29,경부선,서울역,9093,2261,11354,1
2023-01-29,경부선,가산디지털단지,4546,6221,10767,1
2023-01-29,경의선,서울역,1026,955,1981,1
2023-01-29,경의선,홍대입구,1885,2255,4140,1
2023-01-29,공항철도 1호선,서울역,10231,9221,19452,1
2023-01-29,공항철도 1호선,홍대입구,13523,12789,26312,1
2023-01-29,분당선,선릉,2876,4342,7218,1
2023-01-30,1호선,서울역,50073,48595,98668,1
2023-01-30,2호선,잠실(송파구청),76109,76419,152528,1
2023-01-30,2호선,선릉,63492,56438,119930,1
2023-01-30,2호선,강남,89390,86111,175501,1
2023-01-30,2호선,사당,38584,42627,81211,1
2023-01-30,2호선,신림,57861,55769,113630,1
2023-01-30,2호선,구로디지털단지,63927,63983,127910,1
2023-01-30,2호선,홍대입구,61782,64112,125894,1
2023-01-30,3호선,고속터미널,43086,40868,83954,1
2023-01-30,4호선,서울역,12498,19332,31830,1
2023-01-30,4호선,사당,26197,22312,48509,1
2023-01-30,7호선,고속터미널,17198,14274,31472,1
2023-01-30,7호선,가산디지털단지,49927,50093,100020,1
2023-01-30,8호선,잠실(송파구청),15815,18069,33884,1
2023-01-30,9호선,고속터미널,13107,16997,30104,1
2023-01-30,경부선,서울역,8245,2647,10892,1
2023-01-30,경부선,가산디지털단지,19098,22165,41263,1
2023-01-30,경의선,서울역,5002,6218,11220,1
2023-01-30,경의선,홍대입구,1809,2315,4124,1
2023-01-30,공항철도 1호선,서울역,10326,9465,19791,1
2023-01-30,공항철도 1호선,홍대입구,12331,11972,24303,1
2023-01-30,분당선,선릉,15136,22829,37965,1
2023-01-30,신림선,신림,1698,2400,4098,1
2023-01-31,9호선,고속터미널,13372,17251,30623,1
2023-01-31,3호선,고속터미널,42694,40791,83485,1
2023-01-31,4호선,서울역,12863,19304,32167,1
2023-01-31,4호선,사당,27330,23169,50499,1
2023-01-31,7호선,고속터미널,16866,14409,31275,1
2023-01-31,7호선,가산디지털단지,49869,50247,100116,1
2023-01-31,8호선,잠실(송파구청),15854,18592,34446,1
2023-01-31,경부선,가산디지털단지,19555,22391,41946,1
2023-01-31,경부선,서울역,7701,2324,10025,1
2023-01-31,1호선,서울역,50559,47835,98394,1
2023-01-31,2호선,잠실(송파구청),78572,77606,156178,1
2023-01-31,공항철도 1호선,서울역,10085,8641,18726,1
2023-01-31,공항철도 1호선,홍대입구,12212,12106,24318,1
2023-01-31,분당선,선릉,15294,23177,38471,1
2023-01-31,신림선,신림,1765,2374,4139,1
2023-01-31,2호선,선릉,64882,57288,122170,1
2023-01-31,2호선,강남,91186,87738,178924,1
2023-01-31,2호선,사당,40236,44162,84398,1
2023-01-31,2호선,신림,59455,57368,116823,1
2023-01-31,2호선,구로디지털단지,65092,65250,130342,1
2023-01-31,2호선,홍대입구,62753,65367,128120,1
2023-01-31,경의선,홍대입구,1971,2286,4257,1
2023-01-31,경의선,서울역,4831,6073,10904,1
2023-02-01,2호선,신림,59650,57704,117354,2
2023-02-01,2호선,구로디지털단지,65381,65150,130531,2
2023-02-01,신림선,신림,1696,2499,4195,2
2023-02-01,4호선,서울역,13330,19832,33162,2
2023-02-01,4호선,사당,27418,23217,50635,2
2023-02-01,3호선,고속터미널,42891,40812,83703,2
2023-02-01,2호선,홍대입구,63760,66515,130275,2
2023-02-01,7호선,고속터미널,16702,14255,30957,2
2023-02-01,7호선,가산디지털단지,50468,50372,100840,2
2023-02-01,8호선,잠실(송파구청),16416,19015,35431,2
2023-02-01,9호선,고속터미널,13598,17445,31043,2
2023-02-01,경부선,서울역,7278,2367,9645,2
2023-02-01,경부선,가산디지털단지,19367,22573,41940,2
2023-02-01,경의선,서울역,4871,6314,11185,2
2023-02-01,경의선,홍대입구,1920,2345,4265,2
2023-02-01,공항철도 1호선,서울역,10290,8871,19161,2
2023-02-01,공항철도 1호선,홍대입구,12347,12756,25103,2
2023-02-01,분당선,선릉,15393,23356,38749,2
2023-02-01,1호선,서울역,51305,48575,99880,2
2023-02-01,2호선,잠실(송파구청),79092,78771,157863,2
2023-02-01,2호선,선릉,65776,57783,123559,2
2023-02-01,2호선,강남,91885,88788,180673,2
2023-02-01,2호선,사당,40287,44734,85021,2
2023-02-02,분당선,선릉,15364,23479,38843,2
2023-02-02,공항철도 1호선,홍대입구,12196,12504,24700,2
2023-02-02,공항철도 1호선,서울역,10572,9068,19640,2
2023-02-02,1호선,서울역,51113,49190,100303,2
2023-02-02,2호선,잠실(송파구청),80101,79421,159522,2
2023-02-02,2호선,선릉,65114,57525,122639,2
2023-02-02,2호선,강남,92986,89869,182855,2
2023-02-02,2호선,사당,41053,45358,86411,2
2023-02-02,2호선,신림,60024,57964,117988,2
2023-02-02,2호선,구로디지털단지,65340,65516,130856,2
2023-02-02,2호선,홍대입구,63285,66381,129666,2
2023-02-02,3호선,고속터미널,43883,41820,85703,2
2023-02-02,4호선,서울역,12929,20077,33006,2
2023-02-02,4호선,사당,27572,22942,50514,2
2023-02-02,7호선,고속터미널,16490,14273,30763,2
2023-02-02,7호선,가산디지털단지,50356,50366,100722,2
2023-02-02,8호선,잠실(송파구청),16302,19064,35366,2
2023-02-02,9호선,고속터미널,13605,18149,31754,2
2023-02-02,경부선,서울역,7799,2440,10239,2
2023-02-02,경부선,가산디지털단지,19379,22581,41960,2
2023-02-02,경의선,서울역,4913,6092,11005,2
2023-02-02,경의선,홍대입구,1847,2340,4187,2
2023-02-02,신림선,신림,1813,2425,4238,2
2023-02-03,2호선,선릉,64764,56986,121750,2
2023-02-03,신림선,신림,1800,2449,4249,2
2023-02-03,1호선,서울역,57970,55302,113272,2
2023-02-03,2호선,잠실(송파구청),82870,81914,164784,2
2023-02-03,2호선,강남,97528,95675,193203,2
2023-02-03,2호선,사당,44256,49595,93851,2
2023-02-03,2호선,신림,62038,60401,122439,2
2023-02-03,2호선,구로디지털단지,66563,66405,132968,2
2023-02-03,2호선,홍대입구,69781,77193,146974,2
2023-02-03,3호선,고속터미널,50602,51085,101687,2
2023-02-03,4호선,서울역,13304,22650,35954,2
2023-02-03,4호선,사당,29817,25620,55437,2
2023-02-03,7호선,고속터미널,19480,15622,35102,2
2023-02-03,7호선,가산디지털단지,50057,49556,99613,2
2023-02-03,8호선,잠실(송파구청),17107,20128,37235,2
2023-02-03,9호선,고속터미널,15023,20990,36013,2
2023-02-03,경부선,서울역,10669,3161,13830,2
2023-02-03,경부선,가산디지털단지,19791,22691,42482,2
2023-02-03,경의선,서울역,4917,6219,11136,2
2023-02-03,경의선,홍대입구,2127,2631,4758,2
2023-02-03,공항철도 1호선,서울역,12777,11497,24274,2
2023-02-03,공항철도 1호선,홍대입구,13879,14748,28627,2
2023-02-03,분당선,선릉,15198,23060,38258,2
2023-02-04,2호선,홍대입구,80530,89117,169647,2
2023-02-04,3호선,고속터미널,54951,53585,108536,2
2023-02-04,4호선,서울역,7145,17136,24281,2
2023-02-04,4호선,사당,24241,22561,46802,2
2023-02-04,7호선,고속터미널,16602,12234,28836,2
2023-02-04,7호선,가산디지털단지,15167,13379,28546,2
2023-02-04,8호선,잠실(송파구청),15617,18315,33932,2
2023-02-04,1호선,서울역,43592,41520,85112,2
2023-02-04,9호선,고속터미널,14222,21219,35441,2
2023-02-04,경부선,서울역,10269,2807,13076,2
2023-02-04,경부선,가산디지털단지,6774,8848,15622,2
2023-02-04,신림선,신림,1398,1900,3298,2
2023-02-04,2호선,구로디지털단지,38096,37567,75663,2
2023-02-04,2호선,신림,49295,47385,96680,2
2023-02-04,2호선,사당,36438,40059,76497,2
2023-02-04,2호선,강남,64223,63820,128043,2
2023-02-04,2호선,선릉,26476,23018,49494,2
2023-02-04,2호선,잠실(송파구청),76777,74255,151032,2
2023-02-04,경의선,서울역,1659,1650,3309,2
2023-02-04,경의선,홍대입구,2525,3238,5763,2
2023-02-04,분당선,선릉,5295,8629,13924,2
2023-02-04,공항철도 1호선,홍대입구,17181,17898,35079,2
2023-02-04,공항철도 1호선,서울역,11507,10996,22503,2
2023-02-05,경의선,서울역,1194,1094,2288,2
2023-02-05,1호선,서울역,32061,31122,63183,2
2023-02-05,2호선,잠실(송파구청),56390,52982,109372,2
2023-02-05,2호선,선릉,13660,11592,25252,2
2023-02-05,2호선,강남,36169,34285,70454,2
2023-02-05,2호선,사당,24610,27056,51666,2
2023-02-05,2호선,신림,36780,35760,72540,2
2023-02-05,2호선,구로디지털단지,26410,25915,52325,2
2023-02-05,2호선,홍대입구,65186,63781,128967,2
2023-02-05,3호선,고속터미널,43610,41691,85301,2
2023-02-05,4호선,서울역,4947,12960,17907,2
2023-02-05,4호선,사당,17060,16213,33273,2
2023-02-05,신림선,신림,1069,1571,2640,2
2023-02-05,공항철도 1호선,서울역,10815,9824,20639,2
2023-02-05,공항철도 1호선,홍대입구,14915,13338,28253,2
2023-02-05,분당선,선릉,2811,4324,7135,2
2023-02-05,경의선,홍대입구,2274,2825,5099,2
2023-02-05,경부선,가산디지털단지,4855,6686,11541,2
2023-02-05,경부선,서울역,9535,2340,11875,2
2023-02-05,9호선,고속터미널,11280,16204,27484,2
2023-02-05,7호선,고속터미널,13174,9134,22308,2
2023-02-05,7호선,가산디지털단지,10534,9745,20279,2
2023-02-05,8호선,잠실(송파구청),11432,12859,24291,2
2023-02-06,경의선,홍대입구,1845,2295,4140,2
2023-02-06,경의선,서울역,4920,6121,11041,2
2023-02-06,2호선,강남,89001,85330,174331,2
2023-02-06,신림선,신림,1722,2488,4210,2
2023-02-06,공항철도 1호선,서울역,10452,9321,19773,2
2023-02-06,공항철도 1호선,홍대입구,12085,11548,23633,2
2023-02-06,7호선,가산디지털단지,50359,50559,100918,2
2023-02-06,7호선,고속터미널,17414,14325,31739,2
2023-02-06,경부선,가산디지털단지,19736,22711,42447,2
2023-02-06,경부선,서울역,8037,2542,10579,2
2023-02-06,9호선,고속터미널,13257,17066,30323,2
2023-02-06,8호선,잠실(송파구청),15248,17963,33211,2
2023-02-06,4호선,사당,26080,21900,47980,2
2023-02-06,4호선,서울역,12860,19708,32568,2
2023-02-06,2호선,선릉,63510,56229,119739,2
2023-02-06,2호선,잠실(송파구청),75806,75377,151183,2
2023-02-06,1호선,서울역,51082,49338,100420,2
2023-02-06,3호선,고속터미널,43072,40894,83966,2
2023-02-06,2호선,홍대입구,60788,62854,123642,2
2023-02-06,2호선,구로디지털단지,63657,63690,127347,2
2023-02-06,2호선,신림,57839,55940,113779,2
2023-02-06,2호선,사당,38544,42878,81422,2
2023-02-06,분당선,선릉,15067,22906,37973,2
2023-02-07,4호선,서울역,13002,20057,33059,2
2023-02-07,신림선,신림,1698,2373,4071,2
2023-02-07,분당선,선릉,15587,23690,39277,2
2023-02-07,공항철도 1호선,홍대입구,12045,11805,23850,2
2023-02-07,공항철도 1호선,서울역,10117,9013,19130,2
2023-02-07,경의선,홍대입구,1859,2168,4027,2
2023-02-07,경의선,서울역,4985,6245,11230,2
2023-02-07,9호선,고속터미널,13468,17572,31040,2
2023-02-07,8호선,잠실(송파구청),16058,18591,34649,2
2023-02-07,7호선,가산디지털단지,50515,50621,101136,2
2023-02-07,7호선,고속터미널,17018,14594,31612,2
2023-02-07,4호선,사당,27729,23557,51286,2
2023-02-07,3호선,고속터미널,43680,41557,85237,2
2023-02-07,2호선,홍대입구,62742,65833,128575,2
2023-02-07,2호선,구로디지털단지,65370,65257,130627,2
2023-02-07,2호선,신림,59426,57422,116848,2
2023-02-07,2호선,사당,41079,45262,86341,2
2023-02-07,2호선,강남,92040,89033,181073,2
2023-02-07,2호선,선릉,65995,58088,124083,2
2023-02-07,2호선,잠실(송파구청),80056,79337,159393,2
2023-02-07,1호선,서울역,51806,49819,101625,2
2023-02-07,경부선,가산디지털단지,19891,22809,42700,2
2023-02-07,경부선,서울역,7397,2280,9677,2
2023-02-08,경의선,서울역,4927,6254,11181,2
2023-02-08,경의선,홍대입구,1938,2406,4344,2
2023-02-08,신림선,신림,1755,2402,4157,2
2023-02-08,분당선,선릉,15363,23534,38897,2
2023-02-08,공항철도 1호선,홍대입구,12678,12656,25334,2
2023-02-08,공항철도 1호선,서울역,10492,9307,19799,2
2023-02-08,1호선,서울역,52656,50191,102847,2
2023-02-08,2호선,잠실(송파구청),80787,79861,160648,2
2023-02-08,2호선,선릉,65942,58423,124365,2
2023-02-08,2호선,강남,92301,88323,180624,2
2023-02-08,2호선,사당,42011,45861,87872,2
2023-02-08,2호선,신림,60110,58079,118189,2
2023-02-08,2호선,구로디지털단지,65811,65384,131195,2
2023-02-08,2호선,홍대입구,64466,67168,131634,2
2023-02-08,3호선,고속터미널,43827,41913,85740,2
2023-02-08,4호선,서울역,13285,20891,34176,2
2023-02-08,4호선,사당,27778,23996,51774,2
2023-02-08,7호선,고속터미널,17016,14476,31492,2
2023-02-08,7호선,가산디지털단지,50487,50447,100934,2
2023-02-08,8호선,잠실(송파구청),16477,19292,35769,2
2023-02-08,9호선,고속터미널,13735,17965,31700,2
2023-02-08,경부선,서울역,7973,2464,10437,2
2023-02-08,경부선,가산디지털단지,19818,23075,42893,2
2023-02-09,신림선,신림,1789,2356,4145,2
2023-02-09,분당선,선릉,15181,23233,38414,2
2023-02-09,공항철도 1호선,홍대입구,12901,12680,25581,2
2023-02-09,공항철도 1호선,서울역,11002,9859,20861,2
2023-02-09,경의선,홍대입구,1909,2490,4399,2
2023-02-09,경의선,서울역,4778,6285,11063,2
2023-02-09,경부선,가산디지털단지,19957,22871,42828,2
2023-02-09,경부선,서울역,8058,2581,10639,2
2023-02-09,9호선,고속터미널,14000,18548,32548,2
2023-02-09,8호선,잠실(송파구청),16295,19117,35412,2
2023-02-09,7호선,가산디지털단지,49943,50194,100137,2
2023-02-09,7호선,고속터미널,17402,14801,32203,2
2023-02-09,4호선,사당,28127,24267,52394,2
2023-02-09,4호선,서울역,13074,20876,33950,2
2023-02-09,3호선,고속터미널,45529,43444,88973,2
2023-02-09,2호선,홍대입구,65149,68634,133783,2
2023-02-09,2호선,구로디지털단지,65931,65378,131309,2
2023-02-09,2호선,신림,60326,58163,118489,2
2023-02-09,2호선,사당,42898,46894,89792,2
2023-02-09,2호선,강남,92578,89197,181775,2
2023-02-09,2호선,선릉,65284,57788,123072,2
2023-02-09,2호선,잠실(송파구청),81515,80615,162130,2
2023-02-09,1호선,서울역,53591,51548,105139,2
2023-02-10,7호선,가산디지털단지,49459,49092,98551,2
2023-02-10,8호선,잠실(송파구청),16904,20357,37261,2
2023-02-10,9호선,고속터미널,15571,21776,37347,2
2023-02-10,경부선,서울역,10885,3498,14383,2
2023-02-10,경부선,가산디지털단지,19746,22442,42188,2
2023-02-10,7호선,고속터미널,19804,15816,35620,2
2023-02-10,3호선,고속터미널,52942,53332,106274,2
2023-02-10,2호선,홍대입구,71576,79761,151337,2
2023-02-10,경의선,서울역,4897,6499,11396,2
2023-02-10,경의선,홍대입구,2077,2651,4728,2
2023-02-10,2호선,구로디지털단지,66380,66482,132862,2
2023-02-10,2호선,신림,62596,60678,123274,2
2023-02-10,2호선,사당,45858,50301,96159,2
2023-02-10,2호선,강남,96554,94821,191375,2
2023-02-10,2호선,선릉,64004,56403,120407,2
2023-02-10,2호선,잠실(송파구청),84004,83010,167014,2
2023-02-10,1호선,서울역,59231,57121,116352,2
2023-02-10,분당선,선릉,15016,22931,37947,2
2023-02-10,공항철도 1호선,홍대입구,14280,15073,29353,2
2023-02-10,공항철도 1호선,서울역,12995,11940,24935,2
2023-02-10,신림선,신림,1836,2590,4426,2
2023-02-10,4호선,사당,31067,26263,57330,2
2023-02-10,4호선,서울역,13390,23326,36716,2
2023-02-11,4호선,사당,25666,24247,49913,2
2023-02-11,4호선,서울역,6972,17898,24870,2
2023-02-11,3호선,고속터미널,57644,56489,114133,2
2023-02-11,2호선,홍대입구,81542,92025,173567,2
2023-02-11,2호선,구로디지털단지,39949,39270,79219,2
2023-02-11,2호선,신림,50804,48394,99198,2
2023-02-11,2호선,사당,39282,43324,82606,2
2023-02-11,2호선,강남,65626,65263,130889,2
2023-02-11,2호선,선릉,26349,22944,49293,2
2023-02-11,2호선,잠실(송파구청),78992,76392,155384,2
2023-02-11,1호선,서울역,43968,43112,87080,2
2023-02-11,신림선,신림,1350,1924,3274,2
2023-02-11,분당선,선릉,5366,8662,14028,2
2023-02-11,공항철도 1호선,홍대입구,17217,17449,34666,2
2023-02-11,공항철도 1호선,서울역,12256,11526,23782,2
2023-02-11,경의선,홍대입구,2475,3321,5796,2
2023-02-11,경의선,서울역,1576,1860,3436,2
2023-02-11,경부선,가산디지털단지,7190,9347,16537,2
2023-02-11,경부선,서울역,10736,2876,13612,2
2023-02-11,9호선,고속터미널,15064,22005,37069,2
2023-02-11,8호선,잠실(송파구청),15155,18040,33195,2
2023-02-11,7호선,가산디지털단지,16005,14393,30398,2
2023-02-11,7호선,고속터미널,17354,12944,30298,2
2023-02-12,1호선,서울역,34545,33374,67919,2
2023-02-12,2호선,잠실(송파구청),59463,56402,115865,2
2023-02-12,2호선,선릉,14476,12296,26772,2
2023-02-12,2호선,강남,38122,36226,74348,2
2023-02-12,2호선,사당,25725,28500,54225,2
2023-02-12,2호선,신림,37087,36411,73498,2
2023-02-12,2호선,구로디지털단지,27633,26683,54316,2
2023-02-12,2호선,홍대입구,64657,63460,128117,2
2023-02-12,3호선,고속터미널,47263,44494,91757,2
2023-02-12,4호선,서울역,5290,14531,19821,2
2023-02-12,4호선,사당,18073,16981,35054,2
2023-02-12,7호선,고속터미널,14269,9489,23758,2
2023-02-12,7호선,가산디지털단지,11289,10293,21582,2
2023-02-12,8호선,잠실(송파구청),11829,13407,25236,2
2023-02-12,9호선,고속터미널,12066,17300,29366,2
2023-02-12,경부선,서울역,9803,2546,12349,2
2023-02-12,경부선,가산디지털단지,4964,6988,11952,2
2023-02-12,경의선,서울역,1258,1125,2383,2
2023-02-12,경의선,홍대입구,1917,2510,4427,2
2023-02-12,공항철도 1호선,서울역,11645,10384,22029,2
2023-02-12,공항철도 1호선,홍대입구,14141,12657,26798,2
2023-02-12,분당선,선릉,2820,4634,7454,2
2023-02-12,신림선,신림,1070,1537,2607,2
2023-02-13,경의선,홍대입구,1881,2155,4036,2
2023-02-13,경의선,서울역,4985,6406,11391,2
2023-02-13,경부선,가산디지털단지,19779,22762,42541,2
2023-02-13,경부선,서울역,8480,2805,11285,2
2023-02-13,2호선,잠실(송파구청),78954,79046,158000,2
2023-02-13,2호선,선릉,63927,56419,120346,2
2023-02-13,2호선,강남,89939,86675,176614,2
2023-02-13,9호선,고속터미널,13913,18175,32088,2
2023-02-13,2호선,사당,39839,43951,83790,2
2023-02-13,2호선,신림,58241,56422,114663,2
2023-02-13,2호선,구로디지털단지,63883,63680,127563,2
2023-02-13,2호선,홍대입구,62778,65106,127884,2
2023-02-13,3호선,고속터미널,46052,42993,89045,2
2023-02-13,4호선,서울역,12769,20602,33371,2
2023-02-13,4호선,사당,26752,22500,49252,2
2023-02-13,7호선,고속터미널,18217,15069,33286,2
2023-02-13,7호선,가산디지털단지,50255,50299,100554,2
2023-02-13,8호선,잠실(송파구청),15908,18412,34320,2
2023-02-13,신림선,신림,1647,2342,3989,2
2023-02-13,분당선,선릉,14882,22687,37569,2
2023-02-13,1호선,서울역,53734,51572,105306,2
2023-02-13,공항철도 1호선,홍대입구,12857,12765,25622,2
2023-02-13,공항철도 1호선,서울역,11490,10005,21495,2
2023-02-14,경의선,홍대입구,1974,2397,4371,2
2023-02-14,경의선,서울역,5005,6417,11422,2
2023-02-14,경부선,가산디지털단지,20002,23161,43163,2
2023-02-14,경부선,서울역,8255,2567,10822,2
2023-02-14,9호선,고속터미널,14140,18800,32940,2
2023-02-14,8호선,잠실(송파구청),16722,19374,36096,2
2023-02-14,7호선,가산디지털단지,51216,51217,102433,2
2023-02-14,7호선,고속터미널,17848,15311,33159,2
2023-02-14,4호선,사당,28866,24720,53586,2
2023-02-14,4호선,서울역,13372,20760,34132,2
2023-02-14,3호선,고속터미널,47060,44364,91424,2
2023-02-14,2호선,홍대입구,67338,70257,137595,2
2023-02-14,2호선,구로디지털단지,66291,66047,132338,2
2023-02-14,2호선,신림,60286,58248,118534,2
2023-02-14,2호선,사당,42887,47077,89964,2
2023-02-14,2호선,강남,93142,90183,183325,2
2023-02-14,2호선,선릉,64861,58451,123312,2
2023-02-14,2호선,잠실(송파구청),82680,82111,164791,2
2023-02-14,1호선,서울역,54584,51511,106095,2
2023-02-14,공항철도 1호선,서울역,10606,9620,20226,2
2023-02-14,공항철도 1호선,홍대입구,13691,13266,26957,2
2023-02-14,분당선,선릉,16254,23453,39707,2
2023-02-14,신림선,신림,1795,2624,4419,2
2023-02-15,1호선,서울역,55034,52714,107748,2
2023-02-15,2호선,잠실(송파구청),83351,82585,165936,2
2023-02-15,2호선,선릉,66395,58042,124437,2
2023-02-15,2호선,강남,92273,88633,180906,2
2023-02-15,2호선,사당,42990,47327,90317,2
2023-02-15,2호선,신림,60571,58776,119347,2
2023-02-15,2호선,구로디지털단지,65885,65758,131643,2
2023-02-15,2호선,홍대입구,65729,69369,135098,2
2023-02-15,3호선,고속터미널,46244,44181,90425,2
2023-02-15,4호선,서울역,13552,21681,35233,2
2023-02-15,4호선,사당,28680,24617,53297,2
2023-02-15,7호선,고속터미널,18396,15574,33970,2
2023-02-15,7호선,가산디지털단지,50499,50807,101306,2
2023-02-15,8호선,잠실(송파구청),16575,19756,36331,2
2023-02-15,9호선,고속터미널,14150,18594,32744,2
2023-02-15,경부선,서울역,9090,2600,11690,2
2023-02-15,경부선,가산디지털단지,20195,23071,43266,2
2023-02-15,경의선,서울역,5043,6358,11401,2
2023-02-15,경의선,홍대입구,1967,2451,4418,2
2023-02-15,신림선,신림,1762,2502,4264,2
2023-02-15,분당선,선릉,15592,23653,39245,2
2023-02-15,공항철도 1호선,홍대입구,13084,12717,25801,2
2023-02-15,공항철도 1호선,서울역,11226,10101,21327,2
2023-02-16,8호선,잠실(송파구청),16752,19810,36562,2
2023-02-16,7호선,가산디지털단지,49953,50416,100369,2
2023-02-16,7호선,고속터미널,18406,15401,33807,2
2023-02-16,4호선,사당,29214,25099,54313,2
2023-02-16,4호선,서울역,13443,22867,36310,2
2023-02-16,3호선,고속터미널,47378,45631,93009,2
2023-02-16,2호선,홍대입구,66527,70318,136845,2
2023-02-16,2호선,구로디지털단지,65649,65405,131054,2
2023-02-16,2호선,신림,60855,58615,119470,2
2023-02-16,2호선,사당,43338,47860,91198,2
2023-02-16,2호선,강남,92091,89538,181629,2
2023-02-16,2호선,선릉,65828,57536,123364,2
2023-02-16,2호선,잠실(송파구청),86283,85648,171931,2
2023-02-16,1호선,서울역,56855,54906,111761,2
2023-02-16,분당선,선릉,15462,23446,38908,2
2023-02-16,신림선,신림,1759,2523,4282,2
2023-02-16,공항철도 1호선,서울역,12091,10916,23007,2
2023-02-16,공항철도 1호선,홍대입구,13086,13311,26397,2
2023-02-16,경의선,홍대입구,1844,2399,4243,2
2023-02-16,경의선,서울역,4992,6500,11492,2
2023-02-16,경부선,가산디지털단지,20030,22987,43017,2
2023-02-16,경부선,서울역,9384,2820,12204,2
2023-02-16,9호선,고속터미널,14527,19479,34006,2
2023-02-17,3호선,고속터미널,54868,55887,110755,2
2023-02-17,4호선,서울역,13440,24479,37919,2
2023-02-17,4호선,사당,30554,27119,57673,2
2023-02-17,공항철도 1호선,서울역,13917,12623,26540,2
2023-02-17,공항철도 1호선,홍대입구,14610,14804,29414,2
2023-02-17,경의선,서울역,5154,6688,11842,2
2023-02-17,경의선,홍대입구,2213,2813,5026,2
2023-02-17,7호선,고속터미널,20871,16459,37330,2
2023-02-17,7호선,가산디지털단지,49147,48834,97981,2
2023-02-17,8호선,잠실(송파구청),17098,20513,37611,2
2023-02-17,분당선,선릉,15103,22735,37838,2
2023-02-17,신림선,신림,1818,2539,4357,2
2023-02-17,9호선,고속터미널,16461,23064,39525,2
2023-02-17,경부선,서울역,11944,3623,15567,2
2023-02-17,경부선,가산디지털단지,19816,22753,42569,2
2023-02-17,1호선,서울역,61262,59485,120747,2
2023-02-17,2호선,잠실(송파구청),86915,85671,172586,2
2023-02-17,2호선,선릉,63358,55956,119314,2
2023-02-17,2호선,강남,96430,94802,191232,2
2023-02-17,2호선,사당,46329,51339,97668,2
2023-02-17,2호선,신림,62607,60527,123134,2
2023-02-17,2호선,구로디지털단지,65611,65482,131093,2
2023-02-17,2호선,홍대입구,72271,81457,153728,2
2023-02-18,1호선,서울역,46562,44776,91338,2
2023-02-18,2호선,잠실(송파구청),77283,74912,152195,2
2023-02-18,2호선,선릉,26644,22918,49562,2
2023-02-18,2호선,강남,64185,64323,128508,2
2023-02-18,2호선,사당,38687,43446,82133,2
2023-02-18,2호선,신림,49968,47952,97920,2
2023-02-18,2호선,구로디지털단지,38658,37721,76379,2
2023-02-18,2호선,홍대입구,79588,89413,169001,2
2023-02-18,3호선,고속터미널,57564,56861,114425,2
2023-02-18,4호선,서울역,7425,19114,26539,2
2023-02-18,4호선,사당,25871,23964,49835,2
2023-02-18,7호선,고속터미널,17489,13016,30505,2
2023-02-18,7호선,가산디지털단지,15604,13882,29486,2
2023-02-18,8호선,잠실(송파구청),15455,18071,33526,2
2023-02-18,9호선,고속터미널,15739,23112,38851,2
2023-02-18,경부선,서울역,10947,3094,14041,2
2023-02-18,경부선,가산디지털단지,7047,9224,16271,2
2023-02-18,경의선,서울역,1695,1758,3453,2
2023-02-18,경의선,홍대입구,2345,3228,5573,2
2023-02-18,공항철도 1호선,서울역,12537,11768,24305,2
2023-02-18,공항철도 1호선,홍대입구,17148,16931,34079,2
2023-02-18,분당선,선릉,5367,8670,14037,2
2023-02-18,신림선,신림,1318,1820,3138,2
2023-02-19,경의선,서울역,1254,1202,2456,2
2023-02-19,경의선,홍대입구,2000,2467,4467,2
2023-02-19,공항철도 1호선,서울역,11919,10737,22656,2
2023-02-19,공항철도 1호선,홍대입구,14020,12848,26868,2
2023-02-19,분당선,선릉,2949,4645,7594,2
2023-02-19,신림선,신림,1177,1622,2799,2
2023-02-19,1호선,서울역,36023,35050,71073,2
2023-02-19,2호선,잠실(송파구청),60815,57439,118254,2
2023-02-19,2호선,선릉,14712,12345,27057,2
2023-02-19,2호선,강남,38501,36495,74996,2
2023-02-19,2호선,사당,25501,28053,53554,2
2023-02-19,2호선,신림,37383,36674,74057,2
2023-02-19,2호선,구로디지털단지,27353,27040,54393,2
2023-02-19,2호선,홍대입구,64778,63153,127931,2
2023-02-19,3호선,고속터미널,48532,45189,93721,2
2023-02-19,4호선,서울역,5392,15733,21125,2
2023-02-19,4호선,사당,18053,16877,34930,2
2023-02-19,7호선,고속터미널,15301,9863,25164,2
2023-02-19,7호선,가산디지털단지,11159,10172,21331,2
2023-02-19,8호선,잠실(송파구청),12311,13745,26056,2
2023-02-19,9호선,고속터미널,12692,18247,30939,2
2023-02-19,경부선,서울역,10949,2613,13562,2
2023-02-19,경부선,가산디지털단지,5120,7095,12215,2
2023-02-20,신림선,신림,1772,2468,4240,2
2023-02-20,분당선,선릉,15206,22811,38017,2
2023-02-20,1호선,서울역,55345,52650,107995,2
2023-02-20,2호선,잠실(송파구청),79520,78931,158451,2
2023-02-20,2호선,선릉,63763,56482,120245,2
2023-02-20,2호선,강남,88957,85961,174918,2
2023-02-20,2호선,사당,39736,43722,83458,2
2023-02-20,2호선,신림,58719,56871,115590,2
2023-02-20,2호선,구로디지털단지,64050,63863,127913,2
2023-02-20,2호선,홍대입구,63174,64939,128113,2
2023-02-20,3호선,고속터미널,45852,43135,88987,2
2023-02-20,4호선,서울역,12863,21357,34220,2
2023-02-20,4호선,사당,26877,23093,49970,2
2023-02-20,7호선,고속터미널,18217,14684,32901,2
2023-02-20,7호선,가산디지털단지,50057,49554,99611,2
2023-02-20,8호선,잠실(송파구청),16142,18589,34731,2
2023-02-20,9호선,고속터미널,14083,18316,32399,2
2023-02-20,경부선,서울역,9637,2895,12532,2
2023-02-20,경부선,가산디지털단지,19329,22469,41798,2
2023-02-20,경의선,서울역,5192,6581,11773,2
2023-02-20,경의선,홍대입구,1830,2347,4177,2
2023-02-20,공항철도 1호선,서울역,11928,10275,22203,2
2023-02-20,공항철도 1호선,홍대입구,12298,12273,24571,2
2023-02-21,공항철도 1호선,서울역,11088,9842,20930,2
2023-02-21,공항철도 1호선,홍대입구,12754,12864,25618,2
2023-02-21,분당선,선릉,15259,23109,38368,2
2023-02-21,신림선,신림,1725,2484,4209,2
2023-02-21,경의선,홍대입구,1878,2348,4226,2
2023-02-21,경의선,서울역,5015,6403,11418,2
2023-02-21,경부선,가산디지털단지,19612,22866,42478,2
2023-02-21,경부선,서울역,9107,2675,11782,2
2023-02-21,9호선,고속터미널,14215,18832,33047,2
2023-02-21,8호선,잠실(송파구청),16394,19275,35669,2
2023-02-21,7호선,가산디지털단지,50199,50310,100509,2
2023-02-21,7호선,고속터미널,17478,14488,31966,2
2023-02-21,4호선,사당,28430,24088,52518,2
2023-02-21,4호선,서울역,13194,21846,35040,2
2023-02-21,3호선,고속터미널,46414,43798,90212,2
2023-02-21,2호선,홍대입구,65311,67758,133069,2
2023-02-21,2호선,구로디지털단지,64984,64813,129797,2
2023-02-21,2호선,신림,59573,57432,117005,2
2023-02-21,2호선,사당,42092,46192,88284,2
2023-02-21,2호선,강남,92414,88884,181298,2
2023-02-21,2호선,선릉,65709,57913,123622,2
2023-02-21,2호선,잠실(송파구청),83468,82481,165949,2
2023-02-21,1호선,서울역,54965,52289,107254,2
2023-02-22,신림선,신림,1818,2609,4427,2
2023-02-22,분당선,선릉,15179,23175,38354,2
2023-02-22,공항철도 1호선,홍대입구,13220,13154,26374,2
2023-02-22,공항철도 1호선,서울역,12090,10403,22493,2
2023-02-22,경의선,홍대입구,2004,2455,4459,2
2023-02-22,경의선,서울역,5250,6480,11730,2
2023-02-22,경부선,가산디지털단지,19723,22828,42551,2
2023-02-22,경부선,서울역,9413,2836,12249,2
2023-02-22,9호선,고속터미널,14279,18840,33119,2
2023-02-22,8호선,잠실(송파구청),16660,19557,36217,2
2023-02-22,7호선,가산디지털단지,49841,50043,99884,2
2023-02-22,7호선,고속터미널,17837,14905,32742,2
2023-02-22,4호선,사당,28917,24787,53704,2
2023-02-22,4호선,서울역,13659,22827,36486,2
2023-02-22,3호선,고속터미널,46477,44384,90861,2
2023-02-22,2호선,홍대입구,67930,71478,139408,2
2023-02-22,2호선,구로디지털단지,65657,65603,131260,2
2023-02-22,1호선,서울역,56356,54164,110520,2
2023-02-22,2호선,신림,60835,58695,119530,2
2023-02-22,2호선,사당,42660,46945,89605,2
2023-02-22,2호선,강남,91931,88894,180825,2
2023-02-22,2호선,선릉,65878,58113,123991,2
2023-02-22,2호선,잠실(송파구청),84330,83421,167751,2
2023-02-23,공항철도 1호선,홍대입구,13628,14061,27689,2
2023-02-23,공항철도 1호선,서울역,12885,10946,23831,2
2023-02-23,경의선,홍대입구,2105,2531,4636,2
2023-02-23,경의선,서울역,5082,6630,11712,2
2023-02-23,경부선,가산디지털단지,19764,22756,42520,2
2023-02-23,경부선,서울역,10040,2943,12983,2
2023-02-23,9호선,고속터미널,14568,19273,33841,2
2023-02-23,8호선,잠실(송파구청),16651,20082,36733,2
2023-02-23,7호선,가산디지털단지,49641,50126,99767,2
2023-02-23,7호선,고속터미널,18166,15231,33397,2
2023-02-23,4호선,사당,29098,25131,54229,2
2023-02-23,4호선,서울역,13804,23386,37190,2
2023-02-23,3호선,고속터미널,47296,45490,92786,2
2023-02-23,2호선,홍대입구,68250,72582,140832,2
2023-02-23,2호선,구로디지털단지,65612,65252,130864,2
2023-02-23,2호선,신림,61304,58845,120149,2
2023-02-23,2호선,사당,42974,47458,90432,2
2023-02-23,2호선,강남,92825,89835,182660,2
2023-02-23,2호선,선릉,66173,58302,124475,2
2023-02-23,2호선,잠실(송파구청),85560,84500,170060,2
2023-02-23,1호선,서울역,58145,55299,113444,2
2023-02-23,분당선,선릉,15378,23485,38863,2
2023-02-23,신림선,신림,1782,2633,4415,2
2023-02-24,1호선,서울역,63837,61629,125466,2
2023-02-24,2호선,잠실(송파구청),87965,87014,174979,2
2023-02-24,2호선,선릉,64475,56800,121275,2
2023-02-24,2호선,강남,96989,95165,192154,2
2023-02-24,2호선,사당,46643,51860,98503,2
2023-02-24,2호선,신림,63337,61361,124698,2
2023-02-24,2호선,구로디지털단지,66460,66181,132641,2
2023-02-24,2호선,홍대입구,74938,83679,158617,2
2023-02-24,3호선,고속터미널,56050,56659,112709,2
2023-02-24,4호선,서울역,14042,25834,39876,2
2023-02-24,4호선,사당,30966,27552,58518,2
2023-02-24,7호선,고속터미널,21289,16535,37824,2
2023-02-24,7호선,가산디지털단지,49629,49163,98792,2
2023-02-24,8호선,잠실(송파구청),17602,20916,38518,2
2023-02-24,9호선,고속터미널,16329,23725,40054,2
2023-02-24,경부선,서울역,12023,3625,15648,2
2023-02-24,경부선,가산디지털단지,19746,22607,42353,2
2023-02-24,경의선,서울역,5311,6716,12027,2
2023-02-24,경의선,홍대입구,2212,2875,5087,2
2023-02-24,공항철도 1호선,서울역,14148,12900,27048,2
2023-02-24,공항철도 1호선,홍대입구,14717,15605,30322,2
2023-02-24,분당선,선릉,15310,23019,38329,2
2023-02-24,신림선,신림,1846,2679,4525,2
2023-02-25,신림선,신림,1433,1989,3422,2
2023-02-25,1호선,서울역,46740,45970,92710,2
2023-02-25,2호선,잠실(송파구청),80062,78466,158528,2
2023-02-25,2호선,선릉,27261,23676,50937,2
2023-02-25,2호선,강남,65532,65737,131269,2
2023-02-25,2호선,사당,39295,43739,83034,2
2023-02-25,2호선,신림,50719,49058,99777,2
2023-02-25,2호선,구로디지털단지,38975,38327,77302,2
2023-02-25,2호선,홍대입구,83147,92744,175891,2
2023-02-25,3호선,고속터미널,59586,58739,118325,2
2023-02-25,4호선,서울역,7436,20119,27555,2
2023-02-25,4호선,사당,26255,24582,50837,2
2023-02-25,7호선,고속터미널,18483,13556,32039,2
2023-02-25,7호선,가산디지털단지,16166,14384,30550,2
2023-02-25,8호선,잠실(송파구청),16123,18905,35028,2
2023-02-25,9호선,고속터미널,15382,23470,38852,2
2023-02-25,경부선,서울역,11225,2945,14170,2
2023-02-25,경부선,가산디지털단지,6790,9195,15985,2
2023-02-25,경의선,서울역,1690,1894,3584,2
2023-02-25,경의선,홍대입구,2432,3261,5693,2
2023-02-25,공항철도 1호선,서울역,13012,12436,25448,2
2023-02-25,공항철도 1호선,홍대입구,16866,17774,34640,2
2023-02-25,분당선,선릉,5485,8707,14192,2
2023-02-26,1호선,서울역,36383,35776,72159,2
2023-02-26,2호선,잠실(송파구청),61958,58468,120426,2
2023-02-26,2호선,선릉,15305,12865,28170,2
2023-02-26,2호선,강남,38390,36514,74904,2
2023-02-26,2호선,사당,26115,28890,55005,2
2023-02-26,2호선,신림,37824,36975,74799,2
2023-02-26,2호선,구로디지털단지,27383,26879,54262,2
2023-02-26,2호선,홍대입구,64718,63601,128319,2
2023-02-26,3호선,고속터미널,49568,45978,95546,2
2023-02-26,4호선,서울역,5598,15634,21232,2
2023-02-26,4호선,사당,18680,17606,36286,2
2023-02-26,7호선,고속터미널,15345,10159,25504,2
2023-02-26,7호선,가산디지털단지,11511,10617,22128,2
2023-02-26,8호선,잠실(송파구청),11858,13590,25448,2
2023-02-26,9호선,고속터미널,12762,18749,31511,2
2023-02-26,경부선,서울역,10923,2638,13561,2
2023-02-26,경부선,가산디지털단지,5243,7188,12431,2
2023-02-26,경의선,서울역,1242,1198,2440,2
2023-02-26,경의선,홍대입구,2029,2478,4507,2
2023-02-26,공항철도 1호선,서울역,12116,11427,23543,2
2023-02-26,공항철도 1호선,홍대입구,14446,12924,27370,2
2023-02-26,분당선,선릉,2978,4727,7705,2
2023-02-26,신림선,신림,1195,1690,2885,2
2023-02-27,2호선,잠실(송파구청),83077,82911,165988,2
2023-02-27,2호선,선릉,63639,55866,119505,2
2023-02-27,2호선,강남,89424,86061,175485,2
2023-02-27,2호선,사당,41469,44849,86318,2
2023-02-27,2호선,신림,58797,57258,116055,2
2023-02-27,2호선,구로디지털단지,63681,63421,127102,2
2023-02-27,2호선,홍대입구,67033,64591,131624,2
2023-02-27,3호선,고속터미널,46701,44059,90760,2
2023-02-27,4호선,서울역,12765,21567,34332,2
2023-02-27,4호선,사당,25845,22833,48678,2
2023-02-27,7호선,고속터미널,18379,14782,33161,2
2023-02-27,7호선,가산디지털단지,49292,49732,99024,2
2023-02-27,8호선,잠실(송파구청),16363,19137,35500,2
2023-02-27,9호선,고속터미널,14339,19083,33422,2
2023-02-27,경부선,서울역,10075,2942,13017,2
2023-02-27,경부선,가산디지털단지,19438,22686,42124,2
2023-02-27,경의선,서울역,5099,6631,11730,2
2023-02-27,경의선,홍대입구,2058,2464,4522,2
2023-02-27,공항철도 1호선,서울역,11933,10917,22850,2
2023-02-27,공항철도 1호선,홍대입구,13404,12797,26201,2
2023-02-27,분당선,선릉,14793,22700,37493,2
2023-02-27,신림선,신림,1753,2502,4255,2
2023-02-27,1호선,서울역,56629,54084,110713,2
2023-02-28,1호선,서울역,63208,58144,121352,2
2023-02-28,2호선,잠실(송파구청),87752,87005,174757,2
2023-02-28,2호선,선릉,65110,57722,122832,2
2023-02-28,2호선,강남,94479,92745,187224,2
2023-02-28,2호선,사당,44269,49635,93904,2
2023-02-28,2호선,신림,62379,60775,123154,2
2023-02-28,2호선,구로디지털단지,66456,66616,133072,2
2023-02-28,2호선,홍대입구,70107,77327,147434,2
2023-02-28,3호선,고속터미널,49860,48167,98027,2
2023-02-28,4호선,서울역,14440,24159,38599,2
2023-02-28,4호선,사당,29700,25824,55524,2
2023-02-28,7호선,고속터미널,18627,15506,34133,2
2023-02-28,7호선,가산디지털단지,49570,50508,100078,2
2023-02-28,8호선,잠실(송파구청),17261,20572,37833,2
2023-02-28,9호선,고속터미널,15344,21205,36549,2
2023-02-28,경부선,서울역,10463,2969,13432,2
2023-02-28,경부선,가산디지털단지,19982,23106,43088,2
2023-02-28,경의선,서울역,5687,6777,12464,2
2023-02-28,경의선,홍대입구,2143,2639,4782,2
2023-02-28,공항철도 1호선,서울역,12222,10997,23219,2
2023-02-28,공항철도 1호선,홍대입구,13719,13948,27667,2
2023-02-28,분당선,선릉,15187,23279,38466,2
2023-02-28,신림선,신림,1800,2601,4401,2
2023-03-01,분당선,선릉,3520,5396,8916,3
2023-03-01,공항철도 1호선,홍대입구,12742,12633,25375,3
2023-03-01,공항철도 1호선,서울역,9225,8675,17900,3
2023-03-01,경의선,홍대입구,1889,2368,4257,3
2023-03-01,경의선,서울역,1517,1427,2944,3
2023-03-01,경부선,가산디지털단지,5583,7437,13020,3
2023-03-01,경부선,서울역,7636,1859,9495,3
2023-03-01,9호선,고속터미널,10975,16249,27224,3
2023-03-01,8호선,잠실(송파구청),13067,14153,27220,3
2023-03-01,7호선,가산디지털단지,13292,12044,25336,3
2023-03-01,7호선,고속터미널,11244,8622,19866,3
2023-03-01,4호선,사당,18248,16697,34945,3
2023-03-01,4호선,서울역,6159,12696,18855,3
2023-03-01,3호선,고속터미널,43150,41522,84672,3
2023-03-01,2호선,홍대입구,63955,63618,127573,3
2023-03-01,2호선,구로디지털단지,29741,29124,58865,3
2023-03-01,2호선,신림,40329,38895,79224,3
2023-03-01,2호선,사당,26324,28788,55112,3
2023-03-01,2호선,강남,38188,35660,73848,3
2023-03-01,2호선,선릉,17761,15472,33233,3
2023-03-01,2호선,잠실(송파구청),56465,53542,110007,3
2023-03-01,1호선,서울역,35829,34003,69832,3
2023-03-01,신림선,신림,1292,1813,3105,3
2023-03-02,1호선,서울역,51019,49115,100134,3
2023-03-02,2호선,잠실(송파구청),73430,73262,146692,3
2023-03-02,2호선,선릉,62744,55839,118583,3
2023-03-02,2호선,강남,85385,80638,166023,3
2023-03-02,2호선,사당,41014,45274,86288,3
2023-03-02,2호선,신림,60801,58369,119170,3
2023-03-02,2호선,구로디지털단지,64150,63939,128089,3
2023-03-02,2호선,홍대입구,64048,66979,131027,3
2023-03-02,3호선,고속터미널,42641,40040,82681,3
2023-03-02,4호선,서울역,13489,19878,33367,3
2023-03-02,4호선,사당,27967,24293,52260,3
2023-03-02,7호선,고속터미널,16723,14348,31071,3
2023-03-02,7호선,가산디지털단지,48719,48943,97662,3
2023-03-02,8호선,잠실(송파구청),15786,18440,34226,3
2023-03-02,9호선,고속터미널,13352,16957,30309,3
2023-03-02,경부선,서울역,7509,2318,9827,3
2023-03-02,경부선,가산디지털단지,18915,22091,41006,3
2023-03-02,경의선,서울역,5127,6249,11376,3
2023-03-02,경의선,홍대입구,1937,2434,4371,3
2023-03-02,공항철도 1호선,서울역,10897,9098,19995,3
2023-03-02,공항철도 1호선,홍대입구,11818,11815,23633,3
2023-03-02,분당선,선릉,14864,22663,37527,3
2023-03-02,신림선,신림,1774,2560,4334,3
2023-03-03,분당선,선릉,14867,22524,37391,3
2023-03-03,공항철도 1호선,홍대입구,13066,13539,26605,3
2023-03-03,공항철도 1호선,서울역,13321,11230,24551,3
2023-03-03,경의선,홍대입구,2053,2592,4645,3
2023-03-03,경의선,서울역,5215,6818,12033,3
2023-03-03,경부선,가산디지털단지,19750,22830,42580,3
2023-03-03,경부선,서울역,10075,3117,13192,3
2023-03-03,9호선,고속터미널,15326,20602,35928,3
2023-03-03,8호선,잠실(송파구청),16126,19232,35358,3
2023-03-03,7호선,가산디지털단지,49387,49314,98701,3
2023-03-03,7호선,고속터미널,19873,15793,35666,3
2023-03-03,4호선,사당,30660,27052,57712,3
2023-03-03,4호선,서울역,13651,22827,36478,3
2023-03-03,3호선,고속터미널,50071,50449,100520,3
2023-03-03,2호선,홍대입구,68814,77632,146446,3
2023-03-03,2호선,구로디지털단지,65479,65317,130796,3
2023-03-03,2호선,신림,62864,60406,123270,3
2023-03-03,2호선,사당,45169,49616,94785,3
2023-03-03,2호선,강남,91852,87883,179735,3
2023-03-03,2호선,선릉,62700,55401,118101,3
2023-03-03,2호선,잠실(송파구청),77916,78070,155986,3
2023-03-03,1호선,서울역,58139,55681,113820,3
2023-03-03,신림선,신림,1824,2679,4503,3
2023-03-04,1호선,서울역,40961,39471,80432,3
2023-03-04,2호선,잠실(송파구청),68953,67117,136070,3
2023-03-04,2호선,선릉,25840,22494,48334,3
2023-03-04,2호선,강남,63638,60077,123715,3
2023-03-04,2호선,사당,37073,40702,77775,3
2023-03-04,2호선,신림,49082,47389,96471,3
2023-03-04,2호선,구로디지털단지,37938,37291,75229,3
2023-03-04,2호선,홍대입구,77863,87843,165706,3
2023-03-04,3호선,고속터미널,54921,53763,108684,3
2023-03-04,4호선,서울역,7090,16888,23978,3
2023-03-04,4호선,사당,24472,22890,47362,3
2023-03-04,7호선,고속터미널,16192,12388,28580,3
2023-03-04,7호선,가산디지털단지,15927,14287,30214,3
2023-03-04,8호선,잠실(송파구청),14633,16971,31604,3
2023-03-04,9호선,고속터미널,14610,21699,36309,3
2023-03-04,경부선,서울역,9485,2603,12088,3
2023-03-04,경부선,가산디지털단지,6991,9274,16265,3
2023-03-04,경의선,서울역,1530,1722,3252,3
2023-03-04,경의선,홍대입구,2379,3052,5431,3
2023-03-04,공항철도 1호선,서울역,11346,10242,21588,3
2023-03-04,공항철도 1호선,홍대입구,16203,16169,32372,3
2023-03-04,분당선,선릉,5377,8467,13844,3
2023-03-04,신림선,신림,1369,1890,3259,3
2023-03-05,신림선,신림,1122,1628,2750,3
2023-03-05,1호선,서울역,33003,31197,64200,3
2023-03-05,2호선,잠실(송파구청),51641,48604,100245,3
2023-03-05,2호선,선릉,14468,12366,26834,3
2023-03-05,2호선,강남,35493,32172,67665,3
2023-03-05,2호선,사당,25029,27354,52383,3
2023-03-05,2호선,신림,36587,35871,72458,3
2023-03-05,2호선,구로디지털단지,26968,26618,53586,3
2023-03-05,2호선,홍대입구,60247,58926,119173,3
2023-03-05,3호선,고속터미널,45265,43024,88289,3
2023-03-05,4호선,서울역,5244,13392,18636,3
2023-03-05,4호선,사당,17461,16569,34030,3
2023-03-05,7호선,고속터미널,14119,9172,23291,3
2023-03-05,7호선,가산디지털단지,11403,10542,21945,3
2023-03-05,8호선,잠실(송파구청),10871,11927,22798,3
2023-03-05,9호선,고속터미널,11869,17540,29409,3
2023-03-05,경부선,서울역,9698,2209,11907,3
2023-03-05,경부선,가산디지털단지,5221,7136,12357,3
2023-03-05,경의선,서울역,1205,1247,2452,3
2023-03-05,경의선,홍대입구,1891,2378,4269,3
2023-03-05,공항철도 1호선,서울역,11275,9969,21244,3
2023-03-05,공항철도 1호선,홍대입구,12963,11978,24941,3
2023-03-05,분당선,선릉,2991,4416,7407,3
2023-03-06,1호선,서울역,51573,49207,100780,3
2023-03-06,2호선,잠실(송파구청),68889,69049,137938,3
2023-03-06,2호선,선릉,63981,56729,120710,3
2023-03-06,2호선,강남,85833,81058,166891,3
2023-03-06,2호선,사당,40102,44677,84779,3
2023-03-06,2호선,신림,59537,57672,117209,3
2023-03-06,2호선,구로디지털단지,64254,64244,128498,3
2023-03-06,2호선,홍대입구,62288,64301,126589,3
2023-03-06,3호선,고속터미널,42413,40648,83061,3
2023-03-06,4호선,서울역,13102,19714,32816,3
2023-03-06,4호선,사당,27516,23887,51403,3
2023-03-06,7호선,고속터미널,17552,14990,32542,3
2023-03-06,7호선,가산디지털단지,50492,50886,101378,3
2023-03-06,8호선,잠실(송파구청),14621,17146,31767,3
2023-03-06,9호선,고속터미널,13485,17353,30838,3
2023-03-06,경부선,서울역,7673,2487,10160,3
2023-03-06,경부선,가산디지털단지,20037,23172,43209,3
2023-03-06,경의선,서울역,5331,6627,11958,3
2023-03-06,경의선,홍대입구,2016,2253,4269,3
2023-03-06,공항철도 1호선,서울역,11000,9381,20381,3
2023-03-06,공항철도 1호선,홍대입구,12053,11893,23946,3
2023-03-06,분당선,선릉,15199,23098,38297,3
2023-03-06,신림선,신림,1829,2532,4361,3
2023-03-07,신림선,신림,1770,2604,4374,3
2023-03-07,분당선,선릉,15625,23480,39105,3
2023-03-07,공항철도 1호선,홍대입구,12100,12088,24188,3
2023-03-07,공항철도 1호선,서울역,10836,8726,19562,3
2023-03-07,경의선,홍대입구,2028,2346,4374,3
2023-03-07,경의선,서울역,5285,6693,11978,3
2023-03-07,경부선,가산디지털단지,20388,23468,43856,3
2023-03-07,경부선,서울역,6666,2078,8744,3
2023-03-07,9호선,고속터미널,13557,17282,30839,3
2023-03-07,8호선,잠실(송파구청),15362,18173,33535,3
2023-03-07,7호선,가산디지털단지,50281,50771,101052,3
2023-03-07,7호선,고속터미널,16334,14652,30986,3
2023-03-07,4호선,사당,28878,24992,53870,3
2023-03-07,4호선,서울역,13648,19957,33605,3
2023-03-07,3호선,고속터미널,41752,39331,81083,3
2023-03-07,2호선,홍대입구,64591,67634,132225,3
2023-03-07,2호선,구로디지털단지,65578,65266,130844,3
2023-03-07,2호선,신림,61075,58719,119794,3
2023-03-07,2호선,사당,42685,46704,89389,3
2023-03-07,2호선,강남,87418,82766,170184,3
2023-03-07,2호선,선릉,65107,57710,122817,3
2023-03-07,2호선,잠실(송파구청),74247,74451,148698,3
2023-03-07,1호선,서울역,51359,49119,100478,3
2023-03-08,1호선,서울역,51182,48871,100053,3
2023-03-08,2호선,잠실(송파구청),75122,75324,150446,3
2023-03-08,2호선,선릉,65563,57819,123382,3
2023-03-08,2호선,강남,88089,81939,170028,3
2023-03-08,2호선,사당,43091,47438,90529,3
2023-03-08,2호선,신림,61171,59331,120502,3
2023-03-08,2호선,구로디지털단지,65530,65425,130955,3
2023-03-08,2호선,홍대입구,65537,69021,134558,3
2023-03-08,3호선,고속터미널,41937,39600,81537,3
2023-03-08,4호선,서울역,14108,20884,34992,3
2023-03-08,4호선,사당,29082,25264,54346,3
2023-03-08,7호선,고속터미널,16528,14708,31236,3
2023-03-08,7호선,가산디지털단지,50090,50348,100438,3
2023-03-08,8호선,잠실(송파구청),15918,18522,34440,3
2023-03-08,9호선,고속터미널,13673,17130,30803,3
2023-03-08,경부선,서울역,7164,2221,9385,3
2023-03-08,경부선,가산디지털단지,20031,23194,43225,3
2023-03-08,경의선,서울역,5265,6558,11823,3
2023-03-08,경의선,홍대입구,2084,2423,4507,3
2023-03-08,공항철도 1호선,서울역,11225,8804,20029,3
2023-03-08,공항철도 1호선,홍대입구,12566,12530,25096,3
2023-03-08,분당선,선릉,15512,23494,39006,3
2023-03-08,신림선,신림,1756,2478,4234,3
2023-03-09,1호선,서울역,54483,51245,105728,3
2023-03-09,2호선,잠실(송파구청),74676,75238,149914,3
2023-03-09,2호선,선릉,64943,57580,122523,3
2023-03-09,2호선,강남,88273,83766,172039,3
2023-03-09,2호선,사당,43791,48297,92088,3
2023-03-09,2호선,신림,61371,58601,119972,3
2023-03-09,2호선,구로디지털단지,65678,65371,131049,3
2023-03-09,2호선,홍대입구,66784,70651,137435,3
2023-03-09,3호선,고속터미널,44077,41214,85291,3
2023-03-09,4호선,서울역,14195,21936,36131,3
2023-03-09,4호선,사당,29610,25529,55139,3
2023-03-09,7호선,고속터미널,17148,14644,31792,3
2023-03-09,7호선,가산디지털단지,49542,50341,99883,3
2023-03-09,8호선,잠실(송파구청),15264,18272,33536,3
2023-03-09,9호선,고속터미널,14499,18074,32573,3
2023-03-09,경부선,서울역,7851,2475,10326,3
2023-03-09,경부선,가산디지털단지,19877,22898,42775,3
2023-03-09,경의선,홍대입구,2087,2446,4533,3
2023-03-09,공항철도 1호선,서울역,12183,9431,21614,3
2023-03-09,공항철도 1호선,홍대입구,12548,12957,25505,3
2023-03-09,경의선,서울역,5275,6696,11971,3
2023-03-09,분당선,선릉,15517,23584,39101,3
2023-03-09,신림선,신림,1737,2507,4244,3
2023-03-10,신림선,신림,1846,2559,4405,3
2023-03-10,분당선,선릉,15132,23217,38349,3
2023-03-10,공항철도 1호선,홍대입구,14223,14974,29197,3
2023-03-10,공항철도 1호선,서울역,14675,12201,26876,3
2023-03-10,경의선,홍대입구,2333,2965,5298,3
2023-03-10,경의선,서울역,5584,6960,12544,3
2023-03-10,경부선,가산디지털단지,20398,23034,43432,3
2023-03-10,경부선,서울역,10848,3460,14308,3
2023-03-10,9호선,고속터미널,16959,23010,39969,3
2023-03-10,8호선,잠실(송파구청),16167,19490,35657,3
2023-03-10,7호선,가산디지털단지,49788,50191,99979,3
2023-03-10,7호선,고속터미널,21061,16608,37669,3
2023-03-10,4호선,사당,31561,27931,59492,3
2023-03-10,4호선,서울역,14360,24889,39249,3
2023-03-10,3호선,고속터미널,54444,54223,108667,3
2023-03-10,2호선,홍대입구,74372,84166,158538,3
2023-03-10,2호선,구로디지털단지,67305,67112,134417,3
2023-03-10,2호선,신림,63759,61748,125507,3
2023-03-10,2호선,사당,47105,52179,99284,3
2023-03-10,2호선,강남,94474,90212,184686,3
2023-03-10,2호선,선릉,64500,56715,121215,3
2023-03-10,2호선,잠실(송파구청),80354,80582,160936,3
2023-03-10,1호선,서울역,60772,59334,120106,3
2023-03-11,3호선,고속터미널,57659,56704,114363,3
2023-03-11,4호선,서울역,8005,18962,26967,3
2023-03-11,4호선,사당,26741,25123,51864,3
2023-03-11,경의선,서울역,1669,1744,3413,3
2023-03-11,경의선,홍대입구,2602,3557,6159,3
2023-03-11,공항철도 1호선,서울역,13115,11489,24604,3
2023-03-11,공항철도 1호선,홍대입구,17717,18063,35780,3
2023-03-11,분당선,선릉,5913,9341,15254,3
2023-03-11,7호선,고속터미널,17542,13253,30795,3
2023-03-11,7호선,가산디지털단지,16486,15202,31688,3
2023-03-11,8호선,잠실(송파구청),14708,17257,31965,3
2023-03-11,9호선,고속터미널,16652,24257,40909,3
2023-03-11,경부선,서울역,10312,2767,13079,3
2023-03-11,경부선,가산디지털단지,7414,9736,17150,3
2023-03-11,신림선,신림,1390,2150,3540,3
2023-03-11,2호선,잠실(송파구청),73122,70841,143963,3
2023-03-11,2호선,선릉,27586,24261,51847,3
2023-03-11,2호선,강남,64804,64420,129224,3
2023-03-11,2호선,사당,41201,45100,86301,3
2023-03-11,1호선,서울역,45087,43736,88823,3
2023-03-11,2호선,신림,51705,49749,101454,3
2023-03-11,2호선,구로디지털단지,39570,38678,78248,3
2023-03-11,2호선,홍대입구,83665,95198,178863,3
2023-03-12,9호선,고속터미널,11524,18327,29851,3
2023-03-12,경부선,서울역,9836,2321,12157,3
2023-03-12,경부선,가산디지털단지,4547,6311,10858,3
2023-03-12,경의선,서울역,1168,1090,2258,3
2023-03-12,경의선,홍대입구,1713,2393,4106,3
2023-03-12,공항철도 1호선,서울역,12021,10755,22776,3
2023-03-12,공항철도 1호선,홍대입구,12310,11479,23789,3
2023-03-12,분당선,선릉,2816,4542,7358,3
2023-03-12,신림선,신림,1109,1498,2607,3
2023-03-12,1호선,서울역,33424,31324,64748,3
2023-03-12,2호선,잠실(송파구청),47446,44305,91751,3
2023-03-12,2호선,선릉,14100,11963,26063,3
2023-03-12,2호선,강남,34336,32877,67213,3
2023-03-12,2호선,사당,24076,25820,49896,3
2023-03-12,2호선,신림,35112,34334,69446,3
2023-03-12,2호선,구로디지털단지,25075,24324,49399,3
2023-03-12,2호선,홍대입구,58138,55628,113766,3
2023-03-12,3호선,고속터미널,45942,43461,89403,3
2023-03-12,4호선,사당,16273,15596,31869,3
2023-03-12,4호선,서울역,5376,14009,19385,3
2023-03-12,7호선,고속터미널,14622,9048,23670,3
2023-03-12,7호선,가산디지털단지,10356,9299,19655,3
2023-03-12,8호선,잠실(송파구청),10791,11695,22486,3
2023-03-13,7호선,고속터미널,17457,14837,32294,3
2023-03-13,7호선,가산디지털단지,49705,49936,99641,3
2023-03-13,8호선,잠실(송파구청),14869,17224,32093,3
2023-03-13,9호선,고속터미널,13552,17995,31547,3
2023-03-13,경부선,서울역,8027,2515,10542,3
2023-03-13,경부선,가산디지털단지,19503,22857,42360,3
2023-03-13,분당선,선릉,14906,22530,37436,3
2023-03-13,신림선,신림,1758,2417,4175,3
2023-03-13,경의선,서울역,5344,6899,12243,3
2023-03-13,경의선,홍대입구,1992,2446,4438,3
2023-03-13,4호선,사당,27544,23931,51475,3
2023-03-13,4호선,서울역,13600,20843,34443,3
2023-03-13,3호선,고속터미널,43441,41075,84516,3
2023-03-13,2호선,홍대입구,63994,65526,129520,3
2023-03-13,2호선,구로디지털단지,64365,63872,128237,3
2023-03-13,2호선,신림,58840,56959,115799,3
2023-03-13,2호선,사당,39837,44061,83898,3
2023-03-13,2호선,강남,85435,82393,167828,3
2023-03-13,2호선,선릉,62964,55923,118887,3
2023-03-13,2호선,잠실(송파구청),71934,71642,143576,3
2023-03-13,1호선,서울역,52976,50332,103308,3
2023-03-13,공항철도 1호선,서울역,11965,10054,22019,3
2023-03-13,공항철도 1호선,홍대입구,12400,11953,24353,3
2023-03-14,9호선,고속터미널,13899,17708,31607,3
2023-03-14,8호선,잠실(송파구청),15700,18529,34229,3
2023-03-14,7호선,가산디지털단지,50308,50478,100786,3
2023-03-14,7호선,고속터미널,16302,14595,30897,3
2023-03-14,4호선,사당,29048,25346,54394,3
2023-03-14,공항철도 1호선,서울역,11330,9343,20673,3
2023-03-14,공항철도 1호선,홍대입구,12559,12666,25225,3
2023-03-14,분당선,선릉,15578,23605,39183,3
2023-03-14,4호선,서울역,13886,20785,34671,3
2023-03-14,1호선,서울역,52552,50247,102799,3
2023-03-14,2호선,잠실(송파구청),76204,76280,152484,3
2023-03-14,2호선,선릉,65244,57893,123137,3
2023-03-14,2호선,강남,87801,84384,172185,3
2023-03-14,2호선,사당,43399,47283,90682,3
2023-03-14,2호선,신림,61010,59270,120280,3
2023-03-14,2호선,구로디지털단지,66039,65819,131858,3
2023-03-14,2호선,홍대입구,66838,69625,136463,3
2023-03-14,3호선,고속터미널,43108,40592,83700,3
2023-03-14,신림선,신림,1841,2498,4339,3
2023-03-14,경부선,서울역,7048,2395,9443,3
2023-03-14,경부선,가산디지털단지,20086,23317,43403,3
2023-03-14,경의선,서울역,5412,6714,12126,3
2023-03-14,경의선,홍대입구,2059,2410,4469,3
2023-03-15,신림선,신림,1740,2512,4252,3
2023-03-15,2호선,구로디지털단지,65925,65844,131769,3
2023-03-15,2호선,신림,61007,59118,120125,3
2023-03-15,2호선,사당,43723,47826,91549,3
2023-03-15,2호선,강남,88310,85468,173778,3
2023-03-15,2호선,선릉,65292,57765,123057,3
2023-03-15,2호선,잠실(송파구청),74591,74900,149491,3
2023-03-15,1호선,서울역,52939,50240,103179,3
2023-03-15,분당선,선릉,15524,23333,38857,3
2023-03-15,공항철도 1호선,홍대입구,12491,12583,25074,3
2023-03-15,공항철도 1호선,서울역,11315,9388,20703,3
2023-03-15,경의선,홍대입구,1950,2428,4378,3
2023-03-15,경의선,서울역,5057,6651,11708,3
2023-03-15,경부선,가산디지털단지,19771,23114,42885,3
2023-03-15,경부선,서울역,7345,2246,9591,3
2023-03-15,9호선,고속터미널,14022,17760,31782,3
2023-03-15,8호선,잠실(송파구청),15627,18235,33862,3
2023-03-15,7호선,가산디지털단지,49813,49792,99605,3
2023-03-15,7호선,고속터미널,16660,14619,31279,3
2023-03-15,4호선,사당,29344,25650,54994,3
2023-03-15,4호선,서울역,14201,21474,35675,3
2023-03-15,3호선,고속터미널,42660,40289,82949,3
2023-03-15,2호선,홍대입구,66829,69443,136272,3
2023-03-16,1호선,서울역,55174,52611,107785,3
2023-03-16,9호선,고속터미널,14364,18336,32700,3
2023-03-16,분당선,선릉,15415,23306,38721,3
2023-03-16,공항철도 1호선,서울역,12562,9613,22175,3
2023-03-16,공항철도 1호선,홍대입구,12891,13010,25901,3
2023-03-16,신림선,신림,1860,2537,4397,3
2023-03-16,경의선,홍대입구,2001,2401,4402,3
2023-03-16,경의선,서울역,5315,6882,12197,3
2023-03-16,경부선,가산디지털단지,19935,23069,43004,3
2023-03-16,경부선,서울역,8054,2564,10618,3
2023-03-16,8호선,잠실(송파구청),15764,18443,34207,3
2023-03-16,7호선,가산디지털단지,49817,50427,100244,3
2023-03-16,7호선,고속터미널,16958,14659,31617,3
2023-03-16,4호선,사당,30353,25766,56119,3
2023-03-16,4호선,서울역,14130,22209,36339,3
2023-03-16,3호선,고속터미널,45152,42267,87419,3
2023-03-16,2호선,홍대입구,68385,72227,140612,3
2023-03-16,2호선,구로디지털단지,66038,65799,131837,3
2023-03-16,2호선,신림,61830,59702,121532,3
2023-03-16,2호선,사당,43983,48661,92644,3
2023-03-16,2호선,강남,88258,84991,173249,3
2023-03-16,2호선,선릉,65492,58031,123523,3
2023-03-16,2호선,잠실(송파구청),76098,75971,152069,3
2023-03-17,신림선,신림,1858,2583,4441,3
2023-03-17,1호선,서울역,60397,59253,119650,3
2023-03-17,2호선,잠실(송파구청),79314,79938,159252,3
2023-03-17,2호선,선릉,64042,56481,120523,3
2023-03-17,2호선,강남,94715,93042,187757,3
2023-03-17,2호선,사당,46783,52145,98928,3
2023-03-17,2호선,신림,64066,61662,125728,3
2023-03-17,2호선,구로디지털단지,66869,66342,133211,3
2023-03-17,2호선,홍대입구,75255,84806,160061,3
2023-03-17,3호선,고속터미널,54908,55440,110348,3
2023-03-17,4호선,서울역,14038,24793,38831,3
2023-03-17,4호선,사당,32005,28335,60340,3
2023-03-17,7호선,고속터미널,20625,16495,37120,3
2023-03-17,7호선,가산디지털단지,49566,49580,99146,3
2023-03-17,8호선,잠실(송파구청),16509,19435,35944,3
2023-03-17,9호선,고속터미널,16816,23211,40027,3
2023-03-17,경부선,서울역,11108,3485,14593,3
2023-03-17,경부선,가산디지털단지,20192,22896,43088,3
2023-03-17,경의선,서울역,5408,6821,12229,3
2023-03-17,경의선,홍대입구,2250,2911,5161,3
2023-03-17,공항철도 1호선,서울역,14724,12293,27017,3
2023-03-17,공항철도 1호선,홍대입구,14500,14781,29281,3
2023-03-17,분당선,선릉,15073,22902,37975,3
2023-03-18,2호선,구로디지털단지,39973,38528,78501,3
2023-03-18,공항철도 1호선,홍대입구,17732,17843,35575,3
2023-03-18,분당선,선릉,5811,9219,15030,3
2023-03-18,신림선,신림,1509,2103,3612,3
2023-03-18,공항철도 1호선,서울역,13590,11614,25204,3
2023-03-18,경의선,홍대입구,2546,3314,5860,3
2023-03-18,경의선,서울역,1699,1926,3625,3
2023-03-18,경부선,가산디지털단지,7317,9737,17054,3
2023-03-18,경부선,서울역,10832,2786,13618,3
2023-03-18,9호선,고속터미널,16162,23590,39752,3
2023-03-18,8호선,잠실(송파구청),15469,17851,33320,3
2023-03-18,7호선,가산디지털단지,16545,14937,31482,3
2023-03-18,7호선,고속터미널,17639,13612,31251,3
2023-03-18,4호선,사당,27798,25871,53669,3
2023-03-18,4호선,서울역,8257,19467,27724,3
2023-03-18,3호선,고속터미널,59558,57898,117456,3
2023-03-18,2호선,홍대입구,85359,96180,181539,3
2023-03-18,1호선,서울역,46699,45197,91896,3
2023-03-18,2호선,잠실(송파구청),76881,73555,150436,3
2023-03-18,2호선,선릉,27354,23617,50971,3
2023-03-18,2호선,강남,66043,65795,131838,3
2023-03-18,2호선,사당,40872,46098,86970,3
2023-03-18,2호선,신림,51934,50166,102100,3
2023-03-19,1호선,서울역,37684,36185,73869,3
2023-03-19,2호선,잠실(송파구청),57930,55407,113337,3
2023-03-19,2호선,선릉,15276,13268,28544,3
2023-03-19,2호선,강남,37288,35765,73053,3
2023-03-19,2호선,사당,27482,30337,57819,3
2023-03-19,2호선,신림,38744,37606,76350,3
2023-03-19,2호선,구로디지털단지,27714,27085,54799,3
2023-03-19,2호선,홍대입구,65580,64757,130337,3
2023-03-19,3호선,고속터미널,49382,45847,95229,3
2023-03-19,4호선,서울역,5913,15739,21652,3
2023-03-19,4호선,사당,19481,18017,37498,3
2023-03-19,7호선,고속터미널,14967,9768,24735,3
2023-03-19,7호선,가산디지털단지,11984,11200,23184,3
2023-03-19,8호선,잠실(송파구청),12181,13735,25916,3
2023-03-19,9호선,고속터미널,13039,20180,33219,3
2023-03-19,경부선,서울역,10619,2624,13243,3
2023-03-19,경부선,가산디지털단지,5501,7295,12796,3
2023-03-19,경의선,서울역,1340,1249,2589,3
2023-03-19,경의선,홍대입구,2075,2613,4688,3
2023-03-19,공항철도 1호선,서울역,12526,11024,23550,3
2023-03-19,공항철도 1호선,홍대입구,14469,13083,27552,3
2023-03-19,분당선,선릉,3103,4657,7760,3
2023-03-19,신림선,신림,1199,1800,2999,3
2023-03-20,3호선,고속터미널,38967,36708,75675,3
2023-03-20,2호선,홍대입구,64929,66643,131572,3
2023-03-20,2호선,구로디지털단지,64583,64139,128722,3
2023-03-20,2호선,신림,59144,57312,116456,3
2023-03-20,2호선,사당,40260,44861,85121,3
2023-03-20,2호선,강남,85253,82337,167590,3
2023-03-20,2호선,선릉,63862,56318,120180,3
2023-03-20,2호선,잠실(송파구청),73302,73342,146644,3
2023-03-20,7호선,고속터미널,17926,15034,32960,3
2023-03-20,7호선,가산디지털단지,49997,50517,100514,3
2023-03-20,8호선,잠실(송파구청),15072,17680,32752,3
2023-03-20,9호선,고속터미널,13663,18337,32000,3
2023-03-20,경부선,서울역,8618,2533,11151,3
2023-03-20,경부선,가산디지털단지,19687,23031,42718,3
2023-03-20,4호선,사당,27895,24175,52070,3
2023-03-20,4호선,서울역,13878,21120,34998,3
2023-03-20,경의선,서울역,5453,7096,12549,3
2023-03-20,경의선,홍대입구,2021,2402,4423,3
2023-03-20,공항철도 1호선,서울역,11689,10218,21907,3
2023-03-20,공항철도 1호선,홍대입구,12463,12353,24816,3
2023-03-20,분당선,선릉,15012,23048,38060,3
2023-03-20,신림선,신림,1730,2522,4252,3
2023-03-20,1호선,서울역,54259,51057,105316,3
2023-03-21,공항철도 1호선,홍대입구,12494,12387,24881,3
2023-03-21,공항철도 1호선,서울역,11375,9790,21165,3
2023-03-21,4호선,서울역,14174,21423,35597,3
2023-03-21,4호선,사당,28924,25345,54269,3
2023-03-21,7호선,고속터미널,16787,14841,31628,3
2023-03-21,7호선,가산디지털단지,50104,50798,100902,3
2023-03-21,8호선,잠실(송파구청),15067,18008,33075,3
2023-03-21,9호선,고속터미널,14227,18183,32410,3
2023-03-21,경부선,서울역,7083,2204,9287,3
2023-03-21,경부선,가산디지털단지,20133,23291,43424,3
2023-03-21,경의선,서울역,5433,6759,12192,3
2023-03-21,경의선,홍대입구,2039,2329,4368,3
2023-03-21,신림선,신림,1747,2574,4321,3
2023-03-21,분당선,선릉,15629,23920,39549,3
2023-03-21,3호선,고속터미널,43590,41202,84792,3
2023-03-21,2호선,홍대입구,65238,67929,133167,3
2023-03-21,1호선,서울역,52705,50667,103372,3
2023-03-21,2호선,잠실(송파구청),75479,75306,150785,3
2023-03-21,2호선,선릉,66477,58588,125065,3
2023-03-21,2호선,강남,87471,84268,171739,3
2023-03-21,2호선,사당,43114,46989,90103,3
2023-03-21,2호선,신림,61123,58961,120084,3
2023-03-21,2호선,구로디지털단지,65815,65653,131468,3
2023-03-22,1호선,서울역,52567,50013,102580,3
2023-03-22,2호선,잠실(송파구청),75675,75541,151216,3
2023-03-22,2호선,선릉,64941,57398,122339,3
2023-03-22,2호선,강남,86653,83485,170138,3
2023-03-22,2호선,사당,43036,47191,90227,3
2023-03-22,2호선,신림,61713,59704,121417,3
2023-03-22,2호선,구로디지털단지,65627,65632,131259,3
2023-03-22,2호선,홍대입구,65694,69094,134788,3
2023-03-22,3호선,고속터미널,43371,40283,83654,3
2023-03-22,4호선,서울역,14042,20930,34972,3
2023-03-22,4호선,사당,29141,25455,54596,3
2023-03-22,7호선,고속터미널,16678,14738,31416,3
2023-03-22,7호선,가산디지털단지,49906,50679,100585,3
2023-03-22,8호선,잠실(송파구청),15234,17994,33228,3
2023-03-22,9호선,고속터미널,14150,18075,32225,3
2023-03-22,경부선,서울역,6990,2287,9277,3
2023-03-22,경부선,가산디지털단지,20202,23308,43510,3
2023-03-22,경의선,서울역,5320,6795,12115,3
2023-03-22,경의선,홍대입구,2069,2466,4535,3
2023-03-22,공항철도 1호선,서울역,11728,9408,21136,3
2023-03-22,공항철도 1호선,홍대입구,12843,12658,25501,3
2023-03-22,분당선,선릉,15355,23349,38704,3
2023-03-22,신림선,신림,1833,2555,4388,3
2023-03-23,4호선,사당,29637,25858,55495,3
2023-03-23,4호선,서울역,14329,22309,36638,3
2023-03-23,3호선,고속터미널,45551,42319,87870,3
2023-03-23,2호선,홍대입구,68338,72598,140936,3
2023-03-23,2호선,구로디지털단지,66512,66057,132569,3
2023-03-23,2호선,신림,61757,59599,121356,3
2023-03-23,2호선,사당,43787,48237,92024,3
2023-03-23,2호선,강남,88382,85240,173622,3
2023-03-23,2호선,선릉,65502,58071,123573,3
2023-03-23,2호선,잠실(송파구청),75745,76511,152256,3
2023-03-23,1호선,서울역,54863,52997,107860,3
2023-03-23,7호선,고속터미널,17473,14992,32465,3
2023-03-23,7호선,가산디지털단지,49113,50284,99397,3
2023-03-23,8호선,잠실(송파구청),15492,18098,33590,3
2023-03-23,9호선,고속터미널,14956,18463,33419,3
2023-03-23,경부선,서울역,7949,2551,10500,3
2023-03-23,경부선,가산디지털단지,20174,23081,43255,3
2023-03-23,경의선,서울역,5341,6818,12159,3
2023-03-23,경의선,홍대입구,2087,2590,4677,3
2023-03-23,공항철도 1호선,서울역,12390,9939,22329,3
2023-03-23,공항철도 1호선,홍대입구,13242,13351,26593,3
2023-03-23,분당선,선릉,15399,23401,38800,3
2023-03-23,신림선,신림,1825,2522,4347,3
2023-03-24,1호선,서울역,62081,61409,123490,3
2023-03-24,2호선,잠실(송파구청),82717,83073,165790,3
2023-03-24,2호선,선릉,64518,57440,121958,3
2023-03-24,2호선,강남,94541,92842,187383,3
2023-03-24,2호선,사당,47527,52692,100219,3
2023-03-24,2호선,신림,63964,61872,125836,3
2023-03-24,2호선,구로디지털단지,67798,66998,134796,3
2023-03-24,2호선,홍대입구,74782,85001,159783,3
2023-03-24,3호선,고속터미널,55212,55999,111211,3
2023-03-24,4호선,서울역,14251,25826,40077,3
2023-03-24,4호선,사당,31898,28163,60061,3
2023-03-24,7호선,고속터미널,20901,16783,37684,3
2023-03-24,7호선,가산디지털단지,49434,50072,99506,3
2023-03-24,8호선,잠실(송파구청),16842,19933,36775,3
2023-03-24,9호선,고속터미널,17700,23782,41482,3
2023-03-24,경부선,서울역,10873,3594,14467,3
2023-03-24,경부선,가산디지털단지,20574,23112,43686,3
2023-03-24,경의선,서울역,5460,7168,12628,3
2023-03-24,경의선,홍대입구,2436,3055,5491,3
2023-03-24,공항철도 1호선,서울역,14818,12970,27788,3
2023-03-24,공항철도 1호선,홍대입구,14978,15163,30141,3
2023-03-24,분당선,선릉,15165,23203,38368,3
2023-03-24,신림선,신림,1863,2674,4537,3
2023-03-25,4호선,서울역,8526,20516,29042,3
2023-03-25,1호선,서울역,49643,48093,97736,3
2023-03-25,2호선,잠실(송파구청),80171,76985,157156,3
2023-03-25,2호선,선릉,28450,24647,53097,3
2023-03-25,2호선,강남,65735,65434,131169,3
2023-03-25,경부선,서울역,11074,3018,14092,3
2023-03-25,경부선,가산디지털단지,7662,9762,17424,3
2023-03-25,경의선,서울역,1833,1984,3817,3
2023-03-25,경의선,홍대입구,2661,3681,6342,3
2023-03-25,공항철도 1호선,서울역,13632,12350,25982,3
2023-03-25,공항철도 1호선,홍대입구,18160,18283,36443,3
2023-03-25,분당선,선릉,5819,9367,15186,3
2023-03-25,신림선,신림,1506,2030,3536,3
2023-03-25,2호선,사당,40463,45509,85972,3
2023-03-25,2호선,신림,52374,49876,102250,3
2023-03-25,2호선,구로디지털단지,39309,38592,77901,3
2023-03-25,2호선,홍대입구,83779,95042,178821,3
2023-03-25,3호선,고속터미널,60716,59804,120520,3
2023-03-25,4호선,사당,27580,25472,53052,3
2023-03-25,7호선,고속터미널,18077,13916,31993,3
2023-03-25,7호선,가산디지털단지,16522,15663,32185,3
2023-03-25,8호선,잠실(송파구청),16200,18565,34765,3
2023-03-25,9호선,고속터미널,16987,25223,42210,3
2023-03-26,분당선,선릉,3162,4802,7964,3
2023-03-26,공항철도 1호선,홍대입구,14254,13253,27507,3
2023-03-26,공항철도 1호선,서울역,12699,11377,24076,3
2023-03-26,경의선,홍대입구,2017,2568,4585,3
2023-03-26,경의선,서울역,1403,1329,2732,3
2023-03-26,경부선,가산디지털단지,5685,7380,13065,3
2023-03-26,7호선,고속터미널,15891,9962,25853,3
2023-03-26,7호선,가산디지털단지,12227,11538,23765,3
2023-03-26,8호선,잠실(송파구청),13817,14615,28432,3
2023-03-26,9호선,고속터미널,14026,20663,34689,3
2023-03-26,경부선,서울역,10677,2546,13223,3
2023-03-26,신림선,신림,1204,1861,3065,3
2023-03-26,1호선,서울역,36939,36346,73285,3
2023-03-26,2호선,잠실(송파구청),63652,58676,122328,3
2023-03-26,2호선,선릉,15232,12991,28223,3
2023-03-26,2호선,강남,37136,35246,72382,3
2023-03-26,2호선,사당,27242,30035,57277,3
2023-03-26,2호선,신림,39203,37891,77094,3
2023-03-26,2호선,구로디지털단지,27876,27099,54975,3
2023-03-26,2호선,홍대입구,65675,64280,129955,3
2023-03-26,3호선,고속터미널,51659,47373,99032,3
2023-03-26,4호선,서울역,6041,16035,22076,3
2023-03-26,4호선,사당,19610,18219,37829,3
2023-03-27,신림선,신림,1756,2619,4375,3
2023-03-27,분당선,선릉,15064,22791,37855,3
2023-03-27,공항철도 1호선,홍대입구,12290,11909,24199,3
2023-03-27,공항철도 1호선,서울역,12863,10608,23471,3
2023-03-27,경의선,홍대입구,1888,2202,4090,3
2023-03-27,경의선,서울역,5476,6981,12457,3
2023-03-27,경부선,가산디지털단지,20365,23178,43543,3
2023-03-27,경부선,서울역,9222,2654,11876,3
2023-03-27,9호선,고속터미널,13978,18331,32309,3
2023-03-27,8호선,잠실(송파구청),16440,18928,35368,3
2023-03-27,7호선,가산디지털단지,49386,50432,99818,3
2023-03-27,7호선,고속터미널,17271,14624,31895,3
2023-03-27,4호선,사당,27632,24041,51673,3
2023-03-27,4호선,서울역,13562,21699,35261,3
2023-03-27,3호선,고속터미널,44281,41710,85991,3
2023-03-27,2호선,홍대입구,64234,66244,130478,3
2023-03-27,2호선,구로디지털단지,64546,64096,128642,3
2023-03-27,2호선,신림,59208,57199,116407,3
2023-03-27,2호선,사당,40474,44671,85145,3
2023-03-27,2호선,강남,85882,82556,168438,3
2023-03-27,2호선,선릉,63424,56741,120165,3
2023-03-27,2호선,잠실(송파구청),79807,79653,159460,3
2023-03-27,1호선,서울역,55716,52759,108475,3
2023-03-28,8호선,잠실(송파구청),16804,19622,36426,3
2023-03-28,신림선,신림,1847,2598,4445,3
2023-03-28,분당선,선릉,15358,23074,38432,3
2023-03-28,공항철도 1호선,홍대입구,12697,12648,25345,3
2023-03-28,공항철도 1호선,서울역,12209,10321,22530,3
2023-03-28,경의선,홍대입구,2018,2541,4559,3
2023-03-28,경의선,서울역,5572,7057,12629,3
2023-03-28,경부선,가산디지털단지,20496,23270,43766,3
2023-03-28,9호선,고속터미널,14366,18174,32540,3
2023-03-28,1호선,서울역,54843,52182,107025,3
2023-03-28,2호선,잠실(송파구청),84601,84834,169435,3
2023-03-28,2호선,선릉,65362,57914,123276,3
2023-03-28,2호선,강남,87127,84333,171460,3
2023-03-28,2호선,사당,42846,47251,90097,3
2023-03-28,2호선,신림,61333,59058,120391,3
2023-03-28,2호선,구로디지털단지,66697,66124,132821,3
2023-03-28,2호선,홍대입구,66205,68974,135179,3
2023-03-28,3호선,고속터미널,43345,40899,84244,3
2023-03-28,4호선,서울역,14158,21508,35666,3
2023-03-28,4호선,사당,29335,25427,54762,3
2023-03-28,7호선,고속터미널,17094,14896,31990,3
2023-03-28,7호선,가산디지털단지,49599,50743,100342,3
2023-03-28,경부선,서울역,7906,2477,10383,3
2023-03-29,9호선,고속터미널,14117,18344,32461,3
2023-03-29,분당선,선릉,15074,23154,38228,3
2023-03-29,공항철도 1호선,홍대입구,13220,12815,26035,3
2023-03-29,공항철도 1호선,서울역,11994,9905,21899,3
2023-03-29,경의선,홍대입구,2091,2500,4591,3
2023-03-29,경의선,서울역,5343,7003,12346,3
2023-03-29,경부선,서울역,7595,2432,10027,3
2023-03-29,경부선,가산디지털단지,20570,23474,44044,3
2023-03-29,신림선,신림,1883,2524,4407,3
2023-03-29,1호선,서울역,54429,52670,107099,3
2023-03-29,2호선,잠실(송파구청),89265,89586,178851,3
2023-03-29,2호선,선릉,65021,57640,122661,3
2023-03-29,2호선,강남,86589,83451,170040,3
2023-03-29,2호선,사당,43297,47500,90797,3
2023-03-29,2호선,신림,61429,59794,121223,3
2023-03-29,2호선,구로디지털단지,66240,65897,132137,3
2023-03-29,2호선,홍대입구,66475,69431,135906,3
2023-03-29,3호선,고속터미널,43198,40369,83567,3
2023-03-29,4호선,서울역,14410,21858,36268,3
2023-03-29,4호선,사당,29439,25597,55036,3
2023-03-29,7호선,고속터미널,16633,14895,31528,3
2023-03-29,7호선,가산디지털단지,49250,50608,99858,3
2023-03-29,8호선,잠실(송파구청),18218,20946,39164,3
2023-03-30,신림선,신림,1850,2582,4432,3
2023-03-30,분당선,선릉,15296,23271,38567,3
2023-03-30,공항철도 1호선,홍대입구,13575,13506,27081,3
2023-03-30,공항철도 1호선,서울역,12719,10480,23199,3
2023-03-30,경의선,홍대입구,2006,2525,4531,3
2023-03-30,경의선,서울역,5440,7131,12571,3
2023-03-30,경부선,가산디지털단지,20831,23450,44281,3
2023-03-30,경부선,서울역,8314,2648,10962,3
2023-03-30,9호선,고속터미널,14812,18913,33725,3
2023-03-30,8호선,잠실(송파구청),19012,22134,41146,3
2023-03-30,7호선,가산디지털단지,48902,50528,99430,3
2023-03-30,7호선,고속터미널,17720,15174,32894,3
2023-03-30,4호선,사당,29723,25699,55422,3
2023-03-30,4호선,서울역,14247,22749,36996,3
2023-03-30,3호선,고속터미널,45851,42962,88813,3
2023-03-30,2호선,홍대입구,68881,72447,141328,3
2023-03-30,2호선,구로디지털단지,66601,65883,132484,3
2023-03-30,2호선,신림,62387,59643,122030,3
2023-03-30,2호선,사당,43914,48369,92283,3
2023-03-30,2호선,강남,87330,84346,171676,3
2023-03-30,2호선,선릉,64839,57835,122674,3
2023-03-30,2호선,잠실(송파구청),95072,95661,190733,3
2023-03-30,1호선,서울역,56496,54539,111035,3
2023-03-31,1호선,서울역,63173,62161,125334,3
2023-03-31,2호선,잠실(송파구청),108416,109576,217992,3
2023-03-31,2호선,선릉,63683,56623,120306,3
2023-03-31,2호선,강남,92544,91246,183790,3
2023-03-31,2호선,사당,46263,51595,97858,3
2023-03-31,2호선,신림,64246,61477,125723,3
2023-03-31,2호선,구로디지털단지,66804,65957,132761,3
2023-03-31,2호선,홍대입구,74683,84728,159411,3
2023-03-31,3호선,고속터미널,55312,56338,111650,3
2023-03-31,4호선,서울역,14717,25333,40050,3
2023-03-31,4호선,사당,31557,27712,59269,3
2023-03-31,7호선,고속터미널,20685,16895,37580,3
2023-03-31,7호선,가산디지털단지,49151,50292,99443,3
2023-03-31,8호선,잠실(송파구청),21060,24480,45540,3
2023-03-31,9호선,고속터미널,17919,24507,42426,3
2023-03-31,경부선,서울역,10740,3859,14599,3
2023-03-31,경부선,가산디지털단지,21107,23776,44883,3
2023-03-31,경의선,서울역,5483,7359,12842,3
2023-03-31,경의선,홍대입구,2352,2978,5330,3
2023-03-31,공항철도 1호선,서울역,14524,12956,27480,3
2023-03-31,공항철도 1호선,홍대입구,15176,15327,30503,3
2023-03-31,분당선,선릉,14860,22693,37553,3
2023-03-31,신림선,신림,1896,2589,4485,3
2023-04-01,4호선,사당,27309,24766,52075,4
2023-04-01,4호선,서울역,8002,19696,27698,4
2023-04-01,3호선,고속터미널,59541,58744,118285,4
2023-04-01,2호선,홍대입구,81569,92187,173756,4
2023-04-01,2호선,구로디지털단지,39245,37915,77160,4
2023-04-01,2호선,신림,52498,49719,102217,4
2023-04-01,2호선,사당,39246,44656,83902,4
2023-04-01,2호선,강남,62213,62075,124288,4
2023-04-01,2호선,선릉,27134,23721,50855,4
2023-04-01,2호선,잠실(송파구청),125862,123306,249168,4
2023-04-01,1호선,서울역,47075,46426,93501,4
2023-04-01,신림선,신림,1601,2297,3898,4
2023-04-01,분당선,선릉,5696,8778,14474,4
2023-04-01,공항철도 1호선,홍대입구,18406,17683,36089,4
2023-04-01,공항철도 1호선,서울역,13575,13165,26740,4
2023-04-01,경의선,홍대입구,2625,3452,6077,4
2023-04-01,경의선,서울역,1896,2046,3942,4
2023-04-01,경부선,가산디지털단지,8238,10246,18484,4
2023-04-01,경부선,서울역,11019,3028,14047,4
2023-04-01,9호선,고속터미널,18810,27458,46268,4
2023-04-01,8호선,잠실(송파구청),23742,26477,50219,4
2023-04-01,7호선,가산디지털단지,16888,15557,32445,4
2023-04-01,7호선,고속터미널,17646,13620,31266,4
2023-04-02,4호선,사당,20188,17980,38168,4
2023-04-02,4호선,서울역,5872,15654,21526,4
2023-04-02,3호선,고속터미널,51754,45996,97750,4
2023-04-02,2호선,홍대입구,63437,62884,126321,4
2023-04-02,2호선,구로디지털단지,28291,27733,56024,4
2023-04-02,2호선,신림,39894,38425,78319,4
2023-04-02,2호선,사당,27040,29779,56819,4
2023-04-02,2호선,강남,35163,34262,69425,4
2023-04-02,2호선,선릉,15192,12838,28030,4
2023-04-02,2호선,잠실(송파구청),97584,92350,189934,4
2023-04-02,1호선,서울역,38127,36909,75036,4
2023-04-02,7호선,고속터미널,16981,10074,27055,4
2023-04-02,7호선,가산디지털단지,12597,11902,24499,4
2023-04-02,8호선,잠실(송파구청),18269,19450,37719,4
2023-04-02,9호선,고속터미널,15743,22137,37880,4
2023-04-02,신림선,신림,1409,2104,3513,4
2023-04-02,경부선,가산디지털단지,6272,8072,14344,4
2023-04-02,경부선,서울역,11039,2562,13601,4
2023-04-02,분당선,선릉,3176,4717,7893,4
2023-04-02,공항철도 1호선,홍대입구,14690,13414,28104,4
2023-04-02,공항철도 1호선,서울역,13315,12024,25339,4
2023-04-02,경의선,홍대입구,2123,2472,4595,4
2023-04-02,경의선,서울역,1426,1397,2823,4
2023-04-03,신림선,신림,1854,2660,4514,4
2023-04-03,1호선,서울역,56131,52061,108192,4
2023-04-03,2호선,잠실(송파구청),94385,94763,189148,4
2023-04-03,2호선,선릉,63428,56617,120045,4
2023-04-03,2호선,강남,85075,82445,167520,4
2023-04-03,2호선,사당,40311,44906,85217,4
2023-04-03,2호선,신림,60170,57779,117949,4
2023-04-03,2호선,구로디지털단지,65030,64359,129389,4
2023-04-03,2호선,홍대입구,65705,67840,133545,4
2023-04-03,3호선,고속터미널,44837,41947,86784,4
2023-04-03,4호선,서울역,13695,20865,34560,4
2023-04-03,4호선,사당,27983,24386,52369,4
2023-04-03,7호선,고속터미널,18222,15130,33352,4
2023-04-03,7호선,가산디지털단지,49928,50978,100906,4
2023-04-03,8호선,잠실(송파구청),17946,20533,38479,4
2023-04-03,9호선,고속터미널,15035,19266,34301,4
2023-04-03,경부선,서울역,9200,2552,11752,4
2023-04-03,경부선,가산디지털단지,20537,23530,44067,4
2023-04-03,경의선,서울역,5456,7222,12678,4
2023-04-03,경의선,홍대입구,2147,2446,4593,4
2023-04-03,공항철도 1호선,서울역,12445,10745,23190,4
2023-04-03,공항철도 1호선,홍대입구,12920,12829,25749,4
2023-04-03,분당선,선릉,15038,22827,37865,4
2023-04-04,공항철도 1호선,서울역,11547,9910,21457,4
2023-04-04,공항철도 1호선,홍대입구,12431,12280,24711,4
2023-04-04,분당선,선릉,15606,23241,38847,4
2023-04-04,경의선,서울역,5353,6753,12106,4
2023-04-04,9호선,고속터미널,13990,17662,31652,4
2023-04-04,1호선,서울역,53754,50769,104523,4
2023-04-04,2호선,잠실(송파구청),86034,85981,172015,4
2023-04-04,2호선,선릉,65460,57653,123113,4
2023-04-04,2호선,강남,87406,84033,171439,4
2023-04-04,2호선,사당,42200,46179,88379,4
2023-04-04,2호선,신림,60768,58343,119111,4
2023-04-04,2호선,구로디지털단지,65626,64904,130530,4
2023-04-04,2호선,홍대입구,66899,68272,135171,4
2023-04-04,3호선,고속터미널,41540,38875,80415,4
2023-04-04,4호선,서울역,14109,20833,34942,4
2023-04-04,4호선,사당,29143,24722,53865,4
2023-04-04,7호선,고속터미널,16540,14601,31141,4
2023-04-04,7호선,가산디지털단지,50145,50539,100684,4
2023-04-04,8호선,잠실(송파구청),16818,19191,36009,4
2023-04-04,경부선,서울역,7339,2266,9605,4
2023-04-04,경부선,가산디지털단지,20437,23602,44039,4
2023-04-04,경의선,홍대입구,1980,2406,4386,4
2023-04-04,신림선,신림,1890,2673,4563,4
2023-04-05,신림선,신림,1787,2528,4315,4
2023-04-05,2호선,홍대입구,61396,64461,125857,4
2023-04-05,2호선,구로디지털단지,62652,62516,125168,4
2023-04-05,2호선,신림,58375,55789,114164,4
2023-04-05,2호선,사당,39551,43441,82992,4
2023-04-05,2호선,강남,83255,80375,163630,4
2023-04-05,2호선,선릉,62666,55178,117844,4
2023-04-05,2호선,잠실(송파구청),74225,75197,149422,4
2023-04-05,1호선,서울역,52944,49548,102492,4
2023-04-05,8호선,잠실(송파구청),15281,17899,33180,4
2023-04-05,분당선,선릉,14852,22742,37594,4
2023-04-05,공항철도 1호선,홍대입구,11626,11487,23113,4
2023-04-05,공항철도 1호선,서울역,11760,10626,22386,4
2023-04-05,경의선,홍대입구,1862,2170,4032,4
2023-04-05,경의선,서울역,4853,6268,11121,4
2023-04-05,경부선,가산디지털단지,19324,22290,41614,4
2023-04-05,경부선,서울역,7131,2447,9578,4
2023-04-05,9호선,고속터미널,13313,17619,30932,4
2023-04-05,7호선,가산디지털단지,48464,49097,97561,4
2023-04-05,7호선,고속터미널,15689,13721,29410,4
2023-04-05,4호선,사당,26942,23458,50400,4
2023-04-05,4호선,서울역,13661,20809,34470,4
2023-04-05,3호선,고속터미널,40921,38005,78926,4
2023-04-06,신림선,신림,1912,2604,4516,4
2023-04-06,분당선,선릉,15277,23274,38551,4
2023-04-06,공항철도 1호선,홍대입구,12923,12979,25902,4
2023-04-06,공항철도 1호선,서울역,12280,10662,22942,4
2023-04-06,경의선,홍대입구,1974,2407,4381,4
2023-04-06,경의선,서울역,5167,6893,12060,4
2023-04-06,경부선,가산디지털단지,19903,22860,42763,4
2023-04-06,경부선,서울역,7647,2735,10382,4
2023-04-06,9호선,고속터미널,14144,18383,32527,4
2023-04-06,8호선,잠실(송파구청),16253,18669,34922,4
2023-04-06,7호선,가산디지털단지,49152,50062,99214,4
2023-04-06,7호선,고속터미널,16835,14385,31220,4
2023-04-06,4호선,사당,29116,24773,53889,4
2023-04-06,4호선,서울역,14310,22268,36578,4
2023-04-06,3호선,고속터미널,44669,41783,86452,4
2023-04-06,2호선,홍대입구,69340,72761,142101,4
2023-04-06,2호선,구로디지털단지,65115,64554,129669,4
2023-04-06,2호선,신림,61287,58820,120107,4
2023-04-06,2호선,사당,42036,46169,88205,4
2023-04-06,2호선,강남,88172,85142,173314,4
2023-04-06,2호선,선릉,64783,57438,122221,4
2023-04-06,2호선,잠실(송파구청),79348,79897,159245,4
2023-04-06,1호선,서울역,56790,53492,110282,4
2023-04-07,4호선,사당,31660,27680,59340,4
2023-04-07,4호선,서울역,14717,25196,39913,4
2023-04-07,3호선,고속터미널,55637,56203,111840,4
2023-04-07,2호선,홍대입구,77751,87528,165279,4
2023-04-07,2호선,구로디지털단지,67304,66540,133844,4
2023-04-07,2호선,신림,64395,62230,126625,4
2023-04-07,2호선,사당,46156,51316,97472,4
2023-04-07,2호선,강남,94929,92751,187680,4
2023-04-07,2호선,선릉,64236,57049,121285,4
2023-04-07,2호선,잠실(송파구청),91043,90554,181597,4
2023-04-07,7호선,고속터미널,20270,16570,36840,4
2023-04-07,7호선,가산디지털단지,49140,49337,98477,4
2023-04-07,8호선,잠실(송파구청),17778,21157,38935,4
2023-04-07,9호선,고속터미널,17461,23888,41349,4
2023-04-07,경부선,서울역,10850,3484,14334,4
2023-04-07,경부선,가산디지털단지,20427,23090,43517,4
2023-04-07,경의선,서울역,5559,7071,12630,4
2023-04-07,경의선,홍대입구,2283,3074,5357,4
2023-04-07,1호선,서울역,62958,61003,123961,4
2023-04-07,공항철도 1호선,서울역,14838,13453,28291,4
2023-04-07,공항철도 1호선,홍대입구,15439,15702,31141,4
2023-04-07,분당선,선릉,14834,22888,37722,4
2023-04-07,신림선,신림,2038,2724,4762,4
2023-04-08,2호선,사당,39433,44155,83588,4
2023-04-08,2호선,강남,63925,63499,127424,4
2023-04-08,2호선,선릉,28155,24543,52698,4
2023-04-08,2호선,잠실(송파구청),84943,80972,165915,4
2023-04-08,신림선,신림,1458,2126,3584,4
2023-04-08,분당선,선릉,5920,9054,14974,4
2023-04-08,공항철도 1호선,홍대입구,17658,17563,35221,4
2023-04-08,공항철도 1호선,서울역,13660,13208,26868,4
2023-04-08,경의선,홍대입구,2594,3405,5999,4
2023-04-08,경의선,서울역,1896,2081,3977,4
2023-04-08,경부선,가산디지털단지,7602,9623,17225,4
2023-04-08,경부선,서울역,10874,2900,13774,4
2023-04-08,9호선,고속터미널,18318,27037,45355,4
2023-04-08,8호선,잠실(송파구청),16154,18713,34867,4
2023-04-08,7호선,가산디지털단지,16101,14720,30821,4
2023-04-08,7호선,고속터미널,17673,13577,31250,4
2023-04-08,1호선,서울역,47172,45622,92794,4
2023-04-08,4호선,사당,26755,24468,51223,4
2023-04-08,4호선,서울역,8094,19526,27620,4
2023-04-08,3호선,고속터미널,60959,59024,119983,4
2023-04-08,2호선,홍대입구,83698,93713,177411,4
2023-04-08,2호선,구로디지털단지,38889,38054,76943,4
2023-04-08,2호선,신림,51662,49147,100809,4
2023-04-09,1호선,서울역,38502,36509,75011,4
2023-04-09,8호선,잠실(송파구청),11662,12667,24329,4
2023-04-09,7호선,가산디지털단지,11939,11131,23070,4
2023-04-09,7호선,고속터미널,17097,10271,27368,4
2023-04-09,4호선,사당,18610,17023,35633,4
2023-04-09,4호선,서울역,6042,15803,21845,4
2023-04-09,3호선,고속터미널,51035,46013,97048,4
2023-04-09,2호선,홍대입구,63058,63171,126229,4
2023-04-09,경부선,가산디지털단지,5770,7599,13369,4
2023-04-09,경부선,서울역,10953,2669,13622,4
2023-04-09,9호선,고속터미널,14723,21851,36574,4
2023-04-09,신림선,신림,1227,1756,2983,4
2023-04-09,분당선,선릉,3260,4963,8223,4
2023-04-09,공항철도 1호선,홍대입구,14343,13001,27344,4
2023-04-09,공항철도 1호선,서울역,12401,12251,24652,4
2023-04-09,2호선,구로디지털단지,27437,26672,54109,4
2023-04-09,경의선,홍대입구,1953,2474,4427,4
2023-04-09,경의선,서울역,1448,1328,2776,4
2023-04-09,2호선,신림,38425,37605,76030,4
2023-04-09,2호선,사당,26105,28664,54769,4
2023-04-09,2호선,강남,36432,34354,70786,4
2023-04-09,2호선,선릉,16014,13685,29699,4
2023-04-09,2호선,잠실(송파구청),61597,56112,117709,4
2023-04-10,신림선,신림,1836,2715,4551,4
2023-04-10,분당선,선릉,15364,23228,38592,4
2023-04-10,공항철도 1호선,홍대입구,12670,12229,24899,4
2023-04-10,공항철도 1호선,서울역,11952,10973,22925,4
2023-04-10,경의선,홍대입구,2004,2272,4276,4
2023-04-10,경의선,서울역,5382,7062,12444,4
2023-04-10,경부선,가산디지털단지,20341,23291,43632,4
2023-04-10,경부선,서울역,8829,2553,11382,4
2023-04-10,9호선,고속터미널,14696,19091,33787,4
2023-04-10,8호선,잠실(송파구청),15046,17770,32816,4
2023-04-10,7호선,가산디지털단지,49811,50619,100430,4
2023-04-10,7호선,고속터미널,17517,14581,32098,4
2023-04-10,4호선,사당,27806,24143,51949,4
2023-04-10,4호선,서울역,13605,21514,35119,4
2023-04-10,3호선,고속터미널,44514,42236,86750,4
2023-04-10,2호선,홍대입구,64854,67063,131917,4
2023-04-10,2호선,구로디지털단지,64574,64246,128820,4
2023-04-10,2호선,신림,60092,58096,118188,4
2023-04-10,2호선,사당,40499,44860,85359,4
2023-04-10,2호선,강남,85001,82011,167012,4
2023-04-10,2호선,선릉,64364,57150,121514,4
2023-04-10,2호선,잠실(송파구청),76530,76906,153436,4
2023-04-10,1호선,서울역,56010,52515,108525,4
2023-04-11,경의선,서울역,5118,6651,11769,4
2023-04-11,경의선,홍대입구,1942,2249,4191,4
2023-04-11,공항철도 1호선,서울역,10826,9995,20821,4
2023-04-11,공항철도 1호선,홍대입구,11696,11790,23486,4
2023-04-11,분당선,선릉,15094,23092,38186,4
2023-04-11,신림선,신림,1774,2548,4322,4
2023-04-11,경부선,가산디지털단지,19928,22862,42790,4
2023-04-11,경부선,서울역,7458,2378,9836,4
2023-04-11,9호선,고속터미널,13291,17556,30847,4
2023-04-11,8호선,잠실(송파구청),14831,17466,32297,4
2023-04-11,7호선,가산디지털단지,49038,49556,98594,4
2023-04-11,7호선,고속터미널,16682,14572,31254,4
2023-04-11,4호선,사당,27642,24000,51642,4
2023-04-11,4호선,서울역,13827,20695,34522,4
2023-04-11,3호선,고속터미널,41177,38551,79728,4
2023-04-11,2호선,홍대입구,62404,64960,127364,4
2023-04-11,2호선,구로디지털단지,64226,63521,127747,4
2023-04-11,2호선,신림,59034,57175,116209,4
2023-04-11,2호선,사당,40483,44667,85150,4
2023-04-11,2호선,강남,85195,82108,167303,4
2023-04-11,2호선,선릉,63444,56176,119620,4
2023-04-11,2호선,잠실(송파구청),74415,74545,148960,4
2023-04-11,1호선,서울역,53238,50020,103258,4
2023-04-12,분당선,선릉,15519,23773,39292,4
2023-04-12,공항철도 1호선,홍대입구,13254,12888,26142,4
2023-04-12,공항철도 1호선,서울역,11492,10342,21834,4
2023-04-12,경의선,홍대입구,2211,2520,4731,4
2023-04-12,경의선,서울역,5262,6776,12038,4
2023-04-12,경부선,가산디지털단지,20413,23392,43805,4
2023-04-12,경부선,서울역,7663,2372,10035,4
2023-04-12,9호선,고속터미널,14206,18617,32823,4
2023-04-12,8호선,잠실(송파구청),15913,18581,34494,4
2023-04-12,7호선,가산디지털단지,49825,50354,100179,4
2023-04-12,7호선,고속터미널,17080,15151,32231,4
2023-04-12,4호선,사당,29038,25427,54465,4
2023-04-12,4호선,서울역,14235,21341,35576,4
2023-04-12,1호선,서울역,54897,52020,106917,4
2023-04-12,2호선,잠실(송파구청),79006,79025,158031,4
2023-04-12,2호선,선릉,66132,58490,124622,4
2023-04-12,2호선,강남,87701,83804,171505,4
2023-04-12,2호선,사당,42906,47325,90231,4
2023-04-12,2호선,신림,61908,60008,121916,4
2023-04-12,2호선,구로디지털단지,66689,66033,132722,4
2023-04-12,2호선,홍대입구,67226,70224,137450,4
2023-04-12,3호선,고속터미널,44186,41215,85401,4
2023-04-12,신림선,신림,1865,2528,4393,4
2023-04-13,신림선,신림,1807,2636,4443,4
2023-04-13,분당선,선릉,15410,23500,38910,4
2023-04-13,공항철도 1호선,홍대입구,13230,13076,26306,4
2023-04-13,공항철도 1호선,서울역,12450,10883,23333,4
2023-04-13,경의선,홍대입구,2009,2493,4502,4
2023-04-13,경의선,서울역,5348,7021,12369,4
2023-04-13,경부선,가산디지털단지,20936,23279,44215,4
2023-04-13,경부선,서울역,8373,2610,10983,4
2023-04-13,9호선,고속터미널,15184,19092,34276,4
2023-04-13,8호선,잠실(송파구청),15852,18797,34649,4
2023-04-13,7호선,가산디지털단지,48245,49794,98039,4
2023-04-13,7호선,고속터미널,17386,14943,32329,4
2023-04-13,4호선,사당,29514,25992,55506,4
2023-04-13,4호선,서울역,14247,22525,36772,4
2023-04-13,3호선,고속터미널,45724,42771,88495,4
2023-04-13,2호선,홍대입구,68232,71889,140121,4
2023-04-13,2호선,구로디지털단지,66236,65705,131941,4
2023-04-13,2호선,신림,61932,59780,121712,4
2023-04-13,2호선,사당,44204,48434,92638,4
2023-04-13,2호선,강남,88161,84760,172921,4
2023-04-13,2호선,선릉,65158,57972,123130,4
2023-04-13,2호선,잠실(송파구청),80010,80018,160028,4
2023-04-13,1호선,서울역,56801,53827,110628,4
2023-04-14,신림선,신림,1879,2712,4591,4
2023-04-14,분당선,선릉,14861,22681,37542,4
2023-04-14,공항철도 1호선,홍대입구,14796,14731,29527,4
2023-04-14,공항철도 1호선,서울역,14870,13178,28048,4
2023-04-14,경의선,홍대입구,2277,2951,5228,4
2023-04-14,경의선,서울역,5258,6980,12238,4
2023-04-14,경부선,가산디지털단지,20633,22905,43538,4
2023-04-14,경부선,서울역,9945,3492,13437,4
2023-04-14,7호선,고속터미널,20475,16480,36955,4
2023-04-14,7호선,가산디지털단지,47270,47995,95265,4
2023-04-14,8호선,잠실(송파구청),16441,19575,36016,4
2023-04-14,4호선,사당,30801,27370,58171,4
2023-04-14,4호선,서울역,13389,23854,37243,4
2023-04-14,3호선,고속터미널,54199,54465,108664,4
2023-04-14,2호선,홍대입구,72861,82405,155266,4
2023-04-14,2호선,구로디지털단지,66650,65642,132292,4
2023-04-14,2호선,신림,63873,61462,125335,4
2023-04-14,2호선,사당,45731,50707,96438,4
2023-04-14,2호선,강남,92116,90514,182630,4
2023-04-14,2호선,선릉,63379,56210,119589,4
2023-04-14,2호선,잠실(송파구청),84657,84318,168975,4
2023-04-14,1호선,서울역,61601,58977,120578,4
2023-04-14,9호선,고속터미널,17155,24033,41188,4
2023-04-15,1호선,서울역,45404,43025,88429,4
2023-04-15,2호선,잠실(송파구청),73832,71521,145353,4
2023-04-15,2호선,선릉,26134,22827,48961,4
2023-04-15,2호선,강남,59566,59541,119107,4
2023-04-15,2호선,사당,37022,41648,78670,4
2023-04-15,2호선,신림,48912,47072,95984,4
2023-04-15,2호선,구로디지털단지,37567,36256,73823,4
2023-04-15,2호선,홍대입구,74383,83465,157848,4
2023-04-15,3호선,고속터미널,57450,56435,113885,4
2023-04-15,4호선,서울역,7847,18335,26182,4
2023-04-15,4호선,사당,24726,22906,47632,4
2023-04-15,7호선,고속터미널,17121,12852,29973,4
2023-04-15,7호선,가산디지털단지,14909,13695,28604,4
2023-04-15,8호선,잠실(송파구청),14578,17381,31959,4
2023-04-15,9호선,고속터미널,16148,23925,40073,4
2023-04-15,경부선,서울역,10008,2735,12743,4
2023-04-15,경부선,가산디지털단지,7147,8913,16060,4
2023-04-15,경의선,서울역,1671,1786,3457,4
2023-04-15,경의선,홍대입구,2266,3007,5273,4
2023-04-15,공항철도 1호선,서울역,12983,12579,25562,4
2023-04-15,공항철도 1호선,홍대입구,16141,16317,32458,4
2023-04-15,분당선,선릉,5460,8601,14061,4
2023-04-15,신림선,신림,1421,1941,3362,4
2023-04-16,신림선,신림,1198,1709,2907,4
2023-04-16,분당선,선릉,3105,4636,7741,4
2023-04-16,공항철도 1호선,홍대입구,13439,12268,25707,4
2023-04-16,공항철도 1호선,서울역,12746,11477,24223,4
2023-04-16,경의선,홍대입구,1864,2329,4193,4
2023-04-16,경의선,서울역,1353,1223,2576,4
2023-04-16,경부선,가산디지털단지,5558,7301,12859,4
2023-04-16,경부선,서울역,9922,2252,12174,4
2023-04-16,9호선,고속터미널,13975,19547,33522,4
2023-04-16,8호선,잠실(송파구청),11542,12697,24239,4
2023-04-16,7호선,가산디지털단지,11713,10926,22639,4
2023-04-16,7호선,고속터미널,15246,9591,24837,4
2023-04-16,4호선,사당,18220,16976,35196,4
2023-04-16,4호선,서울역,5543,14479,20022,4
2023-04-16,3호선,고속터미널,48362,44461,92823,4
2023-04-16,2호선,홍대입구,59364,58179,117543,4
2023-04-16,2호선,구로디지털단지,27101,26511,53612,4
2023-04-16,2호선,신림,37421,36401,73822,4
2023-04-16,2호선,사당,26616,27974,54590,4
2023-04-16,2호선,강남,35749,33849,69598,4
2023-04-16,2호선,선릉,14961,12728,27689,4
2023-04-16,2호선,잠실(송파구청),57139,52928,110067,4
2023-04-16,1호선,서울역,36512,34465,70977,4
2023-04-17,1호선,서울역,55130,51497,106627,4
2023-04-17,2호선,잠실(송파구청),70922,70841,141763,4
2023-04-17,2호선,선릉,63538,56274,119812,4
2023-04-17,2호선,강남,83867,80576,164443,4
2023-04-17,2호선,사당,40089,44060,84149,4
2023-04-17,2호선,신림,59804,57832,117636,4
2023-04-17,2호선,구로디지털단지,64312,63880,128192,4
2023-04-17,2호선,홍대입구,62303,64500,126803,4
2023-04-17,3호선,고속터미널,38490,36213,74703,4
2023-04-17,4호선,서울역,13366,20844,34210,4
2023-04-17,4호선,사당,27256,23825,51081,4
2023-04-17,7호선,고속터미널,17496,14418,31914,4
2023-04-17,7호선,가산디지털단지,49462,50203,99665,4
2023-04-17,8호선,잠실(송파구청),14371,16942,31313,4
2023-04-17,9호선,고속터미널,13500,17432,30932,4
2023-04-17,경부선,서울역,8349,2576,10925,4
2023-04-17,경부선,가산디지털단지,20567,23405,43972,4
2023-04-17,경의선,서울역,5413,7173,12586,4
2023-04-17,경의선,홍대입구,1966,2301,4267,4
2023-04-17,공항철도 1호선,서울역,12169,10814,22983,4
2023-04-17,공항철도 1호선,홍대입구,12441,11806,24247,4
2023-04-17,분당선,선릉,14786,22872,37658,4
2023-04-17,신림선,신림,1766,2617,4383,4
2023-04-18,3호선,고속터미널,41957,39156,81113,4
2023-04-18,2호선,홍대입구,60676,63316,123992,4
2023-04-18,2호선,구로디지털단지,64755,64169,128924,4
2023-04-18,2호선,신림,59920,57389,117309,4
2023-04-18,2호선,사당,41143,44882,86025,4
2023-04-18,2호선,강남,84459,81786,166245,4
2023-04-18,2호선,선릉,63692,56326,120018,4
2023-04-18,2호선,잠실(송파구청),73706,74198,147904,4
2023-04-18,7호선,가산디지털단지,49436,50719,100155,4
2023-04-18,신림선,신림,1773,2496,4269,4
2023-04-18,분당선,선릉,15035,22955,37990,4
2023-04-18,공항철도 1호선,홍대입구,11686,11451,23137,4
2023-04-18,공항철도 1호선,서울역,11016,9773,20789,4
2023-04-18,경의선,홍대입구,1915,2238,4153,4
2023-04-18,경의선,서울역,5247,6765,12012,4
2023-04-18,경부선,가산디지털단지,19994,22804,42798,4
2023-04-18,경부선,서울역,7464,2267,9731,4
2023-04-18,9호선,고속터미널,13541,17181,30722,4
2023-04-18,1호선,서울역,52550,49974,102524,4
2023-04-18,4호선,서울역,13712,20203,33915,4
2023-04-18,4호선,사당,27478,24275,51753,4
2023-04-18,8호선,잠실(송파구청),15052,17899,32951,4
2023-04-18,7호선,고속터미널,16276,14511,30787,4
2023-04-19,1호선,서울역,55139,53283,108422,4
2023-04-19,2호선,잠실(송파구청),78122,77767,155889,4
2023-04-19,2호선,선릉,65075,57504,122579,4
2023-04-19,2호선,강남,85770,82435,168205,4
2023-04-19,2호선,사당,43192,47402,90594,4
2023-04-19,2호선,신림,61555,59328,120883,4
2023-04-19,2호선,구로디지털단지,66039,65593,131632,4
2023-04-19,2호선,홍대입구,64049,67596,131645,4
2023-04-19,3호선,고속터미널,44689,41730,86419,4
2023-04-19,4호선,서울역,14359,21500,35859,4
2023-04-19,4호선,사당,29022,25468,54490,4
2023-04-19,7호선,고속터미널,16773,14918,31691,4
2023-04-19,7호선,가산디지털단지,49783,50509,100292,4
2023-04-19,8호선,잠실(송파구청),15546,18474,34020,4
2023-04-19,9호선,고속터미널,14693,19022,33715,4
2023-04-19,경부선,서울역,7439,2403,9842,4
2023-04-19,경부선,가산디지털단지,20275,23379,43654,4
2023-04-19,경의선,서울역,5535,6856,12391,4
2023-04-19,경의선,홍대입구,2033,2370,4403,4
2023-04-19,공항철도 1호선,서울역,11209,10136,21345,4
2023-04-19,공항철도 1호선,홍대입구,12801,12541,25342,4
2023-04-19,분당선,선릉,15256,23371,38627,4
2023-04-19,신림선,신림,1920,2698,4618,4
2023-04-20,신림선,신림,1805,2699,4504,4
2023-04-20,1호선,서울역,56397,53382,109779,4
2023-04-20,2호선,잠실(송파구청),77486,77296,154782,4
2023-04-20,2호선,선릉,64786,57385,122171,4
2023-04-20,2호선,강남,86951,83402,170353,4
2023-04-20,2호선,사당,43212,47431,90643,4
2023-04-20,2호선,신림,61652,58837,120489,4
2023-04-20,2호선,구로디지털단지,65971,65223,131194,4
2023-04-20,2호선,홍대입구,63419,67023,130442,4
2023-04-20,3호선,고속터미널,43944,41600,85544,4
2023-04-20,4호선,서울역,14125,21575,35700,4
2023-04-20,4호선,사당,29560,25337,54897,4
2023-04-20,7호선,고속터미널,17187,14543,31730,4
2023-04-20,7호선,가산디지털단지,48683,49717,98400,4
2023-04-20,8호선,잠실(송파구청),15294,18217,33511,4
2023-04-20,9호선,고속터미널,14767,18379,33146,4
2023-04-20,경부선,서울역,8133,2602,10735,4
2023-04-20,경부선,가산디지털단지,20110,23023,43133,4
2023-04-20,경의선,서울역,5371,6894,12265,4
2023-04-20,경의선,홍대입구,1989,2284,4273,4
2023-04-20,공항철도 1호선,서울역,11931,10157,22088,4
2023-04-20,공항철도 1호선,홍대입구,12059,11897,23956,4
2023-04-20,분당선,선릉,15149,23333,38482,4
2023-04-21,7호선,고속터미널,20083,16541,36624,4
2023-04-21,7호선,가산디지털단지,48289,48469,96758,4
2023-04-21,8호선,잠실(송파구청),16513,19668,36181,4
2023-04-21,9호선,고속터미널,16927,23662,40589,4
2023-04-21,경부선,가산디지털단지,19717,22851,42568,4
2023-04-21,신림선,신림,1870,2736,4606,4
2023-04-21,1호선,서울역,61357,59560,120917,4
2023-04-21,경부선,서울역,10733,3371,14104,4
2023-04-21,2호선,잠실(송파구청),83469,83027,166496,4
2023-04-21,2호선,선릉,63246,55949,119195,4
2023-04-21,2호선,강남,90849,89045,179894,4
2023-04-21,2호선,사당,45205,50795,96000,4
2023-04-21,2호선,신림,63781,61108,124889,4
2023-04-21,2호선,구로디지털단지,66572,65539,132111,4
2023-04-21,2호선,홍대입구,70948,80367,151315,4
2023-04-21,3호선,고속터미널,53503,54918,108421,4
2023-04-21,4호선,서울역,14072,24477,38549,4
2023-04-21,4호선,사당,30711,27156,57867,4
2023-04-21,분당선,선릉,14850,22740,37590,4
2023-04-21,공항철도 1호선,홍대입구,14111,14456,28567,4
2023-04-21,공항철도 1호선,서울역,14799,13025,27824,4
2023-04-21,경의선,홍대입구,2220,2759,4979,4
2023-04-21,경의선,서울역,5432,6974,12406,4
2023-04-22,7호선,고속터미널,17414,13397,30811,4
2023-04-22,7호선,가산디지털단지,16186,14350,30536,4
2023-04-22,8호선,잠실(송파구청),14328,16922,31250,4
2023-04-22,9호선,고속터미널,16705,24615,41320,4
2023-04-22,4호선,사당,25108,23213,48321,4
2023-04-22,4호선,서울역,7433,18353,25786,4
2023-04-22,3호선,고속터미널,57235,56438,113673,4
2023-04-22,2호선,홍대입구,73573,83328,156901,4
2023-04-22,2호선,구로디지털단지,38431,37079,75510,4
2023-04-22,2호선,신림,50152,47393,97545,4
2023-04-22,2호선,사당,37149,41924,79073,4
2023-04-22,2호선,강남,59772,58999,118771,4
2023-04-22,2호선,선릉,27210,23985,51195,4
2023-04-22,2호선,잠실(송파구청),75323,72060,147383,4
2023-04-22,1호선,서울역,45732,44111,89843,4
2023-04-22,경부선,서울역,10141,2762,12903,4
2023-04-22,경부선,가산디지털단지,7267,9639,16906,4
2023-04-22,경의선,서울역,1740,1983,3723,4
2023-04-22,경의선,홍대입구,2229,3050,5279,4
2023-04-22,신림선,신림,1372,1939,3311,4
2023-04-22,공항철도 1호선,서울역,13322,12843,26165,4
2023-04-22,공항철도 1호선,홍대입구,16140,15765,31905,4
2023-04-22,분당선,선릉,5665,8914,14579,4
2023-04-23,경의선,홍대입구,1766,2170,3936,4
2023-04-23,경의선,서울역,1408,1262,2670,4
2023-04-23,경부선,가산디지털단지,5418,7379,12797,4
2023-04-23,경부선,서울역,9712,2418,12130,4
2023-04-23,9호선,고속터미널,13416,19139,32555,4
2023-04-23,8호선,잠실(송파구청),10718,11864,22582,4
2023-04-23,7호선,가산디지털단지,11943,11041,22984,4
2023-04-23,7호선,고속터미널,16209,9649,25858,4
2023-04-23,4호선,사당,18371,16548,34919,4
2023-04-23,4호선,서울역,5459,14045,19504,4
2023-04-23,3호선,고속터미널,47172,42519,89691,4
2023-04-23,2호선,홍대입구,55264,54487,109751,4
2023-04-23,2호선,구로디지털단지,27423,26794,54217,4
2023-04-23,2호선,신림,36997,36360,73357,4
2023-04-23,2호선,사당,25839,27909,53748,4
2023-04-23,2호선,강남,33923,31989,65912,4
2023-04-23,2호선,선릉,14780,12391,27171,4
2023-04-23,2호선,잠실(송파구청),55204,51249,106453,4
2023-04-23,1호선,서울역,35726,33892,69618,4
2023-04-23,신림선,신림,1243,1851,3094,4
2023-04-23,분당선,선릉,3131,4631,7762,4
2023-04-23,공항철도 1호선,홍대입구,12885,11463,24348,4
2023-04-23,공항철도 1호선,서울역,12114,11552,23666,4
2023-04-24,4호선,서울역,13457,20577,34034,4
2023-04-24,4호선,사당,27258,23918,51176,4
2023-04-24,신림선,신림,1840,2599,4439,4
2023-04-24,7호선,고속터미널,17209,14388,31597,4
2023-04-24,7호선,가산디지털단지,49579,49941,99520,4
2023-04-24,8호선,잠실(송파구청),14520,16917,31437,4
2023-04-24,9호선,고속터미널,13729,17727,31456,4
2023-04-24,경부선,서울역,8563,2527,11090,4
2023-04-24,경부선,가산디지털단지,20063,23299,43362,4
2023-04-24,경의선,서울역,5353,6805,12158,4
2023-04-24,경의선,홍대입구,1843,2239,4082,4
2023-04-24,공항철도 1호선,서울역,11639,10788,22427,4
2023-04-24,공항철도 1호선,홍대입구,11691,11406,23097,4
2023-04-24,분당선,선릉,14978,22971,37949,4
2023-04-24,1호선,서울역,54384,51255,105639,4
2023-04-24,2호선,잠실(송파구청),71148,71558,142706,4
2023-04-24,2호선,선릉,63739,56139,119878,4
2023-04-24,2호선,강남,83764,80464,164228,4
2023-04-24,2호선,사당,40282,44297,84579,4
2023-04-24,2호선,신림,58957,57229,116186,4
2023-04-24,2호선,구로디지털단지,64291,63734,128025,4
2023-04-24,2호선,홍대입구,59697,61449,121146,4
2023-04-24,3호선,고속터미널,43142,40714,83856,4
2023-04-25,1호선,서울역,52822,50333,103155,4
2023-04-25,2호선,잠실(송파구청),75023,73844,148867,4
2023-04-25,2호선,선릉,64571,57044,121615,4
2023-04-25,2호선,강남,86559,82979,169538,4
2023-04-25,2호선,사당,41343,45230,86573,4
2023-04-25,2호선,신림,59926,57994,117920,4
2023-04-25,2호선,구로디지털단지,64899,64387,129286,4
2023-04-25,2호선,홍대입구,60370,62877,123247,4
2023-04-25,3호선,고속터미널,41922,39719,81641,4
2023-04-25,4호선,서울역,13612,20287,33899,4
2023-04-25,4호선,사당,28454,24539,52993,4
2023-04-25,7호선,고속터미널,16551,14661,31212,4
2023-04-25,7호선,가산디지털단지,50066,50123,100189,4
2023-04-25,8호선,잠실(송파구청),15176,17855,33031,4
2023-04-25,9호선,고속터미널,13452,17168,30620,4
2023-04-25,경부선,서울역,7042,2305,9347,4
2023-04-25,경부선,가산디지털단지,19739,23166,42905,4
2023-04-25,경의선,서울역,5137,6663,11800,4
2023-04-25,경의선,홍대입구,1806,2198,4004,4
2023-04-25,공항철도 1호선,서울역,10465,9227,19692,4
2023-04-25,공항철도 1호선,홍대입구,11356,11376,22732,4
2023-04-25,분당선,선릉,15523,23275,38798,4
2023-04-25,신림선,신림,1785,2474,4259,4
2023-04-26,분당선,선릉,15237,23311,38548,4
2023-04-26,공항철도 1호선,홍대입구,12851,12692,25543,4
2023-04-26,공항철도 1호선,서울역,11531,10252,21783,4
2023-04-26,경의선,홍대입구,2120,2507,4627,4
2023-04-26,경의선,서울역,5316,6959,12275,4
2023-04-26,경부선,가산디지털단지,20045,23335,43380,4
2023-04-26,경부선,서울역,7405,2359,9764,4
2023-04-26,9호선,고속터미널,14109,17997,32106,4
2023-04-26,8호선,잠실(송파구청),16112,18984,35096,4
2023-04-26,7호선,가산디지털단지,50014,50319,100333,4
2023-04-26,7호선,고속터미널,17141,14978,32119,4
2023-04-26,4호선,사당,29211,25637,54848,4
2023-04-26,4호선,서울역,14110,21386,35496,4
2023-04-26,3호선,고속터미널,43836,41350,85186,4
2023-04-26,2호선,홍대입구,66793,70451,137244,4
2023-04-26,2호선,구로디지털단지,65674,65352,131026,4
2023-04-26,2호선,신림,62352,60191,122543,4
2023-04-26,2호선,사당,43372,47250,90622,4
2023-04-26,2호선,강남,87850,84752,172602,4
2023-04-26,2호선,선릉,66100,58393,124493,4
2023-04-26,2호선,잠실(송파구청),80025,79773,159798,4
2023-04-26,1호선,서울역,54804,52501,107305,4
2023-04-26,신림선,신림,1861,2667,4528,4
2023-04-27,분당선,선릉,15339,23252,38591,4
2023-04-27,공항철도 1호선,홍대입구,13502,13551,27053,4
2023-04-27,공항철도 1호선,서울역,12832,10952,23784,4
2023-04-27,경의선,홍대입구,2335,2821,5156,4
2023-04-27,경의선,서울역,5610,7225,12835,4
2023-04-27,경부선,가산디지털단지,20065,23424,43489,4
2023-04-27,경부선,서울역,8552,2847,11399,4
2023-04-27,9호선,고속터미널,15457,19479,34936,4
2023-04-27,8호선,잠실(송파구청),16169,19351,35520,4
2023-04-27,7호선,가산디지털단지,49330,50161,99491,4
2023-04-27,7호선,고속터미널,17707,15197,32904,4
2023-04-27,4호선,사당,30438,26166,56604,4
2023-04-27,4호선,서울역,14130,22365,36495,4
2023-04-27,3호선,고속터미널,46504,43650,90154,4
2023-04-27,2호선,홍대입구,70158,74224,144382,4
2023-04-27,2호선,구로디지털단지,66590,66044,132634,4
2023-04-27,2호선,신림,62585,60198,122783,4
2023-04-27,2호선,사당,44374,49086,93460,4
2023-04-27,2호선,강남,89462,86110,175572,4
2023-04-27,2호선,선릉,65483,58287,123770,4
2023-04-27,2호선,잠실(송파구청),85382,86064,171446,4
2023-04-27,1호선,서울역,56899,54746,111645,4
2023-04-27,신림선,신림,1904,2661,4565,4
2023-04-28,2호선,잠실(송파구청),91632,91714,183346,4
2023-04-28,2호선,선릉,64541,57225,121766,4
2023-04-28,2호선,강남,96765,94078,190843,4
2023-04-28,2호선,사당,47138,52337,99475,4
2023-04-28,2호선,신림,64935,62233,127168,4
2023-04-28,2호선,구로디지털단지,67252,66109,133361,4
2023-04-28,2호선,홍대입구,79356,88632,167988,4
2023-04-28,3호선,고속터미널,58992,60829,119821,4
2023-04-28,4호선,서울역,14652,25761,40413,4
2023-04-28,4호선,사당,32280,28445,60725,4
2023-04-28,7호선,고속터미널,21809,17537,39346,4
2023-04-28,7호선,가산디지털단지,49408,49139,98547,4
2023-04-28,8호선,잠실(송파구청),17478,21649,39127,4
2023-04-28,9호선,고속터미널,18454,25791,44245,4
2023-04-28,경부선,서울역,11388,3831,15219,4
2023-04-28,경부선,가산디지털단지,20054,23392,43446,4
2023-04-28,경의선,서울역,5598,7319,12917,4
2023-04-28,경의선,홍대입구,2464,3301,5765,4
2023-04-28,분당선,선릉,14861,22867,37728,4
2023-04-28,공항철도 1호선,홍대입구,15706,15969,31675,4
2023-04-28,공항철도 1호선,서울역,15558,14114,29672,4
2023-04-28,신림선,신림,1972,2644,4616,4
2023-04-28,1호선,서울역,63797,62865,126662,4
2023-04-29,분당선,선릉,5359,8573,13932,4
2023-04-29,공항철도 1호선,홍대입구,16243,16754,32997,4
2023-04-29,공항철도 1호선,서울역,14430,14040,28470,4
2023-04-29,경의선,홍대입구,2357,3140,5497,4
2023-04-29,경의선,서울역,1778,1950,3728,4
2023-04-29,경부선,가산디지털단지,6231,8469,14700,4
2023-04-29,경부선,서울역,10634,3368,14002,4
2023-04-29,9호선,고속터미널,16789,26909,43698,4
2023-04-29,8호선,잠실(송파구청),14925,17901,32826,4
2023-04-29,7호선,가산디지털단지,15141,13215,28356,4
2023-04-29,7호선,고속터미널,18291,13685,31976,4
2023-04-29,4호선,사당,23600,21500,45100,4
2023-04-29,4호선,서울역,7618,19782,27400,4
2023-04-29,3호선,고속터미널,59989,62144,122133,4
2023-04-29,2호선,홍대입구,77463,87397,164860,4
2023-04-29,2호선,구로디지털단지,36153,34571,70724,4
2023-04-29,2호선,신림,48092,45770,93862,4
2023-04-29,2호선,사당,34588,39031,73619,4
2023-04-29,2호선,강남,60499,60175,120674,4
2023-04-29,2호선,선릉,25875,22442,48317,4
2023-04-29,2호선,잠실(송파구청),76047,74079,150126,4
2023-04-29,1호선,서울역,47685,45281,92966,4
2023-04-29,신림선,신림,1293,1806,3099,4
2023-04-30,분당선,선릉,3375,5115,8490,4
2023-04-30,공항철도 1호선,홍대입구,16293,15400,31693,4
2023-04-30,공항철도 1호선,서울역,13473,12642,26115,4
2023-04-30,경의선,홍대입구,2392,3029,5421,4
2023-04-30,경의선,서울역,1431,1507,2938,4
2023-04-30,경부선,가산디지털단지,5655,8031,13686,4
2023-04-30,경부선,서울역,10671,2447,13118,4
2023-04-30,9호선,고속터미널,14764,21827,36591,4
2023-04-30,8호선,잠실(송파구청),13468,15083,28551,4
2023-04-30,7호선,가산디지털단지,13356,11812,25168,4
2023-04-30,7호선,고속터미널,16452,10044,26496,4
2023-04-30,4호선,사당,20518,18273,38791,4
2023-04-30,4호선,서울역,6348,16672,23020,4
2023-04-30,3호선,고속터미널,51302,47952,99254,4
2023-04-30,2호선,홍대입구,73757,76836,150593,4
2023-04-30,2호선,구로디지털단지,30141,29177,59318,4
2023-04-30,2호선,신림,41336,39644,80980,4
2023-04-30,2호선,사당,28709,31855,60564,4
2023-04-30,2호선,강남,40076,38843,78919,4
2023-04-30,2호선,선릉,16209,13534,29743,4
2023-04-30,2호선,잠실(송파구청),70088,65754,135842,4
2023-04-30,1호선,서울역,39905,37724,77629,4
2023-04-30,신림선,신림,1233,1852,3085,4
2023-05-01,4호선,사당,19816,19203,39019,5
2023-05-01,4호선,서울역,7354,15094,22448,5
2023-05-01,3호선,고속터미널,53496,47096,100592,5
2023-05-01,2호선,홍대입구,66293,67336,133629,5
2023-05-01,2호선,구로디지털단지,34739,34227,68966,5
2023-05-01,2호선,신림,44277,43769,88046,5
2023-05-01,2호선,사당,28708,32361,61069,5
2023-05-01,2호선,강남,48872,47351,96223,5
2023-05-01,2호선,선릉,26036,23648,49684,5
2023-05-01,2호선,잠실(송파구청),65901,63118,129019,5
2023-05-01,1호선,서울역,44369,39452,83821,5
2023-05-01,7호선,고속터미널,16634,10665,27299,5
2023-05-01,7호선,가산디지털단지,16381,15657,32038,5
2023-05-01,8호선,잠실(송파구청),13495,15181,28676,5
2023-05-01,9호선,고속터미널,15301,20410,35711,5
2023-05-01,경부선,서울역,10267,2342,12609,5
2023-05-01,경부선,가산디지털단지,6969,9142,16111,5
2023-05-01,경의선,서울역,3162,4026,7188,5
2023-05-01,경의선,홍대입구,2018,2366,4384,5
2023-05-01,공항철도 1호선,서울역,12292,11468,23760,5
2023-05-01,공항철도 1호선,홍대입구,13382,12209,25591,5
2023-05-01,분당선,선릉,5565,8405,13970,5
2023-05-01,신림선,신림,1501,2169,3670,5
2023-05-02,신림선,신림,1850,2552,4402,5
2023-05-02,1호선,서울역,55301,51467,106768,5
2023-05-02,2호선,잠실(송파구청),80014,79949,159963,5
2023-05-02,2호선,선릉,65193,57872,123065,5
2023-05-02,2호선,강남,87257,84458,171715,5
2023-05-02,2호선,사당,41682,46018,87700,5
2023-05-02,2호선,신림,60808,58663,119471,5
2023-05-02,2호선,구로디지털단지,64974,64180,129154,5
2023-05-02,2호선,홍대입구,68360,71472,139832,5
2023-05-02,3호선,고속터미널,43703,40823,84526,5
2023-05-02,4호선,서울역,13622,20832,34454,5
2023-05-02,4호선,사당,28387,24771,53158,5
2023-05-02,7호선,고속터미널,17427,15025,32452,5
2023-05-02,7호선,가산디지털단지,50075,50614,100689,5
2023-05-02,8호선,잠실(송파구청),15306,18325,33631,5
2023-05-02,9호선,고속터미널,14747,18689,33436,5
2023-05-02,경부선,서울역,8478,2478,10956,5
2023-05-02,경부선,가산디지털단지,20188,23546,43734,5
2023-05-02,경의선,서울역,5559,7032,12591,5
2023-05-02,경의선,홍대입구,2066,2450,4516,5
2023-05-02,공항철도 1호선,서울역,12092,10565,22657,5
2023-05-02,공항철도 1호선,홍대입구,12843,12451,25294,5
2023-05-02,분당선,선릉,15192,23000,38192,5
2023-05-03,신림선,신림,1910,2685,4595,5
2023-05-03,분당선,선릉,15257,23298,38555,5
2023-05-03,공항철도 1호선,홍대입구,13616,13219,26835,5
2023-05-03,공항철도 1호선,서울역,13564,11559,25123,5
2023-05-03,경의선,홍대입구,2218,2801,5019,5
2023-05-03,경의선,서울역,5389,6996,12385,5
2023-05-03,경부선,가산디지털단지,20431,23726,44157,5
2023-05-03,경부선,서울역,7793,2608,10401,5
2023-05-03,9호선,고속터미널,15155,19768,34923,5
2023-05-03,8호선,잠실(송파구청),16294,19764,36058,5
2023-05-03,7호선,가산디지털단지,50052,50729,100781,5
2023-05-03,7호선,고속터미널,17243,15425,32668,5
2023-05-03,4호선,사당,29691,25707,55398,5
2023-05-03,4호선,서울역,14256,22464,36720,5
2023-05-03,3호선,고속터미널,45067,42741,87808,5
2023-05-03,2호선,홍대입구,70232,74563,144795,5
2023-05-03,2호선,구로디지털단지,65935,65438,131373,5
2023-05-03,2호선,신림,62218,60003,122221,5
2023-05-03,2호선,사당,42849,47371,90220,5
2023-05-03,2호선,강남,88875,85921,174796,5
2023-05-03,2호선,선릉,65640,58101,123741,5
2023-05-03,2호선,잠실(송파구청),83821,84224,168045,5
2023-05-03,1호선,서울역,55711,54330,110041,5
2023-05-04,4호선,사당,31641,27313,58954,5
2023-05-04,4호선,서울역,14170,25616,39786,5
2023-05-04,3호선,고속터미널,56260,63871,120131,5
2023-05-04,2호선,홍대입구,76950,85288,162238,5
2023-05-04,2호선,구로디지털단지,67310,66332,133642,5
2023-05-04,2호선,신림,63602,60630,124232,5
2023-05-04,2호선,사당,44726,49949,94675,5
2023-05-04,2호선,강남,91889,90156,182045,5
2023-05-04,2호선,선릉,64330,56962,121292,5
2023-05-04,2호선,잠실(송파구청),92409,91090,183499,5
2023-05-04,1호선,서울역,61228,61772,123000,5
2023-05-04,7호선,고속터미널,20896,17954,38850,5
2023-05-04,7호선,가산디지털단지,53375,52833,106208,5
2023-05-04,8호선,잠실(송파구청),17865,23615,41480,5
2023-05-04,9호선,고속터미널,17915,26505,44420,5
2023-05-04,경부선,서울역,9828,3806,13634,5
2023-05-04,경부선,가산디지털단지,20604,24400,45004,5
2023-05-04,경의선,서울역,5691,7279,12970,5
2023-05-04,경의선,홍대입구,2781,3481,6262,5
2023-05-04,공항철도 1호선,서울역,15462,13543,29005,5
2023-05-04,공항철도 1호선,홍대입구,14708,14825,29533,5
2023-05-04,분당선,선릉,14839,22703,37542,5
2023-05-04,신림선,신림,1900,2670,4570,5
2023-05-05,경의선,서울역,1283,1474,2757,5
2023-05-05,경의선,홍대입구,1730,2266,3996,5
2023-05-05,공항철도 1호선,서울역,12937,12767,25704,5
2023-05-05,공항철도 1호선,홍대입구,12949,12577,25526,5
2023-05-05,분당선,선릉,3195,4942,8137,5
2023-05-05,신림선,신림,1024,1433,2457,5
2023-05-05,1호선,서울역,36674,38363,75037,5
2023-05-05,2호선,잠실(송파구청),59529,58318,117847,5
2023-05-05,2호선,선릉,16773,14979,31752,5
2023-05-05,2호선,강남,38014,37513,75527,5
2023-05-05,2호선,사당,21312,23682,44994,5
2023-05-05,2호선,신림,36970,34305,71275,5
2023-05-05,2호선,구로디지털단지,27255,25674,52929,5
2023-05-05,2호선,홍대입구,62053,68069,130122,5
2023-05-05,3호선,고속터미널,47220,56105,103325,5
2023-05-05,4호선,서울역,5509,15920,21429,5
2023-05-05,4호선,사당,15616,13853,29469,5
2023-05-05,7호선,고속터미널,12770,10344,23114,5
2023-05-05,7호선,가산디지털단지,14886,12468,27354,5
2023-05-05,8호선,잠실(송파구청),14657,16444,31101,5
2023-05-05,9호선,고속터미널,12798,23378,36176,5
2023-05-05,경부선,서울역,7907,2993,10900,5
2023-05-05,경부선,가산디지털단지,5007,7030,12037,5
2023-05-06,경부선,서울역,9837,2595,12432,5
2023-05-06,경부선,가산디지털단지,5219,7465,12684,5
2023-05-06,경의선,서울역,1381,1424,2805,5
2023-05-06,경의선,홍대입구,2097,2637,4734,5
2023-05-06,공항철도 1호선,서울역,13120,12131,25251,5
2023-05-06,공항철도 1호선,홍대입구,15100,14926,30026,5
2023-05-06,분당선,선릉,4328,6606,10934,5
2023-05-06,신림선,신림,1130,1601,2731,5
2023-05-06,1호선,서울역,39266,36566,75832,5
2023-05-06,2호선,잠실(송파구청),64426,62400,126826,5
2023-05-06,2호선,선릉,20790,17990,38780,5
2023-05-06,2호선,강남,49762,49415,99177,5
2023-05-06,2호선,사당,25590,28446,54036,5
2023-05-06,2호선,신림,41015,39372,80387,5
2023-05-06,2호선,구로디지털단지,29932,29243,59175,5
2023-05-06,2호선,홍대입구,71071,79213,150284,5
2023-05-06,3호선,고속터미널,52851,51254,104105,5
2023-05-06,4호선,서울역,6105,15688,21793,5
2023-05-06,4호선,사당,18209,16386,34595,5
2023-05-06,7호선,고속터미널,16511,11046,27557,5
2023-05-06,7호선,가산디지털단지,13984,12402,26386,5
2023-05-06,8호선,잠실(송파구청),13637,16020,29657,5
2023-05-06,9호선,고속터미널,13969,21286,35255,5
2023-05-07,2호선,잠실(송파구청),55880,51844,107724,5
2023-05-07,1호선,서울역,37226,35032,72258,5
2023-05-07,2호선,구로디지털단지,26849,26445,53294,5
2023-05-07,2호선,신림,36299,36560,72859,5
2023-05-07,신림선,신림,1135,1675,2810,5
2023-05-07,분당선,선릉,2813,4203,7016,5
2023-05-07,공항철도 1호선,홍대입구,13655,12487,26142,5
2023-05-07,공항철도 1호선,서울역,12996,12780,25776,5
2023-05-07,경의선,홍대입구,2102,2576,4678,5
2023-05-07,경의선,서울역,1403,1360,2763,5
2023-05-07,9호선,고속터미널,19850,24377,44227,5
2023-05-07,8호선,잠실(송파구청),11263,12354,23617,5
2023-05-07,7호선,가산디지털단지,12957,12493,25450,5
2023-05-07,7호선,고속터미널,21832,10493,32325,5
2023-05-07,4호선,사당,16647,16064,32711,5
2023-05-07,4호선,서울역,5543,14935,20478,5
2023-05-07,3호선,고속터미널,64342,49729,114071,5
2023-05-07,2호선,홍대입구,59990,60499,120489,5
2023-05-07,2호선,선릉,13804,11912,25716,5
2023-05-07,2호선,강남,33680,32285,65965,5
2023-05-07,2호선,사당,23705,26312,50017,5
2023-05-07,경부선,가산디지털단지,5525,7727,13252,5
2023-05-07,경부선,서울역,11603,2418,14021,5
2023-05-08,1호선,서울역,56935,50852,107787,5
2023-05-08,2호선,잠실(송파구청),74366,74727,149093,5
2023-05-08,2호선,선릉,62236,55097,117333,5
2023-05-08,2호선,강남,83432,80006,163438,5
2023-05-08,2호선,사당,38569,42720,81289,5
2023-05-08,2호선,신림,59277,57810,117087,5
2023-05-08,2호선,구로디지털단지,63405,63295,126700,5
2023-05-08,신림선,신림,1820,2690,4510,5
2023-05-08,2호선,홍대입구,60693,63098,123791,5
2023-05-08,3호선,고속터미널,47528,43147,90675,5
2023-05-08,4호선,서울역,13193,20032,33225,5
2023-05-08,4호선,사당,26873,23447,50320,5
2023-05-08,7호선,고속터미널,19163,15071,34234,5
2023-05-08,7호선,가산디지털단지,50644,50929,101573,5
2023-05-08,8호선,잠실(송파구청),15009,17762,32771,5
2023-05-08,분당선,선릉,14759,22548,37307,5
2023-05-08,9호선,고속터미널,14913,18707,33620,5
2023-05-08,경부선,서울역,11144,2597,13741,5
2023-05-08,경부선,가산디지털단지,20002,23517,43519,5
2023-05-08,공항철도 1호선,홍대입구,11921,11624,23545,5
2023-05-08,공항철도 1호선,서울역,12498,10708,23206,5
2023-05-08,경의선,홍대입구,1947,2317,4264,5
2023-05-08,경의선,서울역,5592,7094,12686,5
2023-05-09,1호선,서울역,53980,51249,105229,5
2023-05-09,2호선,잠실(송파구청),77834,77600,155434,5
2023-05-09,2호선,선릉,66221,58558,124779,5
2023-05-09,2호선,강남,88882,85550,174432,5
2023-05-09,2호선,사당,43306,47073,90379,5
2023-05-09,2호선,신림,60972,58814,119786,5
2023-05-09,2호선,구로디지털단지,65803,65424,131227,5
2023-05-09,2호선,홍대입구,63637,67121,130758,5
2023-05-09,3호선,고속터미널,44541,40785,85326,5
2023-05-09,4호선,서울역,14163,20917,35080,5
2023-05-09,4호선,사당,29233,25557,54790,5
2023-05-09,7호선,고속터미널,17429,15304,32733,5
2023-05-09,7호선,가산디지털단지,51376,52099,103475,5
2023-05-09,8호선,잠실(송파구청),15450,18123,33573,5
2023-05-09,9호선,고속터미널,14499,18330,32829,5
2023-05-09,경부선,서울역,8119,2260,10379,5
2023-05-09,경부선,가산디지털단지,20521,24169,44690,5
2023-05-09,경의선,서울역,5483,7042,12525,5
2023-05-09,경의선,홍대입구,2065,2421,4486,5
2023-05-09,공항철도 1호선,서울역,11399,9836,21235,5
2023-05-09,공항철도 1호선,홍대입구,12212,12175,24387,5
2023-05-09,분당선,선릉,15419,23771,39190,5
2023-05-09,신림선,신림,1891,2688,4579,5
2023-05-10,9호선,고속터미널,15187,19013,34200,5
2023-05-10,8호선,잠실(송파구청),15769,18889,34658,5
2023-05-10,7호선,가산디지털단지,50901,51629,102530,5
2023-05-10,7호선,고속터미널,17353,15496,32849,5
2023-05-10,4호선,사당,29046,25483,54529,5
2023-05-10,4호선,서울역,13985,21636,35621,5
2023-05-10,3호선,고속터미널,45054,41897,86951,5
2023-05-10,2호선,홍대입구,65431,69187,134618,5
2023-05-10,2호선,구로디지털단지,65867,65445,131312,5
2023-05-10,2호선,신림,61901,59808,121709,5
2023-05-10,2호선,사당,43189,47377,90566,5
2023-05-10,2호선,강남,88599,84955,173554,5
2023-05-10,2호선,선릉,66263,58496,124759,5
2023-05-10,2호선,잠실(송파구청),78607,78211,156818,5
2023-05-10,분당선,선릉,15411,23421,38832,5
2023-05-10,신림선,신림,1865,2665,4530,5
2023-05-10,1호선,서울역,55297,52132,107429,5
2023-05-10,경의선,홍대입구,2125,2464,4589,5
2023-05-10,공항철도 1호선,서울역,11511,9686,21197,5
2023-05-10,공항철도 1호선,홍대입구,12733,12416,25149,5
2023-05-10,경의선,서울역,5438,7038,12476,5
2023-05-10,경부선,가산디지털단지,20594,23880,44474,5
2023-05-10,경부선,서울역,7880,2373,10253,5
2023-05-11,2호선,잠실(송파구청),81272,80845,162117,5
2023-05-11,2호선,선릉,66002,58546,124548,5
2023-05-11,2호선,강남,89632,86092,175724,5
2023-05-11,2호선,사당,44068,48564,92632,5
2023-05-11,2호선,신림,62107,59929,122036,5
2023-05-11,2호선,구로디지털단지,66564,65742,132306,5
2023-05-11,2호선,홍대입구,67731,72184,139915,5
2023-05-11,3호선,고속터미널,47012,43272,90284,5
2023-05-11,4호선,서울역,14108,22084,36192,5
2023-05-11,4호선,사당,29904,26107,56011,5
2023-05-11,7호선,고속터미널,17738,15167,32905,5
2023-05-11,1호선,서울역,56876,54490,111366,5
2023-05-11,7호선,가산디지털단지,50102,51199,101301,5
2023-05-11,8호선,잠실(송파구청),15790,18976,34766,5
2023-05-11,9호선,고속터미널,15781,19616,35397,5
2023-05-11,경부선,서울역,8597,2598,11195,5
2023-05-11,경부선,가산디지털단지,20326,23555,43881,5
2023-05-11,경의선,서울역,5664,7255,12919,5
2023-05-11,경의선,홍대입구,2187,2523,4710,5
2023-05-11,공항철도 1호선,서울역,12421,10442,22863,5
2023-05-11,공항철도 1호선,홍대입구,13117,13035,26152,5
2023-05-11,분당선,선릉,15427,23478,38905,5
2023-05-11,신림선,신림,1860,2680,4540,5
2023-05-12,4호선,사당,32732,28895,61627,5
2023-05-12,4호선,서울역,14464,25475,39939,5
2023-05-12,3호선,고속터미널,57072,55360,112432,5
2023-05-12,2호선,홍대입구,76440,86737,163177,5
2023-05-12,2호선,구로디지털단지,67238,66387,133625,5
2023-05-12,2호선,신림,65439,63777,129216,5
2023-05-12,2호선,사당,47189,53258,100447,5
2023-05-12,2호선,강남,96529,94585,191114,5
2023-05-12,2호선,선릉,65821,58130,123951,5
2023-05-12,2호선,잠실(송파구청),92412,91962,184374,5
2023-05-12,1호선,서울역,64284,61490,125774,5
2023-05-12,경부선,서울역,11555,3603,15158,5
2023-05-12,경부선,가산디지털단지,20340,23658,43998,5
2023-05-12,경의선,서울역,5644,7221,12865,5
2023-05-12,경의선,홍대입구,2541,3210,5751,5
2023-05-12,공항철도 1호선,서울역,14807,13529,28336,5
2023-05-12,공항철도 1호선,홍대입구,15120,15010,30130,5
2023-05-12,분당선,선릉,14916,23160,38076,5
2023-05-12,신림선,신림,1947,2939,4886,5
2023-05-12,7호선,고속터미널,20897,16267,37164,5
2023-05-12,7호선,가산디지털단지,50347,50537,100884,5
2023-05-12,8호선,잠실(송파구청),17179,22128,39307,5
2023-05-12,9호선,고속터미널,18670,25016,43686,5
2023-05-13,1호선,서울역,49712,47435,97147,5
2023-05-13,신림선,신림,1404,2131,3535,5
2023-05-13,분당선,선릉,5890,9513,15403,5
2023-05-13,공항철도 1호선,홍대입구,19086,19120,38206,5
2023-05-13,공항철도 1호선,서울역,13495,13227,26722,5
2023-05-13,경의선,홍대입구,2838,3764,6602,5
2023-05-13,경의선,서울역,1856,2171,4027,5
2023-05-13,경부선,가산디지털단지,7386,10103,17489,5
2023-05-13,경부선,서울역,11362,2917,14279,5
2023-05-13,9호선,고속터미널,20267,29258,49525,5
2023-05-13,8호선,잠실(송파구청),15295,18485,33780,5
2023-05-13,7호선,가산디지털단지,17526,15896,33422,5
2023-05-13,7호선,고속터미널,19410,14649,34059,5
2023-05-13,4호선,사당,27867,25391,53258,5
2023-05-13,4호선,서울역,7779,20236,28015,5
2023-05-13,3호선,고속터미널,65352,62894,128246,5
2023-05-13,2호선,홍대입구,84616,96234,180850,5
2023-05-13,2호선,구로디지털단지,40325,38972,79297,5
2023-05-13,2호선,신림,53268,50677,103945,5
2023-05-13,2호선,사당,40872,46520,87392,5
2023-05-13,2호선,강남,65973,65191,131164,5
2023-05-13,2호선,선릉,28630,24997,53627,5
2023-05-13,2호선,잠실(송파구청),85521,81291,166812,5
2023-05-14,신림선,신림,1206,1838,3044,5
2023-05-14,분당선,선릉,3372,5385,8757,5
2023-05-14,공항철도 1호선,홍대입구,15283,13949,29232,5
2023-05-14,공항철도 1호선,서울역,12580,12280,24860,5
2023-05-14,경의선,서울역,1525,1539,3064,5
2023-05-14,경의선,홍대입구,2622,3033,5655,5
2023-05-14,1호선,서울역,37311,35721,73032,5
2023-05-14,2호선,잠실(송파구청),62022,57178,119200,5
2023-05-14,2호선,선릉,16449,13761,30210,5
2023-05-14,2호선,강남,38826,36748,75574,5
2023-05-14,2호선,사당,28148,30701,58849,5
2023-05-14,2호선,신림,39338,38526,77864,5
2023-05-14,2호선,구로디지털단지,28758,27449,56207,5
2023-05-14,2호선,홍대입구,67080,66836,133916,5
2023-05-14,3호선,고속터미널,62998,53664,116662,5
2023-05-14,4호선,서울역,5791,15593,21384,5
2023-05-14,4호선,사당,19622,18439,38061,5
2023-05-14,7호선,고속터미널,16809,11276,28085,5
2023-05-14,7호선,가산디지털단지,13844,12686,26530,5
2023-05-14,8호선,잠실(송파구청),11537,13166,24703,5
2023-05-14,9호선,고속터미널,22252,29144,51396,5
2023-05-14,경부선,서울역,10480,2486,12966,5
2023-05-14,경부선,가산디지털단지,5857,7919,13776,5
2023-05-15,공항철도 1호선,서울역,12142,11187,23329,5
2023-05-15,공항철도 1호선,홍대입구,13124,12667,25791,5
2023-05-15,분당선,선릉,15235,23009,38244,5
2023-05-15,3호선,고속터미널,40704,38693,79397,5
2023-05-15,4호선,서울역,13482,21159,34641,5
2023-05-15,4호선,사당,28071,24699,52770,5
2023-05-15,7호선,고속터미널,17746,14979,32725,5
2023-05-15,7호선,가산디지털단지,50201,50791,100992,5
2023-05-15,8호선,잠실(송파구청),14987,17586,32573,5
2023-05-15,9호선,고속터미널,14373,18861,33234,5
2023-05-15,경부선,서울역,8838,2652,11490,5
2023-05-15,경부선,가산디지털단지,20246,23248,43494,5
2023-05-15,경의선,서울역,5417,7124,12541,5
2023-05-15,경의선,홍대입구,2028,2496,4524,5
2023-05-15,2호선,홍대입구,64267,66635,130902,5
2023-05-15,2호선,구로디지털단지,64189,63659,127848,5
2023-05-15,2호선,신림,59863,57749,117612,5
2023-05-15,2호선,사당,41013,45178,86191,5
2023-05-15,2호선,강남,85720,82162,167882,5
2023-05-15,2호선,선릉,64037,56756,120793,5
2023-05-15,2호선,잠실(송파구청),75222,74759,149981,5
2023-05-15,신림선,신림,1824,2683,4507,5
2023-05-15,1호선,서울역,56071,52717,108788,5
2023-05-16,분당선,선릉,15558,23551,39109,5
2023-05-16,공항철도 1호선,홍대입구,12571,12455,25026,5
2023-05-16,공항철도 1호선,서울역,11421,10211,21632,5
2023-05-16,경의선,홍대입구,2113,2579,4692,5
2023-05-16,경의선,서울역,5819,6992,12811,5
2023-05-16,경부선,가산디지털단지,20454,23712,44166,5
2023-05-16,경부선,서울역,7650,2597,10247,5
2023-05-16,신림선,신림,1793,2650,4443,5
2023-05-16,9호선,고속터미널,15244,19214,34458,5
2023-05-16,8호선,잠실(송파구청),15463,18288,33751,5
2023-05-16,7호선,가산디지털단지,50876,51189,102065,5
2023-05-16,7호선,고속터미널,17339,15299,32638,5
2023-05-16,4호선,사당,29066,25145,54211,5
2023-05-16,4호선,서울역,14516,21419,35935,5
2023-05-16,3호선,고속터미널,45757,42543,88300,5
2023-05-16,1호선,서울역,58372,54162,112534,5
2023-05-16,2호선,잠실(송파구청),77383,77535,154918,5
2023-05-16,2호선,선릉,66050,58188,124238,5
2023-05-16,2호선,강남,88094,85352,173446,5
2023-05-16,2호선,사당,42548,47018,89566,5
2023-05-16,2호선,신림,61160,59019,120179,5
2023-05-16,2호선,구로디지털단지,65754,65498,131252,5
2023-05-16,2호선,홍대입구,65312,68944,134256,5
2023-05-17,1호선,서울역,58072,54550,112622,5
2023-05-17,2호선,잠실(송파구청),79901,79873,159774,5
2023-05-17,2호선,선릉,65892,58144,124036,5
2023-05-17,2호선,강남,88422,84911,173333,5
2023-05-17,2호선,사당,43278,47702,90980,5
2023-05-17,2호선,신림,61711,59884,121595,5
2023-05-17,2호선,구로디지털단지,65983,65347,131330,5
2023-05-17,2호선,홍대입구,66459,70202,136661,5
2023-05-17,3호선,고속터미널,45413,42256,87669,5
2023-05-17,4호선,서울역,15017,22871,37888,5
2023-05-17,4호선,사당,29546,25740,55286,5
2023-05-17,7호선,고속터미널,17083,15213,32296,5
2023-05-17,7호선,가산디지털단지,50125,50835,100960,5
2023-05-17,8호선,잠실(송파구청),15541,18358,33899,5
2023-05-17,9호선,고속터미널,15102,19080,34182,5
2023-05-17,경부선,서울역,7972,2609,10581,5
2023-05-17,경부선,가산디지털단지,20110,23520,43630,5
2023-05-17,경의선,서울역,5650,6980,12630,5
2023-05-17,경의선,홍대입구,2112,2420,4532,5
2023-05-17,신림선,신림,1851,2661,4512,5
2023-05-17,공항철도 1호선,서울역,11611,10276,21887,5
2023-05-17,공항철도 1호선,홍대입구,12521,12457,24978,5
2023-05-17,분당선,선릉,15350,23365,38715,5
2023-05-18,7호선,고속터미널,17624,15330,32954,5
2023-05-18,4호선,서울역,13886,21794,35680,5
2023-05-18,1호선,서울역,56003,53485,109488,5
2023-05-18,2호선,잠실(송파구청),78993,78503,157496,5
2023-05-18,2호선,선릉,64860,57484,122344,5
2023-05-18,2호선,강남,87894,84944,172838,5
2023-05-18,2호선,사당,43196,47218,90414,5
2023-05-18,2호선,신림,61390,59025,120415,5
2023-05-18,2호선,구로디지털단지,65873,64969,130842,5
2023-05-18,2호선,홍대입구,66035,70702,136737,5
2023-05-18,3호선,고속터미널,45727,42416,88143,5
2023-05-18,4호선,사당,29354,25735,55089,5
2023-05-18,7호선,가산디지털단지,49282,50061,99343,5
2023-05-18,8호선,잠실(송파구청),15554,18546,34100,5
2023-05-18,9호선,고속터미널,15144,19163,34307,5
2023-05-18,경부선,서울역,8332,2597,10929,5
2023-05-18,경부선,가산디지털단지,20004,23340,43344,5
2023-05-18,경의선,서울역,5474,6893,12367,5
2023-05-18,경의선,홍대입구,2070,2462,4532,5
2023-05-18,공항철도 1호선,서울역,12665,10645,23310,5
2023-05-18,공항철도 1호선,홍대입구,12743,12693,25436,5
2023-05-18,분당선,선릉,15190,23115,38305,5
2023-05-18,신림선,신림,1787,2536,4323,5
2023-05-19,4호선,사당,32089,28231,60320,5
2023-05-19,4호선,서울역,14680,25147,39827,5
2023-05-19,경의선,서울역,5734,7234,12968,5
2023-05-19,9호선,고속터미널,18970,25076,44046,5
2023-05-19,1호선,서울역,66461,61394,127855,5
2023-05-19,2호선,잠실(송파구청),88605,88496,177101,5
2023-05-19,2호선,선릉,64198,56811,121009,5
2023-05-19,2호선,강남,94132,92240,186372,5
2023-05-19,2호선,사당,46690,52621,99311,5
2023-05-19,2호선,신림,63754,61521,125275,5
2023-05-19,2호선,구로디지털단지,66347,65362,131709,5
2023-05-19,2호선,홍대입구,76459,86904,163363,5
2023-05-19,3호선,고속터미널,57612,55923,113535,5
2023-05-19,경부선,서울역,11521,3586,15107,5
2023-05-19,경부선,가산디지털단지,20014,23226,43240,5
2023-05-19,신림선,신림,1916,2761,4677,5
2023-05-19,분당선,선릉,14841,23000,37841,5
2023-05-19,공항철도 1호선,홍대입구,15560,15744,31304,5
2023-05-19,공항철도 1호선,서울역,15368,13362,28730,5
2023-05-19,경의선,홍대입구,2543,3125,5668,5
2023-05-19,8호선,잠실(송파구청),16966,20780,37746,5
2023-05-19,7호선,가산디지털단지,49493,49384,98877,5
2023-05-19,7호선,고속터미널,21169,16611,37780,5
2023-05-20,신림선,신림,1468,2259,3727,5
2023-05-20,7호선,가산디지털단지,17132,15516,32648,5
2023-05-20,8호선,잠실(송파구청),15021,17801,32822,5
2023-05-20,7호선,고속터미널,18616,14397,33013,5
2023-05-20,4호선,사당,27500,25242,52742,5
2023-05-20,4호선,서울역,8853,21367,30220,5
2023-05-20,3호선,고속터미널,64636,61924,126560,5
2023-05-20,2호선,홍대입구,86055,99392,185447,5
2023-05-20,2호선,구로디지털단지,40107,38540,78647,5
2023-05-20,2호선,신림,52845,50682,103527,5
2023-05-20,2호선,사당,40332,45177,85509,5
2023-05-20,2호선,강남,65002,64255,129257,5
2023-05-20,2호선,선릉,28743,24981,53724,5
2023-05-20,2호선,잠실(송파구청),79913,76393,156306,5
2023-05-20,1호선,서울역,52158,50312,102470,5
2023-05-20,9호선,고속터미널,19906,28718,48624,5
2023-05-20,경부선,서울역,11882,3161,15043,5
2023-05-20,경부선,가산디지털단지,7434,10087,17521,5
2023-05-20,경의선,서울역,2034,2183,4217,5
2023-05-20,경의선,홍대입구,2737,3437,6174,5
2023-05-20,공항철도 1호선,서울역,14195,13747,27942,5
2023-05-20,공항철도 1호선,홍대입구,18878,18727,37605,5
2023-05-20,분당선,선릉,6038,9735,15773,5
2023-05-21,4호선,서울역,5903,16349,22252,5
2023-05-21,4호선,사당,19214,17916,37130,5
2023-05-21,신림선,신림,1121,1708,2829,5
2023-05-21,분당선,선릉,3191,4953,8144,5
2023-05-21,공항철도 1호선,홍대입구,15064,13563,28627,5
2023-05-21,공항철도 1호선,서울역,13435,12515,25950,5
2023-05-21,경의선,홍대입구,2305,2789,5094,5
2023-05-21,경의선,서울역,1378,1378,2756,5
2023-05-21,경부선,가산디지털단지,5625,7675,13300,5
2023-05-21,경부선,서울역,10970,2583,13553,5
2023-05-21,9호선,고속터미널,19632,27131,46763,5
2023-05-21,8호선,잠실(송파구청),11753,13196,24949,5
2023-05-21,7호선,가산디지털단지,13132,11960,25092,5
2023-05-21,7호선,고속터미널,16617,11300,27917,5
2023-05-21,1호선,서울역,38712,37299,76011,5
2023-05-21,2호선,잠실(송파구청),59524,54926,114450,5
2023-05-21,2호선,선릉,16164,13675,29839,5
2023-05-21,2호선,강남,38705,36248,74953,5
2023-05-21,2호선,사당,27444,29429,56873,5
2023-05-21,2호선,신림,39088,37825,76913,5
2023-05-21,2호선,구로디지털단지,28268,27166,55434,5
2023-05-21,2호선,홍대입구,65701,65310,131011,5
2023-05-21,3호선,고속터미널,58781,50346,109127,5
2023-05-22,3호선,고속터미널,44787,42493,87280,5
2023-05-22,4호선,서울역,13475,21389,34864,5
2023-05-22,4호선,사당,27702,24226,51928,5
2023-05-22,7호선,고속터미널,17794,15200,32994,5
2023-05-22,7호선,가산디지털단지,50357,50919,101276,5
2023-05-22,8호선,잠실(송파구청),15257,17333,32590,5
2023-05-22,9호선,고속터미널,14551,19108,33659,5
2023-05-22,경부선,서울역,8994,2751,11745,5
2023-05-22,경부선,가산디지털단지,20114,23526,43640,5
2023-05-22,경의선,서울역,5433,7160,12593,5
2023-05-22,경의선,홍대입구,2012,2343,4355,5
2023-05-22,공항철도 1호선,서울역,12336,11159,23495,5
2023-05-22,공항철도 1호선,홍대입구,12542,12098,24640,5
2023-05-22,분당선,선릉,14870,22715,37585,5
2023-05-22,신림선,신림,1821,2588,4409,5
2023-05-22,1호선,서울역,55134,52654,107788,5
2023-05-22,2호선,잠실(송파구청),71758,71453,143211,5
2023-05-22,2호선,선릉,64103,56623,120726,5
2023-05-22,2호선,강남,85513,82122,167635,5
2023-05-22,2호선,사당,40235,44261,84496,5
2023-05-22,2호선,신림,59596,57295,116891,5
2023-05-22,2호선,구로디지털단지,63708,63193,126901,5
2023-05-22,2호선,홍대입구,63221,65728,128949,5
2023-05-23,신림선,신림,1761,2609,4370,5
2023-05-23,분당선,선릉,15178,23237,38415,5
2023-05-23,공항철도 1호선,홍대입구,12659,12151,24810,5
2023-05-23,공항철도 1호선,서울역,11504,10145,21649,5
2023-05-23,경의선,홍대입구,2054,2529,4583,5
2023-05-23,경의선,서울역,5426,7211,12637,5
2023-05-23,경부선,가산디지털단지,20315,23858,44173,5
2023-05-23,경부선,서울역,7785,2444,10229,5
2023-05-23,9호선,고속터미널,14667,18631,33298,5
2023-05-23,8호선,잠실(송파구청),15029,18118,33147,5
2023-05-23,7호선,가산디지털단지,50389,51082,101471,5
2023-05-23,7호선,고속터미널,16601,15114,31715,5
2023-05-23,4호선,사당,28770,24909,53679,5
2023-05-23,4호선,서울역,13568,20838,34406,5
2023-05-23,3호선,고속터미널,43844,41071,84915,5
2023-05-23,2호선,홍대입구,64244,67229,131473,5
2023-05-23,2호선,구로디지털단지,65601,64970,130571,5
2023-05-23,2호선,신림,60944,58883,119827,5
2023-05-23,2호선,사당,42655,46453,89108,5
2023-05-23,2호선,강남,87828,84338,172166,5
2023-05-23,2호선,선릉,65662,58072,123734,5
2023-05-23,2호선,잠실(송파구청),76121,75914,152035,5
2023-05-23,1호선,서울역,54578,51890,106468,5
2023-05-24,1호선,서울역,55387,52932,108319,5
2023-05-24,2호선,잠실(송파구청),77965,77580,155545,5
2023-05-24,2호선,선릉,65354,57721,123075,5
2023-05-24,2호선,강남,88103,84387,172490,5
2023-05-24,2호선,사당,43478,47283,90761,5
2023-05-24,2호선,신림,61657,59274,120931,5
2023-05-24,2호선,구로디지털단지,65154,64580,129734,5
2023-05-24,2호선,홍대입구,64786,68431,133217,5
2023-05-24,3호선,고속터미널,43493,40721,84214,5
2023-05-24,4호선,서울역,14130,21611,35741,5
2023-05-24,4호선,사당,28926,25369,54295,5
2023-05-24,7호선,고속터미널,16792,15006,31798,5
2023-05-24,7호선,가산디지털단지,50429,50931,101360,5
2023-05-24,8호선,잠실(송파구청),15280,18249,33529,5
2023-05-24,9호선,고속터미널,14669,18615,33284,5
2023-05-24,경부선,서울역,8092,2467,10559,5
2023-05-24,경부선,가산디지털단지,20279,23755,44034,5
2023-05-24,경의선,서울역,5437,6953,12390,5
2023-05-24,경의선,홍대입구,2128,2489,4617,5
2023-05-24,공항철도 1호선,서울역,11923,10587,22510,5
2023-05-24,공항철도 1호선,홍대입구,12782,12718,25500,5
2023-05-24,분당선,선릉,14936,22910,37846,5
2023-05-24,신림선,신림,1863,2665,4528,5
2023-05-25,9호선,고속터미널,15614,19500,35114,5
2023-05-25,경부선,서울역,9372,2853,12225,5
2023-05-25,경부선,가산디지털단지,20378,23386,43764,5
2023-05-25,신림선,신림,1886,2657,4543,5
2023-05-25,분당선,선릉,14811,23178,37989,5
2023-05-25,공항철도 1호선,홍대입구,12948,13121,26069,5
2023-05-25,공항철도 1호선,서울역,13379,11475,24854,5
2023-05-25,경의선,홍대입구,2108,2588,4696,5
2023-05-25,경의선,서울역,5663,7125,12788,5
2023-05-25,1호선,서울역,57616,55665,113281,5
2023-05-25,2호선,잠실(송파구청),83233,82540,165773,5
2023-05-25,2호선,선릉,66588,59113,125701,5
2023-05-25,2호선,강남,89266,86110,175376,5
2023-05-25,2호선,사당,44974,49055,94029,5
2023-05-25,2호선,신림,62344,59924,122268,5
2023-05-25,2호선,구로디지털단지,66272,65362,131634,5
2023-05-25,2호선,홍대입구,66387,71024,137411,5
2023-05-25,3호선,고속터미널,47340,44257,91597,5
2023-05-25,4호선,서울역,14185,23041,37226,5
2023-05-25,4호선,사당,29634,26309,55943,5
2023-05-25,7호선,고속터미널,17622,15388,33010,5
2023-05-25,7호선,가산디지털단지,49560,50548,100108,5
2023-05-25,8호선,잠실(송파구청),15948,19186,35134,5
2023-05-26,1호선,서울역,62574,62450,125024,5
2023-05-26,2호선,홍대입구,72531,82484,155015,5
2023-05-26,2호선,구로디지털단지,66046,64648,130694,5
2023-05-26,2호선,신림,64241,61234,125475,5
2023-05-26,2호선,사당,45796,50462,96258,5
2023-05-26,2호선,강남,92836,91396,184232,5
2023-05-26,2호선,선릉,62851,55578,118429,5
2023-05-26,2호선,잠실(송파구청),84805,84544,169349,5
2023-05-26,신림선,신림,1858,2747,4605,5
2023-05-26,분당선,선릉,14486,22341,36827,5
2023-05-26,공항철도 1호선,홍대입구,14765,15004,29769,5
2023-05-26,공항철도 1호선,서울역,15646,14007,29653,5
2023-05-26,경의선,홍대입구,2385,3002,5387,5
2023-05-26,경의선,서울역,5589,7401,12990,5
2023-05-26,3호선,고속터미널,57870,62567,120437,5
2023-05-26,경부선,가산디지털단지,20505,23628,44133,5
2023-05-26,경부선,서울역,11593,3820,15413,5
2023-05-26,9호선,고속터미널,18574,27440,46014,5
2023-05-26,8호선,잠실(송파구청),16124,19851,35975,5
2023-05-26,7호선,가산디지털단지,49449,49159,98608,5
2023-05-26,7호선,고속터미널,21580,17825,39405,5
2023-05-26,4호선,사당,30064,27708,57772,5
2023-05-26,4호선,서울역,14226,25093,39319,5
2023-05-27,1호선,서울역,45017,45037,90054,5
2023-05-27,2호선,잠실(송파구청),69908,68217,138125,5
2023-05-27,2호선,선릉,21846,19300,41146,5
2023-05-27,2호선,강남,48073,47454,95527,5
2023-05-27,2호선,사당,30956,34271,65227,5
2023-05-27,2호선,신림,44091,41729,85820,5
2023-05-27,2호선,구로디지털단지,32828,31589,64417,5
2023-05-27,2호선,홍대입구,71143,79301,150444,5
2023-05-27,3호선,고속터미널,56680,61075,117755,5
2023-05-27,4호선,서울역,6721,19156,25877,5
2023-05-27,4호선,사당,21473,19375,40848,5
2023-05-27,7호선,고속터미널,16703,12780,29483,5
2023-05-27,7호선,가산디지털단지,13826,12119,25945,5
2023-05-27,8호선,잠실(송파구청),14715,16849,31564,5
2023-05-27,9호선,고속터미널,14999,25842,40841,5
2023-05-27,경부선,서울역,10097,3228,13325,5
2023-05-27,경부선,가산디지털단지,5854,8270,14124,5
2023-05-27,경의선,서울역,1510,1743,3253,5
2023-05-27,경의선,홍대입구,2044,2765,4809,5
2023-05-27,공항철도 1호선,서울역,13610,13136,26746,5
2023-05-27,공항철도 1호선,홍대입구,15043,15310,30353,5
2023-05-27,분당선,선릉,4562,7018,11580,5
2023-05-27,신림선,신림,1259,1776,3035,5
2023-05-28,2호선,잠실(송파구청),56346,52716,109062,5
2023-05-28,2호선,선릉,14175,12230,26405,5
2023-05-28,2호선,강남,34275,34026,68301,5
2023-05-28,신림선,신림,1097,1461,2558,5
2023-05-28,분당선,선릉,2971,4499,7470,5
2023-05-28,공항철도 1호선,홍대입구,12766,11931,24697,5
2023-05-28,공항철도 1호선,서울역,12971,11361,24332,5
2023-05-28,경의선,홍대입구,1643,2173,3816,5
2023-05-28,경의선,서울역,1177,1127,2304,5
2023-05-28,경부선,가산디지털단지,4578,6289,10867,5
2023-05-28,경부선,서울역,10254,2457,12711,5
2023-05-28,9호선,고속터미널,11833,18364,30197,5
2023-05-28,8호선,잠실(송파구청),12628,14155,26783,5
2023-05-28,7호선,가산디지털단지,10528,9364,19892,5
2023-05-28,7호선,고속터미널,15056,8925,23981,5
2023-05-28,4호선,사당,16154,14515,30669,5
2023-05-28,4호선,서울역,5289,14535,19824,5
2023-05-28,3호선,고속터미널,47379,43115,90494,5
2023-05-28,2호선,홍대입구,57141,60555,117696,5
2023-05-28,2호선,구로디지털단지,25345,24756,50101,5
2023-05-28,2호선,신림,35763,35070,70833,5
2023-05-28,2호선,사당,22314,24494,46808,5
2023-05-28,1호선,서울역,35365,33020,68385,5
2023-05-29,1호선,서울역,37772,35944,73716,5
2023-05-29,2호선,잠실(송파구청),55148,51271,106419,5
2023-05-29,2호선,선릉,20521,18379,38900,5
2023-05-29,2호선,강남,42398,40499,82897,5
2023-05-29,2호선,사당,24260,26552,50812,5
2023-05-29,2호선,신림,38160,37857,76017,5
2023-05-29,2호선,구로디지털단지,29031,28284,57315,5
2023-05-29,2호선,홍대입구,60519,62244,122763,5
2023-05-29,3호선,고속터미널,54617,45651,100268,5
2023-05-29,4호선,서울역,5399,13807,19206,5
2023-05-29,4호선,사당,16431,15452,31883,5
2023-05-29,7호선,고속터미널,17303,9892,27195,5
2023-05-29,7호선,가산디지털단지,13829,13034,26863,5
2023-05-29,8호선,잠실(송파구청),11886,13094,24980,5
2023-05-29,9호선,고속터미널,15203,20144,35347,5
2023-05-29,경부선,서울역,10571,2080,12651,5
2023-05-29,경부선,가산디지털단지,5701,7928,13629,5
2023-05-29,경의선,서울역,1712,1442,3154,5
2023-05-29,경의선,홍대입구,1908,2328,4236,5
2023-05-29,공항철도 1호선,서울역,12420,12011,24431,5
2023-05-29,공항철도 1호선,홍대입구,13231,11687,24918,5
2023-05-29,분당선,선릉,4102,6312,10414,5
2023-05-29,신림선,신림,1266,1899,3165,5
2023-05-30,2호선,강남,84871,81319,166190,5
2023-05-30,2호선,선릉,65499,57978,123477,5
2023-05-30,2호선,잠실(송파구청),74483,74517,149000,5
2023-05-30,1호선,서울역,56320,52268,108588,5
2023-05-30,신림선,신림,1781,2601,4382,5
2023-05-30,분당선,선릉,15312,23238,38550,5
2023-05-30,공항철도 1호선,홍대입구,11871,11749,23620,5
2023-05-30,공항철도 1호선,서울역,11972,11081,23053,5
2023-05-30,경의선,홍대입구,2089,2240,4329,5
2023-05-30,경의선,서울역,5563,7250,12813,5
2023-05-30,경부선,가산디지털단지,20426,23604,44030,5
2023-05-30,경부선,서울역,9815,2622,12437,5
2023-05-30,9호선,고속터미널,14309,18107,32416,5
2023-05-30,8호선,잠실(송파구청),14910,17659,32569,5
2023-05-30,7호선,가산디지털단지,49840,50438,100278,5
2023-05-30,7호선,고속터미널,17894,15336,33230,5
2023-05-30,4호선,사당,27935,24204,52139,5
2023-05-30,4호선,서울역,14041,20960,35001,5
2023-05-30,3호선,고속터미널,43613,40387,84000,5
2023-05-30,2호선,홍대입구,61229,63984,125213,5
2023-05-30,2호선,구로디지털단지,64612,64280,128892,5
2023-05-30,2호선,신림,59617,57391,117008,5
2023-05-30,2호선,사당,40561,44853,85414,5
2023-05-31,1호선,서울역,54953,52227,107180,5
2023-05-31,2호선,강남,85107,81657,166764,5
2023-05-31,2호선,선릉,64795,57317,122112,5
2023-05-31,2호선,잠실(송파구청),75672,75777,151449,5
2023-05-31,신림선,신림,1893,2651,4544,5
2023-05-31,분당선,선릉,14908,23022,37930,5
2023-05-31,공항철도 1호선,홍대입구,12146,12156,24302,5
2023-05-31,공항철도 1호선,서울역,11309,10084,21393,5
2023-05-31,경의선,홍대입구,2106,2409,4515,5
2023-05-31,경의선,서울역,5552,6802,12354,5
2023-05-31,경부선,가산디지털단지,20227,23428,43655,5
2023-05-31,경부선,서울역,7421,2316,9737,5
2023-05-31,9호선,고속터미널,14359,17978,32337,5
2023-05-31,8호선,잠실(송파구청),15620,18307,33927,5
2023-05-31,7호선,가산디지털단지,49696,50501,100197,5
2023-05-31,7호선,고속터미널,16901,15136,32037,5
2023-05-31,4호선,사당,28618,24652,53270,5
2023-05-31,4호선,서울역,14536,21379,35915,5
2023-05-31,3호선,고속터미널,42952,40101,83053,5
2023-05-31,2호선,홍대입구,63015,67211,130226,5
2023-05-31,2호선,구로디지털단지,65039,64581,129620,5
2023-05-31,2호선,신림,60821,58954,119775,5
2023-05-31,2호선,사당,41501,45490,86991,5
2023-06-01,경의선,서울역,5541,6880,12421,6
2023-06-01,신림선,신림,1865,2621,4486,6
2023-06-01,분당선,선릉,15150,22993,38143,6
2023-06-01,공항철도 1호선,홍대입구,12440,12698,25138,6
2023-06-01,공항철도 1호선,서울역,12536,10383,22919,6
2023-06-01,경의선,홍대입구,2023,2375,4398,6
2023-06-01,경부선,가산디지털단지,20056,23644,43700,6
2023-06-01,경부선,서울역,8168,2531,10699,6
2023-06-01,9호선,고속터미널,15261,18740,34001,6
2023-06-01,8호선,잠실(송파구청),15108,18176,33284,6
2023-06-01,7호선,가산디지털단지,49827,50840,100667,6
2023-06-01,7호선,고속터미널,17389,14988,32377,6
2023-06-01,4호선,사당,29132,24837,53969,6
2023-06-01,4호선,서울역,13900,20956,34856,6
2023-06-01,3호선,고속터미널,44533,41375,85908,6
2023-06-01,2호선,홍대입구,64608,68937,133545,6
2023-06-01,2호선,구로디지털단지,65527,64830,130357,6
2023-06-01,2호선,신림,61320,59562,120882,6
2023-06-01,2호선,사당,42129,46051,88180,6
2023-06-01,2호선,강남,87052,83935,170987,6
2023-06-01,2호선,선릉,65756,58214,123970,6
2023-06-01,2호선,잠실(송파구청),78452,78912,157364,6
2023-06-01,1호선,서울역,54512,52699,107211,6
2023-06-02,신림선,신림,1886,2670,4556,6
2023-06-02,분당선,선릉,14742,22489,37231,6
2023-06-02,공항철도 1호선,홍대입구,14200,14931,29131,6
2023-06-02,공항철도 1호선,서울역,15233,13012,28245,6
2023-06-02,경의선,홍대입구,2329,2853,5182,6
2023-06-02,경의선,서울역,5649,7219,12868,6
2023-06-02,경부선,가산디지털단지,20384,23466,43850,6
2023-06-02,경부선,서울역,10522,3483,14005,6
2023-06-02,9호선,고속터미널,17062,23812,40874,6
2023-06-02,8호선,잠실(송파구청),16366,19820,36186,6
2023-06-02,7호선,가산디지털단지,49895,50218,100113,6
2023-06-02,7호선,고속터미널,20165,16676,36841,6
2023-06-02,4호선,사당,30606,26863,57469,6
2023-06-02,4호선,서울역,14249,24006,38255,6
2023-06-02,3호선,고속터미널,53140,55202,108342,6
2023-06-02,2호선,홍대입구,72013,81190,153203,6
2023-06-02,2호선,구로디지털단지,66247,65545,131792,6
2023-06-02,2호선,신림,63200,61028,124228,6
2023-06-02,2호선,사당,44604,49946,94550,6
2023-06-02,2호선,강남,90495,88715,179210,6
2023-06-02,2호선,선릉,64003,57092,121095,6
2023-06-02,2호선,잠실(송파구청),81204,81553,162757,6
2023-06-02,1호선,서울역,62092,60686,122778,6
2023-06-03,2호선,홍대입구,80228,91151,171379,6
2023-06-03,2호선,구로디지털단지,38775,37050,75825,6
2023-06-03,2호선,신림,50358,47846,98204,6
2023-06-03,신림선,신림,1503,2037,3540,6
2023-06-03,2호선,사당,36212,42144,78356,6
2023-06-03,2호선,강남,58532,58520,117052,6
2023-06-03,2호선,선릉,27792,24080,51872,6
2023-06-03,2호선,잠실(송파구청),73516,71253,144769,6
2023-06-03,1호선,서울역,45758,45621,91379,6
2023-06-03,3호선,고속터미널,60380,60378,120758,6
2023-06-03,4호선,서울역,7778,19558,27336,6
2023-06-03,4호선,사당,26598,24435,51033,6
2023-06-03,7호선,고속터미널,17401,14097,31498,6
2023-06-03,7호선,가산디지털단지,16566,14727,31293,6
2023-06-03,8호선,잠실(송파구청),14517,17518,32035,6
2023-06-03,9호선,고속터미널,18433,26957,45390,6
2023-06-03,경부선,서울역,10763,2998,13761,6
2023-06-03,경부선,가산디지털단지,7043,9559,16602,6
2023-06-03,경의선,서울역,1831,2029,3860,6
2023-06-03,경의선,홍대입구,2473,3199,5672,6
2023-06-03,공항철도 1호선,서울역,14016,13784,27800,6
2023-06-03,공항철도 1호선,홍대입구,17119,17201,34320,6
2023-06-03,분당선,선릉,5621,9026,14647,6
2023-06-04,신림선,신림,1234,1819,3053,6
2023-06-04,1호선,서울역,36059,35510,71569,6
2023-06-04,2호선,잠실(송파구청),57860,54148,112008,6
2023-06-04,2호선,선릉,14957,12744,27701,6
2023-06-04,2호선,강남,35050,33479,68529,6
2023-06-04,2호선,사당,25246,27992,53238,6
2023-06-04,2호선,신림,37885,36858,74743,6
2023-06-04,2호선,구로디지털단지,27732,26531,54263,6
2023-06-04,2호선,홍대입구,64476,65796,130272,6
2023-06-04,3호선,고속터미널,53006,47146,100152,6
2023-06-04,4호선,서울역,5685,15582,21267,6
2023-06-04,4호선,사당,18614,16931,35545,6
2023-06-04,7호선,고속터미널,14527,9908,24435,6
2023-06-04,7호선,가산디지털단지,12277,11246,23523,6
2023-06-04,8호선,잠실(송파구청),12086,13699,25785,6
2023-06-04,9호선,고속터미널,17452,24768,42220,6
2023-06-04,경부선,서울역,9888,2704,12592,6
2023-06-04,경부선,가산디지털단지,5278,7157,12435,6
2023-06-04,경의선,서울역,1354,1421,2775,6
2023-06-04,경의선,홍대입구,2091,2555,4646,6
2023-06-04,공항철도 1호선,서울역,12628,12495,25123,6
2023-06-04,공항철도 1호선,홍대입구,14226,13236,27462,6
2023-06-04,분당선,선릉,3147,4638,7785,6
2023-06-05,8호선,잠실(송파구청),15577,18287,33864,6
2023-06-05,7호선,가산디지털단지,38483,38676,77159,6
2023-06-05,7호선,고속터미널,17587,14903,32490,6
2023-06-05,9호선,고속터미널,15283,20595,35878,6
2023-06-05,경부선,서울역,9908,2553,12461,6
2023-06-05,경의선,서울역,4728,6195,10923,6
2023-06-05,경의선,홍대입구,2193,2757,4950,6
2023-06-05,공항철도 1호선,서울역,12925,11245,24170,6
2023-06-05,공항철도 1호선,홍대입구,14527,14037,28564,6
2023-06-05,분당선,선릉,12104,18189,30293,6
2023-06-05,신림선,신림,1761,2505,4266,6
2023-06-05,1호선,서울역,52336,48308,100644,6
2023-06-05,2호선,잠실(송파구청),78441,77703,156144,6
2023-06-05,2호선,선릉,53042,47489,100531,6
2023-06-05,2호선,강남,79084,77268,156352,6
2023-06-05,2호선,사당,37947,42381,80328,6
2023-06-05,2호선,신림,56915,55350,112265,6
2023-06-05,2호선,구로디지털단지,56622,56176,112798,6
2023-06-05,2호선,홍대입구,69835,76514,146349,6
2023-06-05,경부선,가산디지털단지,15348,18221,33569,6
2023-06-05,3호선,고속터미널,49379,46183,95562,6
2023-06-05,4호선,서울역,11634,19793,31427,6
2023-06-05,4호선,사당,26737,23744,50481,6
2023-06-06,1호선,서울역,36294,31788,68082,6
2023-06-06,2호선,잠실(송파구청),56484,53518,110002,6
2023-06-06,2호선,선릉,17069,15045,32114,6
2023-06-06,2호선,강남,35557,33637,69194,6
2023-06-06,2호선,사당,26297,28307,54604,6
2023-06-06,2호선,신림,38069,37645,75714,6
2023-06-06,2호선,구로디지털단지,28476,27723,56199,6
2023-06-06,2호선,홍대입구,61410,63147,124557,6
2023-06-06,3호선,고속터미널,45754,39867,85621,6
2023-06-06,4호선,서울역,5818,12807,18625,6
2023-06-06,4호선,사당,18179,16852,35031,6
2023-06-06,7호선,고속터미널,12558,9037,21595,6
2023-06-06,7호선,가산디지털단지,12798,12123,24921,6
2023-06-06,8호선,잠실(송파구청),12511,13997,26508,6
2023-06-06,9호선,고속터미널,13597,18439,32036,6
2023-06-06,경부선,서울역,9191,1903,11094,6
2023-06-06,경부선,가산디지털단지,5651,7541,13192,6
2023-06-06,경의선,서울역,1570,1380,2950,6
2023-06-06,경의선,홍대입구,2139,2471,4610,6
2023-06-06,공항철도 1호선,서울역,10802,9997,20799,6
2023-06-06,공항철도 1호선,홍대입구,13528,12187,25715,6
2023-06-06,분당선,선릉,3357,5037,8394,6
2023-06-06,신림선,신림,1219,1819,3038,6
2023-06-07,분당선,선릉,15184,23159,38343,6
2023-06-07,공항철도 1호선,홍대입구,11910,11403,23313,6
2023-06-07,공항철도 1호선,서울역,11685,10365,22050,6
2023-06-07,신림선,신림,1733,2479,4212,6
2023-06-07,4호선,사당,27909,24319,52228,6
2023-06-07,4호선,서울역,14000,20803,34803,6
2023-06-07,3호선,고속터미널,42393,39402,81795,6
2023-06-07,2호선,홍대입구,59759,63213,122972,6
2023-06-07,1호선,서울역,53834,51040,104874,6
2023-06-07,7호선,고속터미널,17621,15249,32870,6
2023-06-07,7호선,가산디지털단지,49837,50464,100301,6
2023-06-07,8호선,잠실(송파구청),14819,17670,32489,6
2023-06-07,9호선,고속터미널,14378,17761,32139,6
2023-06-07,경부선,서울역,8125,2479,10604,6
2023-06-07,경부선,가산디지털단지,20361,23340,43701,6
2023-06-07,경의선,서울역,5384,7058,12442,6
2023-06-07,경의선,홍대입구,2022,2325,4347,6
2023-06-07,2호선,잠실(송파구청),73236,73641,146877,6
2023-06-07,2호선,선릉,64897,57767,122664,6
2023-06-07,2호선,강남,85490,81928,167418,6
2023-06-07,2호선,사당,40839,44651,85490,6
2023-06-07,2호선,신림,60066,57985,118051,6
2023-06-07,2호선,구로디지털단지,64728,64430,129158,6
2023-06-08,경부선,가산디지털단지,20010,23329,43339,6
2023-06-08,경부선,서울역,7949,2503,10452,6
2023-06-08,2호선,잠실(송파구청),75575,76373,151948,6
2023-06-08,2호선,선릉,65693,58183,123876,6
2023-06-08,2호선,강남,86729,82990,169719,6
2023-06-08,2호선,사당,42764,46637,89401,6
2023-06-08,1호선,서울역,56171,52055,108226,6
2023-06-08,2호선,홍대입구,61744,65496,127240,6
2023-06-08,2호선,구로디지털단지,65037,64570,129607,6
2023-06-08,2호선,신림,60249,57506,117755,6
2023-06-08,3호선,고속터미널,43445,40503,83948,6
2023-06-08,4호선,서울역,14304,21163,35467,6
2023-06-08,경의선,서울역,5446,6884,12330,6
2023-06-08,8호선,잠실(송파구청),15216,17728,32944,6
2023-06-08,9호선,고속터미널,14592,18249,32841,6
2023-06-08,신림선,신림,1693,2545,4238,6
2023-06-08,4호선,사당,28726,24784,53510,6
2023-06-08,7호선,가산디지털단지,49796,50545,100341,6
2023-06-08,7호선,고속터미널,17223,14990,32213,6
2023-06-08,분당선,선릉,15269,23003,38272,6
2023-06-08,공항철도 1호선,홍대입구,11653,11944,23597,6
2023-06-08,공항철도 1호선,서울역,12178,10204,22382,6
2023-06-08,경의선,홍대입구,1953,2306,4259,6
2023-06-09,신림선,신림,1868,2602,4470,6
2023-06-09,분당선,선릉,14967,23179,38146,6
2023-06-09,공항철도 1호선,홍대입구,13964,14235,28199,6
2023-06-09,공항철도 1호선,서울역,14732,12716,27448,6
2023-06-09,경의선,홍대입구,2162,2716,4878,6
2023-06-09,경의선,서울역,5468,6923,12391,6
2023-06-09,경부선,가산디지털단지,20132,23435,43567,6
2023-06-09,경부선,서울역,10631,3273,13904,6
2023-06-09,9호선,고속터미널,16752,22845,39597,6
2023-06-09,8호선,잠실(송파구청),15970,19288,35258,6
2023-06-09,7호선,가산디지털단지,50235,50467,100702,6
2023-06-09,7호선,고속터미널,19332,16266,35598,6
2023-06-09,4호선,사당,30583,27437,58020,6
2023-06-09,4호선,서울역,14464,23936,38400,6
2023-06-09,3호선,고속터미널,51920,51908,103828,6
2023-06-09,2호선,홍대입구,69173,79100,148273,6
2023-06-09,2호선,구로디지털단지,66313,65798,132111,6
2023-06-09,2호선,신림,62727,60591,123318,6
2023-06-09,2호선,사당,45488,50303,95791,6
2023-06-09,2호선,강남,90972,89066,180038,6
2023-06-09,2호선,선릉,64665,57045,121710,6
2023-06-09,2호선,잠실(송파구청),79635,79579,159214,6
2023-06-09,1호선,서울역,60513,58360,118873,6
2023-06-10,1호선,서울역,42829,41703,84532,6
2023-06-10,신림선,신림,1411,1974,3385,6
2023-06-10,2호선,잠실(송파구청),70794,68261,139055,6
2023-06-10,2호선,선릉,27610,24384,51994,6
2023-06-10,2호선,강남,58314,57744,116058,6
2023-06-10,2호선,사당,38289,42557,80846,6
2023-06-10,2호선,신림,49032,46931,95963,6
2023-06-10,2호선,구로디지털단지,37520,36366,73886,6
2023-06-10,2호선,홍대입구,74931,84318,159249,6
2023-06-10,3호선,고속터미널,55034,53702,108736,6
2023-06-10,4호선,서울역,7113,17634,24747,6
2023-06-10,4호선,사당,25681,23548,49229,6
2023-06-10,7호선,고속터미널,16270,13022,29292,6
2023-06-10,7호선,가산디지털단지,15115,13751,28866,6
2023-06-10,8호선,잠실(송파구청),14271,16861,31132,6
2023-06-10,9호선,고속터미널,16031,23390,39421,6
2023-06-10,경부선,서울역,9865,2626,12491,6
2023-06-10,경부선,가산디지털단지,6936,9063,15999,6
2023-06-10,경의선,서울역,1636,1829,3465,6
2023-06-10,경의선,홍대입구,2206,2904,5110,6
2023-06-10,공항철도 1호선,서울역,12369,11866,24235,6
2023-06-10,공항철도 1호선,홍대입구,15674,15571,31245,6
2023-06-10,분당선,선릉,5798,9148,14946,6
2023-06-11,1호선,서울역,33118,31083,64201,6
2023-06-11,2호선,잠실(송파구청),50638,46963,97601,6
2023-06-11,2호선,선릉,14968,12603,27571,6
2023-06-11,2호선,강남,32973,31292,64265,6
2023-06-11,2호선,사당,25205,26781,51986,6
2023-06-11,2호선,신림,36025,35251,71276,6
2023-06-11,2호선,구로디지털단지,27335,26398,53733,6
2023-06-11,2호선,홍대입구,58070,57786,115856,6
2023-06-11,3호선,고속터미널,48230,43292,91522,6
2023-06-11,4호선,서울역,5426,13558,18984,6
2023-06-11,4호선,사당,17576,16627,34203,6
2023-06-11,7호선,고속터미널,13762,9263,23025,6
2023-06-11,7호선,가산디지털단지,11391,10439,21830,6
2023-06-11,8호선,잠실(송파구청),10650,11778,22428,6
2023-06-11,9호선,고속터미널,15082,20738,35820,6
2023-06-11,경부선,서울역,9633,2189,11822,6
2023-06-11,경부선,가산디지털단지,5081,6873,11954,6
2023-06-11,경의선,서울역,1287,1197,2484,6
2023-06-11,경의선,홍대입구,1871,2269,4140,6
2023-06-11,공항철도 1호선,서울역,12273,10882,23155,6
2023-06-11,공항철도 1호선,홍대입구,12648,11649,24297,6
2023-06-11,분당선,선릉,3078,4758,7836,6
2023-06-11,신림선,신림,1053,1636,2689,6
2023-06-12,3호선,고속터미널,43741,41410,85151,6
2023-06-12,4호선,서울역,13306,21069,34375,6
2023-06-12,4호선,사당,27226,23837,51063,6
2023-06-12,9호선,고속터미널,14032,18399,32431,6
2023-06-12,경부선,서울역,8140,2624,10764,6
2023-06-12,경부선,가산디지털단지,19987,23201,43188,6
2023-06-12,경의선,서울역,5611,7107,12718,6
2023-06-12,경의선,홍대입구,1980,2345,4325,6
2023-06-12,1호선,서울역,55074,52209,107283,6
2023-06-12,2호선,잠실(송파구청),69972,69986,139958,6
2023-06-12,2호선,선릉,64217,57108,121325,6
2023-06-12,2호선,강남,84498,80886,165384,6
2023-06-12,2호선,사당,39885,43527,83412,6
2023-06-12,2호선,신림,58461,56209,114670,6
2023-06-12,2호선,구로디지털단지,63501,63232,126733,6
2023-06-12,2호선,홍대입구,61295,64078,125373,6
2023-06-12,7호선,고속터미널,17374,14799,32173,6
2023-06-12,7호선,가산디지털단지,50265,50491,100756,6
2023-06-12,8호선,잠실(송파구청),14621,16753,31374,6
2023-06-12,공항철도 1호선,서울역,12439,11032,23471,6
2023-06-12,공항철도 1호선,홍대입구,12313,11951,24264,6
2023-06-12,분당선,선릉,15059,22674,37733,6
2023-06-12,신림선,신림,1747,2647,4394,6
2023-06-13,공항철도 1호선,서울역,11550,10131,21681,6
2023-06-13,공항철도 1호선,홍대입구,12448,12139,24587,6
2023-06-13,분당선,선릉,15263,23337,38600,6
2023-06-13,신림선,신림,1803,2554,4357,6
2023-06-13,경부선,서울역,7428,2397,9825,6
2023-06-13,경부선,가산디지털단지,20368,23505,43873,6
2023-06-13,경의선,홍대입구,2017,2437,4454,6
2023-06-13,경의선,서울역,5566,7032,12598,6
2023-06-13,2호선,구로디지털단지,65231,64796,130027,6
2023-06-13,2호선,신림,59742,57792,117534,6
2023-06-13,2호선,사당,42933,46043,88976,6
2023-06-13,2호선,강남,86823,83465,170288,6
2023-06-13,2호선,선릉,65998,58390,124388,6
2023-06-13,2호선,잠실(송파구청),77000,76572,153572,6
2023-06-13,1호선,서울역,55021,52170,107191,6
2023-06-13,7호선,고속터미널,16799,15165,31964,6
2023-06-13,7호선,가산디지털단지,50331,50763,101094,6
2023-06-13,8호선,잠실(송파구청),15459,18161,33620,6
2023-06-13,9호선,고속터미널,14687,18669,33356,6
2023-06-13,4호선,서울역,14170,21311,35481,6
2023-06-13,4호선,사당,28827,24936,53763,6
2023-06-13,2호선,홍대입구,63980,67225,131205,6
2023-06-13,3호선,고속터미널,44064,40982,85046,6
2023-06-14,1호선,서울역,55547,52055,107602,6
2023-06-14,2호선,잠실(송파구청),77079,77429,154508,6
2023-06-14,2호선,선릉,64940,57458,122398,6
2023-06-14,2호선,강남,86794,83042,169836,6
2023-06-14,2호선,사당,42800,46767,89567,6
2023-06-14,2호선,신림,60231,58335,118566,6
2023-06-14,2호선,구로디지털단지,64742,64415,129157,6
2023-06-14,2호선,홍대입구,64249,68026,132275,6
2023-06-14,3호선,고속터미널,44020,41143,85163,6
2023-06-14,4호선,서울역,14201,21262,35463,6
2023-06-14,4호선,사당,28558,24715,53273,6
2023-06-14,7호선,고속터미널,16886,14936,31822,6
2023-06-14,7호선,가산디지털단지,49636,50057,99693,6
2023-06-14,8호선,잠실(송파구청),15613,18431,34044,6
2023-06-14,9호선,고속터미널,14563,18908,33471,6
2023-06-14,경부선,서울역,7698,2532,10230,6
2023-06-14,경부선,가산디지털단지,19985,23120,43105,6
2023-06-14,경의선,서울역,5390,7009,12399,6
2023-06-14,경의선,홍대입구,2002,2461,4463,6
2023-06-14,공항철도 1호선,서울역,11791,10200,21991,6
2023-06-14,공항철도 1호선,홍대입구,12712,12625,25337,6
2023-06-14,분당선,선릉,15024,22845,37869,6
2023-06-14,신림선,신림,1824,2646,4470,6
2023-06-15,1호선,서울역,56551,54011,110562,6
2023-06-15,2호선,잠실(송파구청),79738,79541,159279,6
2023-06-15,2호선,선릉,66288,58429,124717,6
2023-06-15,2호선,강남,88813,85177,173990,6
2023-06-15,2호선,사당,43966,48141,92107,6
2023-06-15,2호선,신림,61216,58833,120049,6
2023-06-15,2호선,구로디지털단지,65754,65042,130796,6
2023-06-15,2호선,홍대입구,66315,70959,137274,6
2023-06-15,3호선,고속터미널,46153,42920,89073,6
2023-06-15,4호선,서울역,14404,22223,36627,6
2023-06-15,4호선,사당,29218,25196,54414,6
2023-06-15,7호선,고속터미널,17080,14884,31964,6
2023-06-15,7호선,가산디지털단지,49658,50390,100048,6
2023-06-15,8호선,잠실(송파구청),16091,18944,35035,6
2023-06-15,9호선,고속터미널,15164,19649,34813,6
2023-06-15,경부선,서울역,8149,2664,10813,6
2023-06-15,경부선,가산디지털단지,19982,23244,43226,6
2023-06-15,경의선,서울역,5470,6961,12431,6
2023-06-15,경의선,홍대입구,2161,2507,4668,6
2023-06-15,공항철도 1호선,서울역,12770,10884,23654,6
2023-06-15,공항철도 1호선,홍대입구,13321,13502,26823,6
2023-06-15,분당선,선릉,15248,23531,38779,6
2023-06-15,신림선,신림,1866,2584,4450,6
2023-06-16,신림선,신림,1937,2670,4607,6
2023-06-16,1호선,서울역,64614,59560,124174,6
2023-06-16,2호선,잠실(송파구청),83273,83082,166355,6
2023-06-16,2호선,선릉,64112,56356,120468,6
2023-06-16,2호선,강남,92689,90703,183392,6
2023-06-16,2호선,사당,46261,51404,97665,6
2023-06-16,2호선,신림,63368,60970,124338,6
2023-06-16,2호선,구로디지털단지,66290,65623,131913,6
2023-06-16,2호선,홍대입구,73138,83017,156155,6
2023-06-16,3호선,고속터미널,55420,55484,110904,6
2023-06-16,4호선,서울역,14278,24390,38668,6
2023-06-16,4호선,사당,30930,26977,57907,6
2023-06-16,7호선,고속터미널,20091,16320,36411,6
2023-06-16,7호선,가산디지털단지,48948,49007,97955,6
2023-06-16,8호선,잠실(송파구청),16606,19876,36482,6
2023-06-16,9호선,고속터미널,17827,24823,42650,6
2023-06-16,경부선,서울역,9362,3865,13227,6
2023-06-16,경부선,가산디지털단지,19818,22693,42511,6
2023-06-16,경의선,서울역,4046,6354,10400,6
2023-06-16,경의선,홍대입구,2265,2866,5131,6
2023-06-16,공항철도 1호선,서울역,15170,13908,29078,6
2023-06-16,공항철도 1호선,홍대입구,14810,14985,29795,6
2023-06-16,분당선,선릉,14619,22479,37098,6
2023-06-17,2호선,홍대입구,82398,93649,176047,6
2023-06-17,2호선,구로디지털단지,40407,38694,79101,6
2023-06-17,2호선,신림,50851,48782,99633,6
2023-06-17,2호선,사당,40525,45454,85979,6
2023-06-17,1호선,서울역,48447,45424,93871,6
2023-06-17,신림선,신림,1491,2232,3723,6
2023-06-17,분당선,선릉,5983,9291,15274,6
2023-06-17,공항철도 1호선,홍대입구,17172,17267,34439,6
2023-06-17,공항철도 1호선,서울역,14025,13226,27251,6
2023-06-17,경의선,홍대입구,2403,3126,5529,6
2023-06-17,경의선,서울역,1652,1948,3600,6
2023-06-17,경부선,가산디지털단지,7167,9694,16861,6
2023-06-17,경부선,서울역,10859,2965,13824,6
2023-06-17,9호선,고속터미널,18757,27512,46269,6
2023-06-17,8호선,잠실(송파구청),14765,18084,32849,6
2023-06-17,7호선,가산디지털단지,16361,14616,30977,6
2023-06-17,7호선,고속터미널,18397,14120,32517,6
2023-06-17,2호선,잠실(송파구청),79917,75523,155440,6
2023-06-17,2호선,선릉,29140,25140,54280,6
2023-06-17,2호선,강남,63438,62108,125546,6
2023-06-17,4호선,사당,27026,24946,51972,6
2023-06-17,4호선,서울역,7658,19563,27221,6
2023-06-17,3호선,고속터미널,61827,59299,121126,6
2023-06-18,2호선,구로디지털단지,28277,27358,55635,6
2023-06-18,2호선,신림,38346,37469,75815,6
2023-06-18,2호선,사당,26871,29080,55951,6
2023-06-18,2호선,강남,37583,35220,72803,6
2023-06-18,2호선,선릉,16510,13950,30460,6
2023-06-18,2호선,잠실(송파구청),59018,54386,113404,6
2023-06-18,신림선,신림,1265,1780,3045,6
2023-06-18,분당선,선릉,3379,4991,8370,6
2023-06-18,공항철도 1호선,홍대입구,13499,11991,25490,6
2023-06-18,공항철도 1호선,서울역,13770,11569,25339,6
2023-06-18,경의선,홍대입구,2054,2298,4352,6
2023-06-18,경의선,서울역,1356,1347,2703,6
2023-06-18,경부선,가산디지털단지,5206,7001,12207,6
2023-06-18,경부선,서울역,10177,2609,12786,6
2023-06-18,9호선,고속터미널,14785,21611,36396,6
2023-06-18,8호선,잠실(송파구청),11374,13226,24600,6
2023-06-18,7호선,가산디지털단지,11401,10576,21977,6
2023-06-18,4호선,사당,18616,17281,35897,6
2023-06-18,4호선,서울역,5711,15438,21149,6
2023-06-18,3호선,고속터미널,50394,45490,95884,6
2023-06-18,1호선,서울역,36849,35704,72553,6
2023-06-18,7호선,고속터미널,15182,9679,24861,6
2023-06-18,2호선,홍대입구,60523,60793,121316,6
2023-06-19,신림선,신림,1726,2519,4245,6
2023-06-19,분당선,선릉,14694,22494,37188,6
2023-06-19,공항철도 1호선,홍대입구,12720,12105,24825,6
2023-06-19,공항철도 1호선,서울역,12378,11010,23388,6
2023-06-19,경의선,홍대입구,1816,2185,4001,6
2023-06-19,경의선,서울역,5355,7076,12431,6
2023-06-19,경부선,가산디지털단지,19577,22800,42377,6
2023-06-19,경부선,서울역,8818,2904,11722,6
2023-06-19,9호선,고속터미널,13890,18283,32173,6
2023-06-19,8호선,잠실(송파구청),15525,17670,33195,6
2023-06-19,7호선,가산디지털단지,49624,49946,99570,6
2023-06-19,7호선,고속터미널,17544,14528,32072,6
2023-06-19,2호선,잠실(송파구청),74555,74696,149251,6
2023-06-19,2호선,선릉,63299,55798,119097,6
2023-06-19,1호선,서울역,55236,52926,108162,6
2023-06-19,2호선,강남,85484,82095,167579,6
2023-06-19,2호선,사당,39257,42900,82157,6
2023-06-19,2호선,신림,57718,55822,113540,6
2023-06-19,2호선,구로디지털단지,62621,62591,125212,6
2023-06-19,2호선,홍대입구,62838,65734,128572,6
2023-06-19,3호선,고속터미널,40091,37381,77472,6
2023-06-19,4호선,서울역,13780,21452,35232,6
2023-06-19,4호선,사당,26713,23074,49787,6
2023-06-20,7호선,고속터미널,17175,14890,32065,6
2023-06-20,7호선,가산디지털단지,49917,50364,100281,6
2023-06-20,8호선,잠실(송파구청),15713,17906,33619,6
2023-06-20,9호선,고속터미널,14524,18649,33173,6
2023-06-20,경부선,서울역,7914,2744,10658,6
2023-06-20,경부선,가산디지털단지,19744,23083,42827,6
2023-06-20,경의선,서울역,5400,6930,12330,6
2023-06-20,경의선,홍대입구,1854,2258,4112,6
2023-06-20,공항철도 1호선,서울역,12250,10568,22818,6
2023-06-20,공항철도 1호선,홍대입구,12577,12375,24952,6
2023-06-20,분당선,선릉,15303,23221,38524,6
2023-06-20,신림선,신림,1819,2497,4316,6
2023-06-20,4호선,사당,25829,24159,49988,6
2023-06-20,4호선,서울역,14106,21588,35694,6
2023-06-20,3호선,고속터미널,45398,41854,87252,6
2023-06-20,2호선,홍대입구,64760,67984,132744,6
2023-06-20,2호선,구로디지털단지,64129,64036,128165,6
2023-06-20,2호선,신림,59451,57417,116868,6
2023-06-20,2호선,사당,43952,45717,89669,6
2023-06-20,2호선,강남,88843,84404,173247,6
2023-06-20,2호선,선릉,65639,57769,123408,6
2023-06-20,2호선,잠실(송파구청),77272,77125,154397,6
2023-06-20,1호선,서울역,55602,52920,108522,6
2023-06-21,신림선,신림,1776,2571,4347,6
2023-06-21,분당선,선릉,14947,23165,38112,6
2023-06-21,공항철도 1호선,홍대입구,12868,12706,25574,6
2023-06-21,공항철도 1호선,서울역,12338,10547,22885,6
2023-06-21,경의선,홍대입구,2022,2508,4530,6
2023-06-21,경의선,서울역,5310,6607,11917,6
2023-06-21,경부선,가산디지털단지,19361,22500,41861,6
2023-06-21,경부선,서울역,8322,2691,11013,6
2023-06-21,9호선,고속터미널,14542,18756,33298,6
2023-06-21,8호선,잠실(송파구청),15845,18609,34454,6
2023-06-21,7호선,가산디지털단지,49082,49624,98706,6
2023-06-21,7호선,고속터미널,17096,14653,31749,6
2023-06-21,4호선,사당,27757,23956,51713,6
2023-06-21,4호선,서울역,14261,21874,36135,6
2023-06-21,3호선,고속터미널,44741,40931,85672,6
2023-06-21,2호선,홍대입구,65791,71168,136959,6
2023-06-21,2호선,구로디지털단지,64152,63532,127684,6
2023-06-21,2호선,신림,59663,57463,117126,6
2023-06-21,2호선,사당,41711,45548,87259,6
2023-06-21,2호선,강남,87616,84122,171738,6
2023-06-21,2호선,선릉,64847,57064,121911,6
2023-06-21,2호선,잠실(송파구청),75472,76283,151755,6
2023-06-21,1호선,서울역,56059,52384,108443,6
2023-06-22,2호선,구로디지털단지,65673,65092,130765,6
2023-06-22,2호선,신림,61384,58851,120235,6
2023-06-22,2호선,사당,43968,48115,92083,6
2023-06-22,신림선,신림,1784,2546,4330,6
2023-06-22,분당선,선릉,15234,23714,38948,6
2023-06-22,공항철도 1호선,홍대입구,14489,14312,28801,6
2023-06-22,공항철도 1호선,서울역,13505,11464,24969,6
2023-06-22,경의선,홍대입구,2192,2596,4788,6
2023-06-22,경의선,서울역,5346,7000,12346,6
2023-06-22,2호선,강남,92515,88851,181366,6
2023-06-22,2호선,선릉,66602,58731,125333,6
2023-06-22,2호선,잠실(송파구청),83183,83259,166442,6
2023-06-22,1호선,서울역,59014,55350,114364,6
2023-06-22,7호선,고속터미널,18114,15512,33626,6
2023-06-22,7호선,가산디지털단지,48967,49828,98795,6
2023-06-22,8호선,잠실(송파구청),16749,19569,36318,6
2023-06-22,9호선,고속터미널,15950,20868,36818,6
2023-06-22,경부선,서울역,8384,2928,11312,6
2023-06-22,경부선,가산디지털단지,19842,22876,42718,6
2023-06-22,4호선,사당,28719,24771,53490,6
2023-06-22,4호선,서울역,14564,23548,38112,6
2023-06-22,3호선,고속터미널,47907,45076,92983,6
2023-06-22,2호선,홍대입구,72867,79071,151938,6
2023-06-23,분당선,선릉,14777,22869,37646,6
2023-06-23,경부선,가산디지털단지,19373,22801,42174,6
2023-06-23,경부선,서울역,10998,3640,14638,6
2023-06-23,경의선,서울역,5443,7157,12600,6
2023-06-23,경의선,홍대입구,2317,2930,5247,6
2023-06-23,8호선,잠실(송파구청),17060,20368,37428,6
2023-06-23,7호선,가산디지털단지,49257,48808,98065,6
2023-06-23,7호선,고속터미널,20899,16890,37789,6
2023-06-23,4호선,사당,30740,27017,57757,6
2023-06-23,4호선,서울역,14543,25566,40109,6
2023-06-23,2호선,홍대입구,78625,90247,168872,6
2023-06-23,2호선,구로디지털단지,66195,65718,131913,6
2023-06-23,2호선,신림,63590,61454,125044,6
2023-06-23,2호선,사당,46634,52372,99006,6
2023-06-23,2호선,강남,96067,93421,189488,6
2023-06-23,2호선,선릉,65530,57331,122861,6
2023-06-23,2호선,잠실(송파구청),85963,85756,171719,6
2023-06-23,1호선,서울역,64730,61617,126347,6
2023-06-23,공항철도 1호선,서울역,15533,13977,29510,6
2023-06-23,9호선,고속터미널,18428,25949,44377,6
2023-06-23,공항철도 1호선,홍대입구,15477,15774,31251,6
2023-06-23,신림선,신림,1925,2650,4575,6
2023-06-23,3호선,고속터미널,57380,57050,114430,6
2023-06-24,경의선,서울역,1781,1977,3758,6
2023-06-24,경의선,홍대입구,2505,3177,5682,6
2023-06-24,공항철도 1호선,서울역,13913,13547,27460,6
2023-06-24,공항철도 1호선,홍대입구,17414,16860,34274,6
2023-06-24,분당선,선릉,5929,9331,15260,6
2023-06-24,신림선,신림,1501,2180,3681,6
2023-06-24,4호선,사당,26669,24339,51008,6
2023-06-24,4호선,서울역,8189,20068,28257,6
2023-06-24,3호선,고속터미널,61331,59286,120617,6
2023-06-24,2호선,홍대입구,83918,94094,178012,6
2023-06-24,2호선,구로디지털단지,39431,37710,77141,6
2023-06-24,2호선,신림,51161,48724,99885,6
2023-06-24,2호선,사당,39599,44870,84469,6
2023-06-24,2호선,강남,63910,62869,126779,6
2023-06-24,2호선,선릉,29155,25424,54579,6
2023-06-24,2호선,잠실(송파구청),79833,77361,157194,6
2023-06-24,1호선,서울역,48995,46990,95985,6
2023-06-24,7호선,고속터미널,17723,13941,31664,6
2023-06-24,7호선,가산디지털단지,16329,14397,30726,6
2023-06-24,8호선,잠실(송파구청),15859,18561,34420,6
2023-06-24,9호선,고속터미널,18482,27305,45787,6
2023-06-24,경부선,서울역,10438,3074,13512,6
2023-06-24,경부선,가산디지털단지,6973,9324,16297,6
2023-06-25,3호선,고속터미널,50672,44826,95498,6
2023-06-25,4호선,서울역,5742,15242,20984,6
2023-06-25,4호선,사당,18066,16589,34655,6
2023-06-25,1호선,서울역,36157,35447,71604,6
2023-06-25,2호선,잠실(송파구청),56395,52821,109216,6
2023-06-25,2호선,선릉,15819,13389,29208,6
2023-06-25,2호선,강남,37075,35343,72418,6
2023-06-25,2호선,사당,25512,27726,53238,6
2023-06-25,2호선,신림,37551,36670,74221,6
2023-06-25,2호선,구로디지털단지,27227,26304,53531,6
2023-06-25,2호선,홍대입구,62727,63789,126516,6
2023-06-25,7호선,고속터미널,15521,9842,25363,6
2023-06-25,7호선,가산디지털단지,11402,10463,21865,6
2023-06-25,8호선,잠실(송파구청),11608,13023,24631,6
2023-06-25,9호선,고속터미널,14876,20759,35635,6
2023-06-25,경부선,서울역,9733,2594,12327,6
2023-06-25,경부선,가산디지털단지,5205,7276,12481,6
2023-06-25,경의선,서울역,1391,1189,2580,6
2023-06-25,경의선,홍대입구,1774,2315,4089,6
2023-06-25,공항철도 1호선,서울역,13796,12122,25918,6
2023-06-25,공항철도 1호선,홍대입구,13548,12139,25687,6
2023-06-25,분당선,선릉,3100,4766,7866,6
2023-06-25,신림선,신림,1188,1828,3016,6
2023-06-26,1호선,서울역,55757,52677,108434,6
2023-06-26,2호선,잠실(송파구청),70992,71375,142367,6
2023-06-26,2호선,선릉,63311,55889,119200,6
2023-06-26,2호선,강남,85327,81515,166842,6
2023-06-26,2호선,사당,37720,41130,78850,6
2023-06-26,2호선,신림,56273,53951,110224,6
2023-06-26,2호선,구로디지털단지,61431,60741,122172,6
2023-06-26,2호선,홍대입구,61418,63529,124947,6
2023-06-26,3호선,고속터미널,43432,40173,83605,6
2023-06-26,4호선,서울역,13305,21804,35109,6
2023-06-26,4호선,사당,25439,21671,47110,6
2023-06-26,7호선,고속터미널,16946,14097,31043,6
2023-06-26,7호선,가산디지털단지,49283,49278,98561,6
2023-06-26,8호선,잠실(송파구청),15297,17432,32729,6
2023-06-26,9호선,고속터미널,13652,18125,31777,6
2023-06-26,경부선,서울역,8894,3047,11941,6
2023-06-26,경부선,가산디지털단지,18596,22039,40635,6
2023-06-26,경의선,서울역,4981,6366,11347,6
2023-06-26,경의선,홍대입구,1758,2086,3844,6
2023-06-26,공항철도 1호선,서울역,13304,11568,24872,6
2023-06-26,공항철도 1호선,홍대입구,12144,11906,24050,6
2023-06-26,분당선,선릉,14927,22496,37423,6
2023-06-26,신림선,신림,1724,2480,4204,6
2023-06-27,신림선,신림,1854,2620,4474,6
2023-06-27,분당선,선릉,15237,23503,38740,6
2023-06-27,공항철도 1호선,홍대입구,13204,12696,25900,6
2023-06-27,공항철도 1호선,서울역,11959,10925,22884,6
2023-06-27,경의선,홍대입구,1907,2356,4263,6
2023-06-27,경부선,가산디지털단지,19751,22798,42549,6
2023-06-27,경부선,서울역,7780,2552,10332,6
2023-06-27,9호선,고속터미널,14841,19120,33961,6
2023-06-27,8호선,잠실(송파구청),15816,18383,34199,6
2023-06-27,7호선,가산디지털단지,50315,50542,100857,6
2023-06-27,7호선,고속터미널,17047,15126,32173,6
2023-06-27,4호선,사당,27788,23814,51602,6
2023-06-27,4호선,서울역,14277,22023,36300,6
2023-06-27,3호선,고속터미널,45302,41799,87101,6
2023-06-27,2호선,홍대입구,65473,70181,135654,6
2023-06-27,2호선,구로디지털단지,64924,64487,129411,6
2023-06-27,2호선,신림,59673,57622,117295,6
2023-06-27,2호선,사당,41763,45702,87465,6
2023-06-27,2호선,강남,90872,87105,177977,6
2023-06-27,2호선,선릉,66531,58569,125100,6
2023-06-27,2호선,잠실(송파구청),78365,78731,157096,6
2023-06-27,1호선,서울역,56855,53144,109999,6
2023-06-27,경의선,서울역,5219,6597,11816,6
2023-06-28,2호선,잠실(송파구청),79789,79765,159554,6
2023-06-28,1호선,서울역,56151,52886,109037,6
2023-06-28,공항철도 1호선,서울역,11965,10638,22603,6
2023-06-28,공항철도 1호선,홍대입구,13142,12912,26054,6
2023-06-28,분당선,선릉,15149,23237,38386,6
2023-06-28,신림선,신림,1871,2649,4520,6
2023-06-28,7호선,고속터미널,16645,14877,31522,6
2023-06-28,7호선,가산디지털단지,49992,50517,100509,6
2023-06-28,8호선,잠실(송파구청),16530,19179,35709,6
2023-06-28,9호선,고속터미널,14776,19128,33904,6
2023-06-28,경부선,서울역,8282,2593,10875,6
2023-06-28,경부선,가산디지털단지,19572,22649,42221,6
2023-06-28,경의선,서울역,5217,6588,11805,6
2023-06-28,경의선,홍대입구,2020,2441,4461,6
2023-06-28,4호선,사당,28104,24063,52167,6
2023-06-28,4호선,서울역,14171,22111,36282,6
2023-06-28,3호선,고속터미널,45256,42200,87456,6
2023-06-28,2호선,홍대입구,66243,71213,137456,6
2023-06-28,2호선,구로디지털단지,64877,64319,129196,6
2023-06-28,2호선,신림,60699,58510,119209,6
2023-06-28,2호선,사당,41715,45502,87217,6
2023-06-28,2호선,강남,90155,86658,176813,6
2023-06-28,2호선,선릉,66184,58209,124393,6
2023-06-29,경의선,서울역,4833,5960,10793,6
2023-06-29,경의선,홍대입구,1821,2078,3899,6
2023-06-29,공항철도 1호선,서울역,12207,10636,22843,6
2023-06-29,공항철도 1호선,홍대입구,11487,11718,23205,6
2023-06-29,분당선,선릉,14606,22379,36985,6
2023-06-29,신림선,신림,1709,2445,4154,6
2023-06-29,7호선,고속터미널,16063,13919,29982,6
2023-06-29,7호선,가산디지털단지,48095,48600,96695,6
2023-06-29,8호선,잠실(송파구청),16139,18893,35032,6
2023-06-29,9호선,고속터미널,13135,17965,31100,6
2023-06-29,경부선,서울역,8358,2744,11102,6
2023-06-29,경부선,가산디지털단지,18092,21121,39213,6
2023-06-29,4호선,사당,25849,22013,47862,6
2023-06-29,4호선,서울역,13647,21781,35428,6
2023-06-29,3호선,고속터미널,43105,40547,83652,6
2023-06-29,2호선,홍대입구,58385,62263,120648,6
2023-06-29,2호선,구로디지털단지,60871,60510,121381,6
2023-06-29,2호선,신림,56351,54044,110395,6
2023-06-29,2호선,사당,38363,42055,80418,6
2023-06-29,2호선,강남,85194,81423,166617,6
2023-06-29,2호선,선릉,62040,54727,116767,6
2023-06-29,2호선,잠실(송파구청),74839,74738,149577,6
2023-06-29,1호선,서울역,54791,51496,106287,6
2023-06-30,7호선,고속터미널,19524,16481,36005,6
2023-06-30,7호선,가산디지털단지,49626,49864,99490,6
2023-06-30,4호선,사당,29770,25767,55537,6
2023-06-30,8호선,잠실(송파구청),17077,20511,37588,6
2023-06-30,9호선,고속터미널,16942,23662,40604,6
2023-06-30,경부선,서울역,10404,3383,13787,6
2023-06-30,경부선,가산디지털단지,19676,22603,42279,6
2023-06-30,4호선,서울역,14019,24224,38243,6
2023-06-30,3호선,고속터미널,54272,54779,109051,6
2023-06-30,2호선,홍대입구,74851,86246,161097,6
2023-06-30,2호선,구로디지털단지,65487,64654,130141,6
2023-06-30,2호선,신림,63508,60534,124042,6
2023-06-30,2호선,사당,44155,49674,93829,6
2023-06-30,2호선,강남,96259,93917,190176,6
2023-06-30,2호선,선릉,64155,56889,121044,6
2023-06-30,2호선,잠실(송파구청),85828,86347,172175,6
2023-06-30,1호선,서울역,62153,59252,121405,6
2023-06-30,신림선,신림,1905,2769,4674,6
2023-06-30,분당선,선릉,14730,22540,37270,6
2023-06-30,공항철도 1호선,홍대입구,14949,15173,30122,6
2023-06-30,공항철도 1호선,서울역,14692,13484,28176,6
2023-06-30,경의선,홍대입구,2173,2784,4957,6
2023-06-30,경의선,서울역,5334,6798,12132,6
2023-07-01,2호선,사당,35168,40116,75284,7
2023-07-01,2호선,강남,62628,61540,124168,7
2023-07-01,2호선,선릉,27765,23688,51453,7
2023-07-01,2호선,잠실(송파구청),78194,75090,153284,7
2023-07-01,1호선,서울역,47048,42810,89858,7
2023-07-01,신림선,신림,1488,2279,3767,7
2023-07-01,분당선,선릉,5412,8747,14159,7
2023-07-01,공항철도 1호선,홍대입구,16824,17136,33960,7
2023-07-01,공항철도 1호선,서울역,12964,12635,25599,7
2023-07-01,경의선,홍대입구,2382,3049,5431,7
2023-07-01,경의선,서울역,1525,1716,3241,7
2023-07-01,경부선,가산디지털단지,6266,8413,14679,7
2023-07-01,경부선,서울역,9775,2877,12652,7
2023-07-01,9호선,고속터미널,16576,24634,41210,7
2023-07-01,8호선,잠실(송파구청),16013,19003,35016,7
2023-07-01,7호선,가산디지털단지,15146,13381,28527,7
2023-07-01,7호선,고속터미널,16610,12814,29424,7
2023-07-01,4호선,사당,24997,22266,47263,7
2023-07-01,4호선,서울역,8450,17943,26393,7
2023-07-01,3호선,고속터미널,58192,56952,115144,7
2023-07-01,2호선,홍대입구,78328,90508,168836,7
2023-07-01,2호선,구로디지털단지,37146,35905,73051,7
2023-07-01,2호선,신림,49800,47764,97564,7
2023-07-02,2호선,홍대입구,59169,58932,118101,7
2023-07-02,2호선,구로디지털단지,26534,25677,52211,7
2023-07-02,2호선,신림,37030,36516,73546,7
2023-07-02,2호선,사당,24003,26623,50626,7
2023-07-02,2호선,강남,37391,35225,72616,7
2023-07-02,2호선,선릉,15005,12800,27805,7
2023-07-02,2호선,잠실(송파구청),57126,53691,110817,7
2023-07-02,1호선,서울역,34963,33333,68296,7
2023-07-02,3호선,고속터미널,48607,43121,91728,7
2023-07-02,4호선,서울역,5495,14019,19514,7
2023-07-02,4호선,사당,17344,15957,33301,7
2023-07-02,7호선,고속터미널,14486,9501,23987,7
2023-07-02,7호선,가산디지털단지,10540,9782,20322,7
2023-07-02,8호선,잠실(송파구청),12043,13425,25468,7
2023-07-02,9호선,고속터미널,13853,19676,33529,7
2023-07-02,경부선,서울역,9573,2449,12022,7
2023-07-02,경부선,가산디지털단지,4661,6381,11042,7
2023-07-02,경의선,서울역,1221,1169,2390,7
2023-07-02,경의선,홍대입구,1974,2350,4324,7
2023-07-02,공항철도 1호선,서울역,12603,11266,23869,7
2023-07-02,공항철도 1호선,홍대입구,13406,11667,25073,7
2023-07-02,분당선,선릉,2930,4388,7318,7
2023-07-02,신림선,신림,1126,1698,2824,7
2023-07-03,3호선,고속터미널,44639,41178,85817,7
2023-07-03,경의선,서울역,5001,6614,11615,7
2023-07-03,경의선,홍대입구,1751,2197,3948,7
2023-07-03,7호선,가산디지털단지,50407,50493,100900,7
2023-07-03,7호선,고속터미널,17198,14355,31553,7
2023-07-03,분당선,선릉,14923,22791,37714,7
2023-07-03,1호선,서울역,53435,51030,104465,7
2023-07-03,공항철도 1호선,서울역,12221,11023,23244,7
2023-07-03,공항철도 1호선,홍대입구,12738,11949,24687,7
2023-07-03,4호선,서울역,13466,20804,34270,7
2023-07-03,4호선,사당,25440,21767,47207,7
2023-07-03,2호선,홍대입구,62308,65601,127909,7
2023-07-03,2호선,구로디지털단지,62857,62684,125541,7
2023-07-03,2호선,신림,57866,55944,113810,7
2023-07-03,2호선,사당,38245,41857,80102,7
2023-07-03,경부선,서울역,8099,2581,10680,7
2023-07-03,9호선,고속터미널,14407,19010,33417,7
2023-07-03,8호선,잠실(송파구청),16319,18563,34882,7
2023-07-03,2호선,강남,90016,86666,176682,7
2023-07-03,신림선,신림,1898,2673,4571,7
2023-07-03,2호선,선릉,65075,57212,122287,7
2023-07-03,2호선,잠실(송파구청),76255,77002,153257,7
2023-07-03,경부선,가산디지털단지,18359,21718,40077,7
2023-07-04,3호선,고속터미널,43508,40326,83834,7
2023-07-04,4호선,서울역,13693,20377,34070,7
2023-07-04,4호선,사당,25400,21950,47350,7
2023-07-04,7호선,고속터미널,16263,14422,30685,7
2023-07-04,7호선,가산디지털단지,51184,50018,101202,7
2023-07-04,8호선,잠실(송파구청),16800,18728,35528,7
2023-07-04,9호선,고속터미널,13798,17916,31714,7
2023-07-04,경부선,서울역,7077,2343,9420,7
2023-07-04,경부선,가산디지털단지,17987,21564,39551,7
2023-07-04,경의선,서울역,4946,6150,11096,7
2023-07-04,경의선,홍대입구,1690,2134,3824,7
2023-07-04,공항철도 1호선,서울역,10885,9968,20853,7
2023-07-04,공항철도 1호선,홍대입구,11558,11439,22997,7
2023-07-04,분당선,선릉,15526,23024,38550,7
2023-07-04,신림선,신림,1818,2627,4445,7
2023-07-04,1호선,서울역,52983,50086,103069,7
2023-07-04,2호선,잠실(송파구청),77345,76391,153736,7
2023-07-04,2호선,선릉,65914,57138,123052,7
2023-07-04,2호선,강남,91119,86419,177538,7
2023-07-04,2호선,사당,39670,42308,81978,7
2023-07-04,2호선,신림,56968,55180,112148,7
2023-07-04,2호선,구로디지털단지,62669,61798,124467,7
2023-07-04,2호선,홍대입구,59981,62291,122272,7
2023-07-05,1호선,서울역,53987,50771,104758,7
2023-07-05,2호선,잠실(송파구청),80479,80471,160950,7
2023-07-05,2호선,선릉,66005,58037,124042,7
2023-07-05,2호선,강남,92179,88445,180624,7
2023-07-05,2호선,사당,42059,45254,87313,7
2023-07-05,2호선,신림,60489,58245,118734,7
2023-07-05,2호선,구로디지털단지,64649,63612,128261,7
2023-07-05,2호선,홍대입구,66607,71366,137973,7
2023-07-05,3호선,고속터미널,44164,41129,85293,7
2023-07-05,4호선,서울역,13791,20859,34650,7
2023-07-05,4호선,사당,26536,23431,49967,7
2023-07-05,7호선,고속터미널,16544,14691,31235,7
2023-07-05,7호선,가산디지털단지,50304,50760,101064,7
2023-07-05,8호선,잠실(송파구청),16636,19616,36252,7
2023-07-05,9호선,고속터미널,14487,18956,33443,7
2023-07-05,경부선,서울역,7346,2473,9819,7
2023-07-05,경부선,가산디지털단지,18770,21976,40746,7
2023-07-05,경의선,서울역,5057,6354,11411,7
2023-07-05,경의선,홍대입구,2041,2467,4508,7
2023-07-05,공항철도 1호선,서울역,11487,10191,21678,7
2023-07-05,공항철도 1호선,홍대입구,13294,12885,26179,7
2023-07-05,분당선,선릉,15356,23239,38595,7
2023-07-05,신림선,신림,1906,2719,4625,7
2023-07-06,8호선,잠실(송파구청),16803,19918,36721,7
2023-07-06,7호선,가산디지털단지,50199,50841,101040,7
2023-07-06,7호선,고속터미널,17093,15091,32184,7
2023-07-06,9호선,고속터미널,15184,20053,35237,7
2023-07-06,경부선,서울역,8129,2743,10872,7
2023-07-06,경부선,가산디지털단지,18801,21942,40743,7
2023-07-06,경의선,서울역,5382,6396,11778,7
2023-07-06,경의선,홍대입구,2081,2496,4577,7
2023-07-06,공항철도 1호선,서울역,11936,10770,22706,7
2023-07-06,공항철도 1호선,홍대입구,13319,13418,26737,7
2023-07-06,분당선,선릉,15395,23455,38850,7
2023-07-06,신림선,신림,1905,2644,4549,7
2023-07-06,4호선,사당,27695,23742,51437,7
2023-07-06,4호선,서울역,14339,22197,36536,7
2023-07-06,3호선,고속터미널,46480,43550,90030,7
2023-07-06,2호선,홍대입구,68226,73657,141883,7
2023-07-06,2호선,구로디지털단지,64469,63908,128377,7
2023-07-06,2호선,신림,60583,58093,118676,7
2023-07-06,2호선,사당,42003,46354,88357,7
2023-07-06,2호선,강남,94352,90328,184680,7
2023-07-06,2호선,선릉,66909,58990,125899,7
2023-07-06,2호선,잠실(송파구청),82412,82701,165113,7
2023-07-06,1호선,서울역,58137,54175,112312,7
2023-07-07,신림선,신림,1810,2691,4501,7
2023-07-07,분당선,선릉,14924,22987,37911,7
2023-07-07,공항철도 1호선,홍대입구,15176,15303,30479,7
2023-07-07,공항철도 1호선,서울역,14492,13154,27646,7
2023-07-07,경의선,홍대입구,2202,2827,5029,7
2023-07-07,경의선,서울역,5188,6731,11919,7
2023-07-07,경부선,가산디지털단지,18997,21874,40871,7
2023-07-07,경부선,서울역,10337,3324,13661,7
2023-07-07,9호선,고속터미널,17065,24654,41719,7
2023-07-07,8호선,잠실(송파구청),17425,20571,37996,7
2023-07-07,7호선,가산디지털단지,50029,49687,99716,7
2023-07-07,7호선,고속터미널,19970,17004,36974,7
2023-07-07,4호선,사당,29809,26133,55942,7
2023-07-07,4호선,서울역,14446,24578,39024,7
2023-07-07,3호선,고속터미널,54903,55541,110444,7
2023-07-07,2호선,홍대입구,73603,83981,157584,7
2023-07-07,2호선,구로디지털단지,65211,64315,129526,7
2023-07-07,2호선,신림,63311,60421,123732,7
2023-07-07,2호선,사당,45039,50224,95263,7
2023-07-07,2호선,강남,97647,95762,193409,7
2023-07-07,2호선,선릉,65698,57652,123350,7
2023-07-07,2호선,잠실(송파구청),85374,85352,170726,7
2023-07-07,1호선,서울역,62062,59268,121330,7
2023-07-08,2호선,잠실(송파구청),78199,76109,154308,7
2023-07-08,2호선,선릉,27709,23986,51695,7
2023-07-08,2호선,강남,64334,63711,128045,7
2023-07-08,2호선,사당,36580,41603,78183,7
2023-07-08,2호선,신림,49340,46958,96298,7
2023-07-08,2호선,구로디지털단지,37740,35836,73576,7
2023-07-08,2호선,홍대입구,81321,92225,173546,7
2023-07-08,3호선,고속터미널,57593,56581,114174,7
2023-07-08,4호선,서울역,8010,18329,26339,7
2023-07-08,4호선,사당,25455,23154,48609,7
2023-07-08,7호선,고속터미널,16844,12975,29819,7
2023-07-08,7호선,가산디지털단지,15282,13462,28744,7
2023-07-08,1호선,서울역,45122,42305,87427,7
2023-07-08,8호선,잠실(송파구청),15452,18172,33624,7
2023-07-08,9호선,고속터미널,17570,25850,43420,7
2023-07-08,경부선,서울역,9505,2805,12310,7
2023-07-08,경부선,가산디지털단지,6452,8469,14921,7
2023-07-08,경의선,서울역,1600,1747,3347,7
2023-07-08,경의선,홍대입구,2529,3187,5716,7
2023-07-08,공항철도 1호선,서울역,13060,12492,25552,7
2023-07-08,공항철도 1호선,홍대입구,17824,17779,35603,7
2023-07-08,분당선,선릉,5692,8529,14221,7
2023-07-08,신림선,신림,1354,2041,3395,7
2023-07-09,1호선,서울역,33960,32121,66081,7
2023-07-09,2호선,잠실(송파구청),52935,50236,103171,7
2023-07-09,2호선,선릉,14814,12550,27364,7
2023-07-09,2호선,강남,34786,33417,68203,7
2023-07-09,2호선,사당,23047,25665,48712,7
2023-07-09,2호선,신림,33611,33344,66955,7
2023-07-09,2호선,구로디지털단지,24716,24016,48732,7
2023-07-09,2호선,홍대입구,55154,56063,111217,7
2023-07-09,3호선,고속터미널,46630,41182,87812,7
2023-07-09,4호선,서울역,5303,13675,18978,7
2023-07-09,4호선,사당,16731,15591,32322,7
2023-07-09,7호선,고속터미널,14162,8788,22950,7
2023-07-09,7호선,가산디지털단지,9478,8832,18310,7
2023-07-09,8호선,잠실(송파구청),10992,12562,23554,7
2023-07-09,9호선,고속터미널,12865,18430,31295,7
2023-07-09,경부선,서울역,9518,2432,11950,7
2023-07-09,경부선,가산디지털단지,4322,6018,10340,7
2023-07-09,경의선,서울역,1123,1057,2180,7
2023-07-09,경의선,홍대입구,1889,2363,4252,7
2023-07-09,공항철도 1호선,서울역,12168,10966,23134,7
2023-07-09,공항철도 1호선,홍대입구,13136,12154,25290,7
2023-07-09,분당선,선릉,3046,4585,7631,7
2023-07-09,신림선,신림,1047,1580,2627,7
2023-07-10,신림선,신림,1798,2555,4353,7
2023-07-10,분당선,선릉,14914,22910,37824,7
2023-07-10,공항철도 1호선,홍대입구,12781,12537,25318,7
2023-07-10,1호선,서울역,53588,51490,105078,7
2023-07-10,공항철도 1호선,서울역,12094,10861,22955,7
2023-07-10,경의선,홍대입구,1933,2187,4120,7
2023-07-10,경의선,서울역,5096,5636,10732,7
2023-07-10,경부선,가산디지털단지,18775,21797,40572,7
2023-07-10,경부선,서울역,8061,2720,10781,7
2023-07-10,9호선,고속터미널,14268,18603,32871,7
2023-07-10,8호선,잠실(송파구청),15386,17853,33239,7
2023-07-10,7호선,가산디지털단지,50440,50531,100971,7
2023-07-10,7호선,고속터미널,17440,14610,32050,7
2023-07-10,4호선,사당,25788,21912,47700,7
2023-07-10,4호선,서울역,13196,20866,34062,7
2023-07-10,3호선,고속터미널,44634,41218,85852,7
2023-07-10,2호선,홍대입구,62390,66002,128392,7
2023-07-10,2호선,구로디지털단지,62304,61651,123955,7
2023-07-10,2호선,신림,57216,55258,112474,7
2023-07-10,2호선,사당,38441,42295,80736,7
2023-07-10,2호선,강남,89097,85615,174712,7
2023-07-10,2호선,선릉,64601,56845,121446,7
2023-07-10,2호선,잠실(송파구청),72832,73285,146117,7
2023-07-11,신림선,신림,1840,2584,4424,7
2023-07-11,분당선,선릉,15169,22727,37896,7
2023-07-11,공항철도 1호선,홍대입구,11892,12065,23957,7
2023-07-11,공항철도 1호선,서울역,11442,10144,21586,7
2023-07-11,경의선,홍대입구,1679,1985,3664,7
2023-07-11,경의선,서울역,4733,6149,10882,7
2023-07-11,경부선,가산디지털단지,18312,21330,39642,7
2023-07-11,경부선,서울역,7251,2518,9769,7
2023-07-11,9호선,고속터미널,13173,17324,30497,7
2023-07-11,8호선,잠실(송파구청),16016,18038,34054,7
2023-07-11,7호선,가산디지털단지,50459,50137,100596,7
2023-07-11,7호선,고속터미널,16368,14121,30489,7
2023-07-11,4호선,사당,26061,22639,48700,7
2023-07-11,4호선,서울역,13798,20664,34462,7
2023-07-11,3호선,고속터미널,42062,38979,81041,7
2023-07-11,2호선,홍대입구,57815,60649,118464,7
2023-07-11,2호선,구로디지털단지,61015,60400,121415,7
2023-07-11,2호선,신림,55710,53534,109244,7
2023-07-11,2호선,사당,38987,41716,80703,7
2023-07-11,2호선,강남,86774,82517,169291,7
2023-07-11,2호선,선릉,63994,56268,120262,7
2023-07-11,2호선,잠실(송파구청),73925,73924,147849,7
2023-07-11,1호선,서울역,53394,50425,103819,7
2023-07-12,1호선,서울역,54690,51980,106670,7
2023-07-12,2호선,잠실(송파구청),79895,80120,160015,7
2023-07-12,2호선,선릉,67009,58798,125807,7
2023-07-12,2호선,강남,91863,88587,180450,7
2023-07-12,2호선,사당,42110,45953,88063,7
2023-07-12,2호선,신림,60301,57915,118216,7
2023-07-12,2호선,구로디지털단지,64419,64133,128552,7
2023-07-12,2호선,홍대입구,66611,70625,137236,7
2023-07-12,3호선,고속터미널,44799,41423,86222,7
2023-07-12,4호선,서울역,14191,21509,35700,7
2023-07-12,4호선,사당,27272,23740,51012,7
2023-07-12,7호선,고속터미널,17112,15058,32170,7
2023-07-12,7호선,가산디지털단지,49910,50722,100632,7
2023-07-12,8호선,잠실(송파구청),16386,19129,35515,7
2023-07-12,9호선,고속터미널,14496,19030,33526,7
2023-07-12,경부선,서울역,7726,2665,10391,7
2023-07-12,경부선,가산디지털단지,19269,21950,41219,7
2023-07-12,경의선,서울역,5013,6362,11375,7
2023-07-12,경의선,홍대입구,1971,2401,4372,7
2023-07-12,공항철도 1호선,서울역,11914,10444,22358,7
2023-07-12,공항철도 1호선,홍대입구,13328,13511,26839,7
2023-07-12,분당선,선릉,15129,23260,38389,7
2023-07-12,신림선,신림,1776,2629,4405,7
2023-07-13,1호선,서울역,57654,53500,111154,7
2023-07-13,2호선,잠실(송파구청),75104,75090,150194,7
2023-07-13,2호선,선릉,63367,56041,119408,7
2023-07-13,2호선,강남,86437,81830,168267,7
2023-07-13,2호선,사당,38116,41319,79435,7
2023-07-13,2호선,신림,56109,54063,110172,7
2023-07-13,2호선,구로디지털단지,60993,60473,121466,7
2023-07-13,2호선,홍대입구,59420,62323,121743,7
2023-07-13,3호선,고속터미널,43873,40402,84275,7
2023-07-13,4호선,서울역,13957,21465,35422,7
2023-07-13,4호선,사당,25466,21843,47309,7
2023-07-13,7호선,고속터미널,16684,14486,31170,7
2023-07-13,7호선,가산디지털단지,49668,49382,99050,7
2023-07-13,8호선,잠실(송파구청),16605,18495,35100,7
2023-07-13,9호선,고속터미널,13024,17912,30936,7
2023-07-13,경부선,서울역,8480,2795,11275,7
2023-07-13,경부선,가산디지털단지,17964,21096,39060,7
2023-07-13,경의선,서울역,4811,6005,10816,7
2023-07-13,경의선,홍대입구,1581,2148,3729,7
2023-07-13,공항철도 1호선,서울역,12057,10697,22754,7
2023-07-13,공항철도 1호선,홍대입구,11664,12169,23833,7
2023-07-13,분당선,선릉,15240,22538,37778,7
2023-07-13,신림선,신림,1802,2581,4383,7
2023-07-14,분당선,선릉,14835,22248,37083,7
2023-07-14,공항철도 1호선,홍대입구,13064,13677,26741,7
2023-07-14,공항철도 1호선,서울역,15192,13823,29015,7
2023-07-14,경의선,홍대입구,1908,2392,4300,7
2023-07-14,경의선,서울역,5092,6079,11171,7
2023-07-14,경부선,가산디지털단지,18302,20856,39158,7
2023-07-14,경부선,서울역,9892,3723,13615,7
2023-07-14,9호선,고속터미널,14831,21371,36202,7
2023-07-14,8호선,잠실(송파구청),17147,20073,37220,7
2023-07-14,7호선,가산디지털단지,48813,48083,96896,7
2023-07-14,7호선,고속터미널,18674,15573,34247,7
2023-07-14,4호선,사당,26856,23976,50832,7
2023-07-14,4호선,서울역,13940,23851,37791,7
2023-07-14,3호선,고속터미널,49523,50840,100363,7
2023-07-14,2호선,홍대입구,63359,72800,136159,7
2023-07-14,2호선,구로디지털단지,61925,60955,122880,7
2023-07-14,2호선,신림,58698,56335,115033,7
2023-07-14,2호선,사당,41034,44185,85219,7
2023-07-14,2호선,강남,88628,86448,175076,7
2023-07-14,2호선,선릉,62222,54750,116972,7
2023-07-14,2호선,잠실(송파구청),78646,78761,157407,7
2023-07-14,1호선,서울역,62023,58153,120176,7
2023-07-14,신림선,신림,1764,2620,4384,7
2023-07-15,2호선,잠실(송파구청),67953,66194,134147,7
2023-07-15,2호선,선릉,26492,23110,49602,7
2023-07-15,2호선,강남,58864,58253,117117,7
2023-07-15,2호선,사당,32156,35932,68088,7
2023-07-15,2호선,신림,45656,43888,89544,7
2023-07-15,2호선,구로디지털단지,35290,34478,69768,7
2023-07-15,2호선,홍대입구,74682,85394,160076,7
2023-07-15,3호선,고속터미널,53874,52318,106192,7
2023-07-15,4호선,서울역,7608,16441,24049,7
2023-07-15,4호선,사당,21888,19955,41843,7
2023-07-15,7호선,고속터미널,15639,12213,27852,7
2023-07-15,7호선,가산디지털단지,13892,12723,26615,7
2023-07-15,8호선,잠실(송파구청),14839,17601,32440,7
2023-07-15,9호선,고속터미널,15253,22397,37650,7
2023-07-15,경부선,서울역,7857,2719,10576,7
2023-07-15,경부선,가산디지털단지,6336,7896,14232,7
2023-07-15,경의선,서울역,1579,1606,3185,7
2023-07-15,경의선,홍대입구,2327,2919,5246,7
2023-07-15,1호선,서울역,41204,40027,81231,7
2023-07-15,공항철도 1호선,서울역,12059,11605,23664,7
2023-07-15,공항철도 1호선,홍대입구,16372,16779,33151,7
2023-07-15,분당선,선릉,5632,8700,14332,7
2023-07-15,신림선,신림,1324,1892,3216,7
2023-07-16,1호선,서울역,33701,31889,65590,7
2023-07-16,2호선,잠실(송파구청),52730,50326,103056,7
2023-07-16,2호선,선릉,15269,12942,28211,7
2023-07-16,2호선,강남,36456,34498,70954,7
2023-07-16,2호선,사당,22650,24878,47528,7
2023-07-16,2호선,신림,35135,34654,69789,7
2023-07-16,2호선,구로디지털단지,26114,25114,51228,7
2023-07-16,2호선,홍대입구,62922,63766,126688,7
2023-07-16,3호선,고속터미널,48135,42594,90729,7
2023-07-16,4호선,서울역,5469,13344,18813,7
2023-07-16,4호선,사당,15944,15332,31276,7
2023-07-16,7호선,고속터미널,14825,9171,23996,7
2023-07-16,7호선,가산디지털단지,9947,9444,19391,7
2023-07-16,8호선,잠실(송파구청),11570,13158,24728,7
2023-07-16,9호선,고속터미널,13986,19375,33361,7
2023-07-16,경부선,서울역,8647,2054,10701,7
2023-07-16,경부선,가산디지털단지,4672,6096,10768,7
2023-07-16,경의선,서울역,1064,999,2063,7
2023-07-16,경의선,홍대입구,2020,2393,4413,7
2023-07-16,공항철도 1호선,서울역,12108,10730,22838,7
2023-07-16,공항철도 1호선,홍대입구,14035,13302,27337,7
2023-07-16,분당선,선릉,3021,4604,7625,7
2023-07-16,신림선,신림,1028,1543,2571,7
2023-07-17,공항철도 1호선,홍대입구,13287,12762,26049,7
2023-07-17,공항철도 1호선,서울역,12733,10868,23601,7
2023-07-17,경의선,홍대입구,1992,2440,4432,7
2023-07-17,경의선,서울역,4918,6319,11237,7
2023-07-17,경부선,가산디지털단지,19156,21614,40770,7
2023-07-17,경부선,서울역,8230,2460,10690,7
2023-07-17,9호선,고속터미널,13980,18049,32029,7
2023-07-17,8호선,잠실(송파구청),15724,18036,33760,7
2023-07-17,7호선,가산디지털단지,50374,50985,101359,7
2023-07-17,7호선,고속터미널,17957,14370,32327,7
2023-07-17,4호선,사당,25507,22049,47556,7
2023-07-17,4호선,서울역,13264,20595,33859,7
2023-07-17,3호선,고속터미널,40058,36626,76684,7
2023-07-17,2호선,홍대입구,64731,67922,132653,7
2023-07-17,2호선,구로디지털단지,62555,62061,124616,7
2023-07-17,2호선,신림,57395,55558,112953,7
2023-07-17,2호선,사당,38319,42009,80328,7
2023-07-17,2호선,강남,89347,85400,174747,7
2023-07-17,2호선,선릉,64812,57054,121866,7
2023-07-17,2호선,잠실(송파구청),74487,74713,149200,7
2023-07-17,1호선,서울역,53370,51291,104661,7
2023-07-17,신림선,신림,1772,2611,4383,7
2023-07-17,분당선,선릉,15038,22825,37863,7
2023-07-18,신림선,신림,1802,2540,4342,7
2023-07-18,분당선,선릉,15287,23101,38388,7
2023-07-18,공항철도 1호선,홍대입구,13006,13053,26059,7
2023-07-18,공항철도 1호선,서울역,11401,10292,21693,7
2023-07-18,경의선,홍대입구,2030,2345,4375,7
2023-07-18,경의선,서울역,5069,6398,11467,7
2023-07-18,경부선,가산디지털단지,19113,21788,40901,7
2023-07-18,경부선,서울역,5921,2076,7997,7
2023-07-18,9호선,고속터미널,14562,19347,33909,7
2023-07-18,8호선,잠실(송파구청),15661,18666,34327,7
2023-07-18,7호선,가산디지털단지,50220,50995,101215,7
2023-07-18,7호선,고속터미널,17682,14595,32277,7
2023-07-18,4호선,사당,26344,22627,48971,7
2023-07-18,4호선,서울역,13921,20130,34051,7
2023-07-18,3호선,고속터미널,45486,42110,87596,7
2023-07-18,2호선,홍대입구,64156,68222,132378,7
2023-07-18,2호선,구로디지털단지,63196,62814,126010,7
2023-07-18,2호선,신림,58345,56115,114460,7
2023-07-18,2호선,사당,40276,43668,83944,7
2023-07-18,2호선,강남,91105,87592,178697,7
2023-07-18,2호선,선릉,65445,58211,123656,7
2023-07-18,2호선,잠실(송파구청),76691,77626,154317,7
2023-07-18,1호선,서울역,52292,49466,101758,7
2023-07-19,경의선,서울역,4998,6188,11186,7
2023-07-19,경의선,홍대입구,2169,2590,4759,7
2023-07-19,2호선,홍대입구,69615,74312,143927,7
2023-07-19,신림선,신림,1878,2754,4632,7
2023-07-19,3호선,고속터미널,48945,46112,95057,7
2023-07-19,4호선,서울역,14128,20686,34814,7
2023-07-19,4호선,사당,28132,23985,52117,7
2023-07-19,2호선,잠실(송파구청),82024,81611,163635,7
2023-07-19,2호선,선릉,67921,59713,127634,7
2023-07-19,2호선,강남,94049,89845,183894,7
2023-07-19,2호선,사당,42216,46307,88523,7
2023-07-19,1호선,서울역,53358,50407,103765,7
2023-07-19,2호선,신림,60395,57903,118298,7
2023-07-19,2호선,구로디지털단지,64286,63597,127883,7
2023-07-19,공항철도 1호선,서울역,11253,10004,21257,7
2023-07-19,공항철도 1호선,홍대입구,14054,14171,28225,7
2023-07-19,분당선,선릉,15276,23808,39084,7
2023-07-19,7호선,고속터미널,18884,15265,34149,7
2023-07-19,7호선,가산디지털단지,50394,50970,101364,7
2023-07-19,8호선,잠실(송파구청),16987,19737,36724,7
2023-07-19,9호선,고속터미널,15748,20893,36641,7
2023-07-19,경부선,서울역,6340,2045,8385,7
2023-07-19,경부선,가산디지털단지,19260,22014,41274,7
2023-07-20,2호선,잠실(송파구청),85757,85467,171224,7
2023-07-20,2호선,선릉,67795,60147,127942,7
2023-07-20,2호선,강남,97093,92722,189815,7
2023-07-20,2호선,사당,42376,47018,89394,7
2023-07-20,2호선,신림,60758,58627,119385,7
2023-07-20,2호선,구로디지털단지,64672,64352,129024,7
2023-07-20,2호선,홍대입구,73468,79237,152705,7
2023-07-20,3호선,고속터미널,51185,48333,99518,7
2023-07-20,4호선,서울역,14405,21888,36293,7
2023-07-20,4호선,사당,28673,24251,52924,7
2023-07-20,7호선,고속터미널,19616,15638,35254,7
2023-07-20,7호선,가산디지털단지,50176,50964,101140,7
2023-07-20,8호선,잠실(송파구청),17210,20272,37482,7
2023-07-20,9호선,고속터미널,16363,22643,39006,7
2023-07-20,경부선,서울역,7881,2445,10326,7
2023-07-20,경부선,가산디지털단지,19109,21732,40841,7
2023-07-20,경의선,서울역,5014,6294,11308,7
2023-07-20,경의선,홍대입구,2134,2691,4825,7
2023-07-20,공항철도 1호선,서울역,12714,10594,23308,7
2023-07-20,공항철도 1호선,홍대입구,14714,15406,30120,7
2023-07-20,분당선,선릉,15421,23676,39097,7
2023-07-20,1호선,서울역,55752,52847,108599,7
2023-07-20,신림선,신림,1893,2655,4548,7
2023-07-21,신림선,신림,1919,2658,4577,7
2023-07-21,1호선,서울역,61501,59417,120918,7
2023-07-21,2호선,홍대입구,77155,86178,163333,7
2023-07-21,2호선,구로디지털단지,64829,64283,129112,7
2023-07-21,2호선,신림,61203,57040,118243,7
2023-07-21,2호선,사당,43167,48679,91846,7
2023-07-21,2호선,강남,98353,96888,195241,7
2023-07-21,2호선,선릉,66046,57923,123969,7
2023-07-21,2호선,잠실(송파구청),87311,87170,174481,7
2023-07-21,3호선,고속터미널,55700,56686,112386,7
2023-07-21,4호선,서울역,14051,24208,38259,7
2023-07-21,4호선,사당,29841,25695,55536,7
2023-07-21,7호선,고속터미널,20788,16573,37361,7
2023-07-21,7호선,가산디지털단지,49699,49471,99170,7
2023-07-21,8호선,잠실(송파구청),17727,20950,38677,7
2023-07-21,9호선,고속터미널,17774,25098,42872,7
2023-07-21,경부선,서울역,9178,3439,12617,7
2023-07-21,경부선,가산디지털단지,19386,22467,41853,7
2023-07-21,경의선,서울역,5013,6463,11476,7
2023-07-21,경의선,홍대입구,2221,2849,5070,7
2023-07-21,공항철도 1호선,서울역,14520,13180,27700,7
2023-07-21,공항철도 1호선,홍대입구,15591,16321,31912,7
2023-07-21,분당선,선릉,14859,22879,37738,7
2023-07-22,3호선,고속터미널,55937,54896,110833,7
2023-07-22,1호선,서울역,41829,40774,82603,7
2023-07-22,2호선,잠실(송파구청),74856,72317,147173,7
2023-07-22,신림선,신림,1304,1897,3201,7
2023-07-22,2호선,선릉,26822,23293,50115,7
2023-07-22,4호선,서울역,7281,17178,24459,7
2023-07-22,4호선,사당,23173,20619,43792,7
2023-07-22,7호선,고속터미널,16633,12169,28802,7
2023-07-22,7호선,가산디지털단지,14459,13131,27590,7
2023-07-22,8호선,잠실(송파구청),15963,18011,33974,7
2023-07-22,9호선,고속터미널,15666,23585,39251,7
2023-07-22,경부선,서울역,8195,2678,10873,7
2023-07-22,경부선,가산디지털단지,6573,8772,15345,7
2023-07-22,경의선,서울역,1410,1581,2991,7
2023-07-22,경의선,홍대입구,2240,2960,5200,7
2023-07-22,공항철도 1호선,서울역,11944,11949,23893,7
2023-07-22,공항철도 1호선,홍대입구,17336,17639,34975,7
2023-07-22,분당선,선릉,5614,8498,14112,7
2023-07-22,2호선,강남,63204,61768,124972,7
2023-07-22,2호선,사당,33010,37114,70124,7
2023-07-22,2호선,신림,45079,41608,86687,7
2023-07-22,2호선,구로디지털단지,36290,35423,71713,7
2023-07-22,2호선,홍대입구,80172,88672,168844,7
2023-07-23,분당선,선릉,2778,4257,7035,7
2023-07-23,공항철도 1호선,홍대입구,13583,12610,26193,7
2023-07-23,공항철도 1호선,서울역,12557,11829,24386,7
2023-07-23,경의선,홍대입구,1832,2150,3982,7
2023-07-23,경의선,서울역,1026,951,1977,7
2023-07-23,경부선,가산디지털단지,4029,5239,9268,7
2023-07-23,경부선,서울역,8310,2341,10651,7
2023-07-23,9호선,고속터미널,11458,17375,28833,7
2023-07-23,8호선,잠실(송파구청),10492,12319,22811,7
2023-07-23,7호선,가산디지털단지,8506,8104,16610,7
2023-07-23,7호선,고속터미널,13311,8211,21522,7
2023-07-23,4호선,사당,13973,13426,27399,7
2023-07-23,4호선,서울역,5173,12786,17959,7
2023-07-23,3호선,고속터미널,43360,39482,82842,7
2023-07-23,2호선,홍대입구,58197,58829,117026,7
2023-07-23,2호선,구로디지털단지,23227,22504,45731,7
2023-07-23,2호선,신림,30794,30094,60888,7
2023-07-23,2호선,사당,19884,22096,41980,7
2023-07-23,2호선,강남,34046,31709,65755,7
2023-07-23,2호선,선릉,13328,11424,24752,7
2023-07-23,2호선,잠실(송파구청),50285,47234,97519,7
2023-07-23,1호선,서울역,32362,30645,63007,7
2023-07-23,신림선,신림,957,1288,2245,7
2023-07-24,신림선,신림,1805,2513,4318,7
2023-07-24,1호선,서울역,53808,52154,105962,7
2023-07-24,분당선,선릉,14769,22380,37149,7
2023-07-24,공항철도 1호선,홍대입구,13941,14023,27964,7
2023-07-24,공항철도 1호선,서울역,12530,11440,23970,7
2023-07-24,경의선,홍대입구,1990,2352,4342,7
2023-07-24,경의선,서울역,5046,6195,11241,7
2023-07-24,경부선,가산디지털단지,18596,21388,39984,7
2023-07-24,경부선,서울역,8353,2580,10933,7
2023-07-24,9호선,고속터미널,14290,18925,33215,7
2023-07-24,8호선,잠실(송파구청),16168,18547,34715,7
2023-07-24,7호선,가산디지털단지,49852,50054,99906,7
2023-07-24,7호선,고속터미널,17521,14279,31800,7
2023-07-24,4호선,사당,25450,21819,47269,7
2023-07-24,4호선,서울역,13362,20733,34095,7
2023-07-24,3호선,고속터미널,45461,41782,87243,7
2023-07-24,2호선,홍대입구,66789,70170,136959,7
2023-07-24,2호선,구로디지털단지,62222,61834,124056,7
2023-07-24,2호선,신림,55700,52897,108597,7
2023-07-24,2호선,사당,38418,41921,80339,7
2023-07-24,2호선,강남,89397,85940,175337,7
2023-07-24,2호선,선릉,64413,56706,121119,7
2023-07-24,2호선,잠실(송파구청),77223,77508,154731,7
2023-07-25,신림선,신림,1781,2454,4235,7
2023-07-25,공항철도 1호선,서울역,11931,10750,22681,7
2023-07-25,경의선,홍대입구,2069,2630,4699,7
2023-07-25,경의선,서울역,5043,6340,11383,7
2023-07-25,경부선,가산디지털단지,18952,21624,40576,7
2023-07-25,경부선,서울역,7985,2513,10498,7
2023-07-25,9호선,고속터미널,14315,19272,33587,7
2023-07-25,8호선,잠실(송파구청),16756,19290,36046,7
2023-07-25,7호선,가산디지털단지,50104,50635,100739,7
2023-07-25,7호선,고속터미널,17110,14730,31840,7
2023-07-25,4호선,사당,27011,23010,50021,7
2023-07-25,4호선,서울역,13799,21397,35196,7
2023-07-25,3호선,고속터미널,45286,42633,87919,7
2023-07-25,2호선,홍대입구,67439,70946,138385,7
2023-07-25,2호선,구로디지털단지,63373,62860,126233,7
2023-07-25,2호선,신림,56533,53108,109641,7
2023-07-25,2호선,사당,40508,44428,84936,7
2023-07-25,2호선,강남,92226,88406,180632,7
2023-07-25,2호선,선릉,66237,58308,124545,7
2023-07-25,2호선,잠실(송파구청),82047,82014,164061,7
2023-07-25,1호선,서울역,54473,52483,106956,7
2023-07-25,공항철도 1호선,홍대입구,14171,13969,28140,7
2023-07-25,분당선,선릉,14980,22949,37929,7
2023-07-26,4호선,사당,27015,23338,50353,7
2023-07-26,공항철도 1호선,서울역,12079,10979,23058,7
2023-07-26,공항철도 1호선,홍대입구,13953,14231,28184,7
2023-07-26,4호선,서울역,13888,22781,36669,7
2023-07-26,1호선,서울역,55980,50907,106887,7
2023-07-26,2호선,잠실(송파구청),82929,82963,165892,7
2023-07-26,2호선,선릉,65910,57947,123857,7
2023-07-26,2호선,강남,91776,87094,178870,7
2023-07-26,2호선,사당,41046,44666,85712,7
2023-07-26,2호선,신림,56429,53004,109433,7
2023-07-26,2호선,구로디지털단지,63390,62639,126029,7
2023-07-26,2호선,홍대입구,67231,71316,138547,7
2023-07-26,3호선,고속터미널,46263,43447,89710,7
2023-07-26,7호선,고속터미널,17018,14442,31460,7
2023-07-26,7호선,가산디지털단지,49335,50720,100055,7
2023-07-26,8호선,잠실(송파구청),16930,19857,36787,7
2023-07-26,9호선,고속터미널,15035,19692,34727,7
2023-07-26,경부선,서울역,7645,2940,10585,7
2023-07-26,경부선,가산디지털단지,18492,20343,38835,7
2023-07-26,경의선,서울역,5025,6371,11396,7
2023-07-26,경의선,홍대입구,2043,2618,4661,7
2023-07-26,분당선,선릉,14983,22934,37917,7
2023-07-26,신림선,신림,1834,2396,4230,7
2023-07-27,신림선,신림,1822,2494,4316,7
2023-07-27,분당선,선릉,14832,22895,37727,7
2023-07-27,공항철도 1호선,홍대입구,14586,15184,29770,7
2023-07-27,공항철도 1호선,서울역,13711,12247,25958,7
2023-07-27,경의선,홍대입구,2118,2703,4821,7
2023-07-27,경의선,서울역,5090,6398,11488,7
2023-07-27,경부선,가산디지털단지,18534,21255,39789,7
2023-07-27,경부선,서울역,8415,2768,11183,7
2023-07-27,9호선,고속터미널,15271,20626,35897,7
2023-07-27,8호선,잠실(송파구청),17261,20187,37448,7
2023-07-27,7호선,가산디지털단지,49130,49508,98638,7
2023-07-27,7호선,고속터미널,18141,14915,33056,7
2023-07-27,2호선,구로디지털단지,63134,62442,125576,7
2023-07-27,2호선,홍대입구,70046,75124,145170,7
2023-07-27,4호선,사당,28095,23817,51912,7
2023-07-27,4호선,서울역,13888,23354,37242,7
2023-07-27,3호선,고속터미널,48456,45734,94190,7
2023-07-27,2호선,강남,92288,87761,180049,7
2023-07-27,2호선,선릉,65677,57629,123306,7
2023-07-27,2호선,잠실(송파구청),85602,85035,170637,7
2023-07-27,1호선,서울역,58460,55087,113547,7
2023-07-27,2호선,신림,56967,53510,110477,7
2023-07-27,2호선,사당,41600,45889,87489,7
2023-07-28,1호선,서울역,60888,59619,120507,7
2023-07-28,2호선,잠실(송파구청),87901,89024,176925,7
2023-07-28,2호선,선릉,63083,55403,118486,7
2023-07-28,2호선,강남,94560,91846,186406,7
2023-07-28,2호선,사당,42747,47828,90575,7
2023-07-28,2호선,신림,58144,53795,111939,7
2023-07-28,2호선,구로디지털단지,62752,61948,124700,7
2023-07-28,2호선,홍대입구,74963,83877,158840,7
2023-07-28,3호선,고속터미널,55183,58569,113752,7
2023-07-28,4호선,서울역,13377,24127,37504,7
2023-07-28,4호선,사당,28891,25479,54370,7
2023-07-28,7호선,고속터미널,19745,16175,35920,7
2023-07-28,7호선,가산디지털단지,48793,48126,96919,7
2023-07-28,8호선,잠실(송파구청),17838,20958,38796,7
2023-07-28,9호선,고속터미널,16916,25604,42520,7
2023-07-28,경부선,서울역,10420,3559,13979,7
2023-07-28,경부선,가산디지털단지,18393,20683,39076,7
2023-07-28,경의선,서울역,4912,6162,11074,7
2023-07-28,경의선,홍대입구,2359,3013,5372,7
2023-07-28,공항철도 1호선,서울역,15158,13578,28736,7
2023-07-28,공항철도 1호선,홍대입구,16004,17044,33048,7
2023-07-28,분당선,선릉,14391,21911,36302,7
2023-07-28,신림선,신림,1797,2528,4325,7
2023-07-29,신림선,신림,1317,1889,3206,7
2023-07-29,분당선,선릉,5368,7846,13214,7
2023-07-29,공항철도 1호선,홍대입구,17429,17719,35148,7
2023-07-29,공항철도 1호선,서울역,13091,12732,25823,7
2023-07-29,경의선,홍대입구,2512,3062,5574,7
2023-07-29,경의선,서울역,1470,1648,3118,7
2023-07-29,경부선,가산디지털단지,6089,7680,13769,7
2023-07-29,경부선,서울역,9855,2894,12749,7
2023-07-29,9호선,고속터미널,15338,24006,39344,7
2023-07-29,8호선,잠실(송파구청),15061,17942,33003,7
2023-07-29,7호선,가산디지털단지,13597,12437,26034,7
2023-07-29,7호선,고속터미널,15810,11955,27765,7
2023-07-29,4호선,사당,21969,19391,41360,7
2023-07-29,4호선,서울역,6889,17280,24169,7
2023-07-29,3호선,고속터미널,55015,55584,110599,7
2023-07-29,2호선,홍대입구,79292,87490,166782,7
2023-07-29,2호선,구로디지털단지,34046,33122,67168,7
2023-07-29,2호선,신림,43459,39816,83275,7
2023-07-29,2호선,사당,31198,34837,66035,7
2023-07-29,2호선,강남,60256,58858,119114,7
2023-07-29,2호선,선릉,24459,21329,45788,7
2023-07-29,2호선,잠실(송파구청),75200,72963,148163,7
2023-07-29,1호선,서울역,43029,41663,84692,7
2023-07-30,7호선,고속터미널,15609,8359,23968,7
2023-07-30,7호선,가산디지털단지,10009,9371,19380,7
2023-07-30,8호선,잠실(송파구청),12123,13893,26016,7
2023-07-30,9호선,고속터미널,13394,18574,31968,7
2023-07-30,경부선,서울역,9810,2562,12372,7
2023-07-30,경부선,가산디지털단지,4344,6158,10502,7
2023-07-30,경의선,서울역,1252,1269,2521,7
2023-07-30,경의선,홍대입구,1884,2716,4600,7
2023-07-30,공항철도 1호선,서울역,13973,12777,26750,7
2023-07-30,공항철도 1호선,홍대입구,14883,14856,29739,7
2023-07-30,분당선,선릉,2824,4187,7011,7
2023-07-30,신림선,신림,1086,1632,2718,7
2023-07-30,1호선,서울역,37990,34806,72796,7
2023-07-30,2호선,잠실(송파구청),61124,57193,118317,7
2023-07-30,2호선,선릉,13876,12175,26051,7
2023-07-30,2호선,강남,35019,33169,68188,7
2023-07-30,2호선,사당,22002,24510,46512,7
2023-07-30,2호선,신림,32861,31786,64647,7
2023-07-30,2호선,구로디지털단지,25048,24690,49738,7
2023-07-30,2호선,홍대입구,64942,66456,131398,7
2023-07-30,3호선,고속터미널,49243,42184,91427,7
2023-07-30,4호선,서울역,5634,14861,20495,7
2023-07-30,4호선,사당,16053,14711,30764,7
2023-07-31,8호선,잠실(송파구청),17293,20033,37326,7
2023-07-31,7호선,가산디지털단지,45524,45865,91389,7
2023-07-31,7호선,고속터미널,18513,14449,32962,7
2023-07-31,신림선,신림,1804,2497,4301,7
2023-07-31,분당선,선릉,13870,21146,35016,7
2023-07-31,공항철도 1호선,홍대입구,14880,14072,28952,7
2023-07-31,공항철도 1호선,서울역,13423,12180,25603,7
2023-07-31,경의선,홍대입구,1979,2447,4426,7
2023-07-31,경의선,서울역,4730,6009,10739,7
2023-07-31,경부선,가산디지털단지,17146,19611,36757,7
2023-07-31,경부선,서울역,9788,2888,12676,7
2023-07-31,1호선,서울역,55632,52734,108366,7
2023-07-31,2호선,잠실(송파구청),86292,86614,172906,7
2023-07-31,2호선,선릉,60133,52817,112950,7
2023-07-31,2호선,강남,83086,79409,162495,7
2023-07-31,2호선,사당,36193,39917,76110,7
2023-07-31,2호선,신림,53716,51043,104759,7
2023-07-31,2호선,구로디지털단지,58308,58073,116381,7
2023-07-31,2호선,홍대입구,68734,71350,140084,7
2023-07-31,3호선,고속터미널,47773,44504,92277,7
2023-07-31,4호선,서울역,12892,21366,34258,7
2023-07-31,4호선,사당,24855,21036,45891,7
2023-07-31,9호선,고속터미널,14766,20498,35264,7
2023-08-01,1호선,서울역,52929,50606,103535,8
2023-08-01,2호선,선릉,62329,54557,116886,8
2023-08-01,신림선,신림,1766,2376,4142,8
2023-08-01,분당선,선릉,14145,21429,35574,8
2023-08-01,공항철도 1호선,홍대입구,14354,14089,28443,8
2023-08-01,공항철도 1호선,서울역,12358,11068,23426,8
2023-08-01,경의선,홍대입구,1999,2520,4519,8
2023-08-01,경의선,서울역,4680,5939,10619,8
2023-08-01,경부선,가산디지털단지,16705,19357,36062,8
2023-08-01,경부선,서울역,8783,2497,11280,8
2023-08-01,9호선,고속터미널,14682,20043,34725,8
2023-08-01,8호선,잠실(송파구청),17680,20268,37948,8
2023-08-01,7호선,가산디지털단지,46066,46092,92158,8
2023-08-01,7호선,고속터미널,17701,14463,32164,8
2023-08-01,4호선,사당,25919,21773,47692,8
2023-08-01,4호선,서울역,13049,20813,33862,8
2023-08-01,3호선,고속터미널,46458,42877,89335,8
2023-08-01,2호선,홍대입구,67723,71032,138755,8
2023-08-01,2호선,구로디지털단지,59354,58953,118307,8
2023-08-01,2호선,신림,54272,51326,105598,8
2023-08-01,2호선,사당,37680,41777,79457,8
2023-08-01,2호선,강남,87270,83345,170615,8
2023-08-01,2호선,잠실(송파구청),88474,88358,176832,8
2023-08-02,공항철도 1호선,서울역,12185,11085,23270,8
2023-08-02,공항철도 1호선,홍대입구,14465,14028,28493,8
2023-08-02,1호선,서울역,53200,50678,103878,8
2023-08-02,2호선,잠실(송파구청),86490,86163,172653,8
2023-08-02,2호선,선릉,61968,54137,116105,8
2023-08-02,2호선,강남,87006,83143,170149,8
2023-08-02,2호선,사당,38610,42324,80934,8
2023-08-02,2호선,신림,54767,51677,106444,8
2023-08-02,2호선,구로디지털단지,59328,59152,118480,8
2023-08-02,2호선,홍대입구,67030,71798,138828,8
2023-08-02,3호선,고속터미널,46385,43284,89669,8
2023-08-02,4호선,서울역,12972,21374,34346,8
2023-08-02,4호선,사당,26034,22159,48193,8
2023-08-02,7호선,고속터미널,17325,14277,31602,8
2023-08-02,7호선,가산디지털단지,45130,45126,90256,8
2023-08-02,8호선,잠실(송파구청),17420,20223,37643,8
2023-08-02,9호선,고속터미널,14352,19597,33949,8
2023-08-02,경부선,서울역,8647,2698,11345,8
2023-08-02,경부선,가산디지털단지,16959,19344,36303,8
2023-08-02,경의선,서울역,4457,5657,10114,8
2023-08-02,경의선,홍대입구,2190,2593,4783,8
2023-08-02,분당선,선릉,14067,21238,35305,8
2023-08-02,신림선,신림,1762,2506,4268,8
2023-08-03,1호선,서울역,53890,51746,105636,8
2023-08-03,2호선,잠실(송파구청),87274,86881,174155,8
2023-08-03,2호선,선릉,62873,55333,118206,8
2023-08-03,2호선,강남,88104,84166,172270,8
2023-08-03,2호선,사당,38914,42844,81758,8
2023-08-03,2호선,신림,54835,51800,106635,8
2023-08-03,2호선,구로디지털단지,59575,59268,118843,8
2023-08-03,2호선,홍대입구,66809,71226,138035,8
2023-08-03,3호선,고속터미널,46764,44132,90896,8
2023-08-03,4호선,서울역,13131,21873,35004,8
2023-08-03,4호선,사당,26138,22413,48551,8
2023-08-03,7호선,고속터미널,17223,14431,31654,8
2023-08-03,7호선,가산디지털단지,45629,45886,91515,8
2023-08-03,8호선,잠실(송파구청),17356,20385,37741,8
2023-08-03,9호선,고속터미널,14661,20349,35010,8
2023-08-03,경부선,서울역,8950,2835,11785,8
2023-08-03,경부선,가산디지털단지,17015,19427,36442,8
2023-08-03,경의선,서울역,4519,5752,10271,8
2023-08-03,경의선,홍대입구,1966,2379,4345,8
2023-08-03,공항철도 1호선,서울역,12521,11486,24007,8
2023-08-03,공항철도 1호선,홍대입구,13678,13924,27602,8
2023-08-03,분당선,선릉,14060,21513,35573,8
2023-08-03,신림선,신림,1767,2489,4256,8
2023-08-04,신림선,신림,1785,2418,4203,8
2023-08-04,분당선,선릉,13461,20580,34041,8
2023-08-04,공항철도 1호선,홍대입구,14639,15110,29749,8
2023-08-04,공항철도 1호선,서울역,14554,13419,27973,8
2023-08-04,경의선,홍대입구,2090,2632,4722,8
2023-08-04,경의선,서울역,4733,5914,10647,8
2023-08-04,경부선,가산디지털단지,16661,18998,35659,8
2023-08-04,경부선,서울역,10460,3372,13832,8
2023-08-04,9호선,고속터미널,15535,22386,37921,8
2023-08-04,8호선,잠실(송파구청),15535,18196,33731,8
2023-08-04,7호선,가산디지털단지,44613,44456,89069,8
2023-08-04,7호선,고속터미널,19010,14967,33977,8
2023-08-04,4호선,사당,26907,23744,50651,8
2023-08-04,4호선,서울역,12783,22891,35674,8
2023-08-04,3호선,고속터미널,49851,51699,101550,8
2023-08-04,2호선,홍대입구,67302,74260,141562,8
2023-08-04,2호선,구로디지털단지,59278,58921,118199,8
2023-08-04,2호선,신림,55604,51269,106873,8
2023-08-04,2호선,사당,39465,43723,83188,8
2023-08-04,2호선,강남,79672,78179,157851,8
2023-08-04,2호선,선릉,59370,52468,111838,8
2023-08-04,2호선,잠실(송파구청),78740,77022,155762,8
2023-08-04,1호선,서울역,57269,55142,112411,8
2023-08-05,신림선,신림,1263,1899,3162,8
2023-08-05,1호선,서울역,37783,36733,74516,8
2023-08-05,2호선,잠실(송파구청),66444,64223,130667,8
2023-08-05,2호선,선릉,23800,20521,44321,8
2023-08-05,2호선,강남,51521,50351,101872,8
2023-08-05,2호선,사당,28850,32328,61178,8
2023-08-05,2호선,신림,41320,37722,79042,8
2023-08-05,2호선,구로디지털단지,32789,31706,64495,8
2023-08-05,2호선,홍대입구,68085,76716,144801,8
2023-08-05,3호선,고속터미널,48322,48483,96805,8
2023-08-05,4호선,서울역,6184,15812,21996,8
2023-08-05,4호선,사당,20313,18258,38571,8
2023-08-05,7호선,고속터미널,14966,11072,26038,8
2023-08-05,7호선,가산디지털단지,12741,11470,24211,8
2023-08-05,8호선,잠실(송파구청),13506,15409,28915,8
2023-08-05,9호선,고속터미널,13455,20567,34022,8
2023-08-05,경부선,서울역,9488,2686,12174,8
2023-08-05,경부선,가산디지털단지,5541,7006,12547,8
2023-08-05,경의선,서울역,1397,1469,2866,8
2023-08-05,경의선,홍대입구,2173,2845,5018,8
2023-08-05,공항철도 1호선,서울역,12274,12148,24422,8
2023-08-05,공항철도 1호선,홍대입구,15180,15554,30734,8
2023-08-05,분당선,선릉,4897,7547,12444,8
2023-08-06,3호선,고속터미널,44015,38129,82144,8
2023-08-06,2호선,잠실(송파구청),50645,48084,98729,8
2023-08-06,2호선,선릉,13293,11405,24698,8
2023-08-06,2호선,강남,30878,29114,59992,8
2023-08-06,2호선,사당,20548,22745,43293,8
2023-08-06,2호선,신림,31080,30737,61817,8
2023-08-06,2호선,구로디지털단지,23808,23581,47389,8
2023-08-06,2호선,홍대입구,54935,55169,110104,8
2023-08-06,4호선,서울역,4897,13034,17931,8
2023-08-06,4호선,사당,14473,14003,28476,8
2023-08-06,7호선,고속터미널,14414,8122,22536,8
2023-08-06,7호선,가산디지털단지,9178,8768,17946,8
2023-08-06,8호선,잠실(송파구청),10793,11906,22699,8
2023-08-06,9호선,고속터미널,11645,16403,28048,8
2023-08-06,경부선,서울역,8950,2509,11459,8
2023-08-06,경부선,가산디지털단지,4201,5799,10000,8
2023-08-06,경의선,서울역,1115,1128,2243,8
2023-08-06,경의선,홍대입구,1800,2374,4174,8
2023-08-06,공항철도 1호선,서울역,12401,11586,23987,8
2023-08-06,공항철도 1호선,홍대입구,13014,11960,24974,8
2023-08-06,분당선,선릉,2757,4056,6813,8
2023-08-06,신림선,신림,1090,1613,2703,8
2023-08-06,1호선,서울역,32823,30866,63689,8
2023-08-07,1호선,서울역,52546,49733,102279,8
2023-08-07,2호선,잠실(송파구청),76289,76137,152426,8
2023-08-07,2호선,선릉,62025,54591,116616,8
2023-08-07,2호선,강남,84366,81164,165530,8
2023-08-07,2호선,사당,36635,39942,76577,8
2023-08-07,2호선,신림,53323,50655,103978,8
2023-08-07,2호선,구로디지털단지,59331,59025,118356,8
2023-08-07,2호선,홍대입구,61351,64701,126052,8
2023-08-07,3호선,고속터미널,43847,40408,84255,8
2023-08-07,4호선,서울역,12885,20072,32957,8
2023-08-07,4호선,사당,24807,20955,45762,8
2023-08-07,7호선,고속터미널,17542,14041,31583,8
2023-08-07,7호선,가산디지털단지,49095,48473,97568,8
2023-08-07,8호선,잠실(송파구청),15916,18042,33958,8
2023-08-07,9호선,고속터미널,13701,17931,31632,8
2023-08-07,경부선,서울역,8805,2625,11430,8
2023-08-07,경부선,가산디지털단지,17252,20265,37517,8
2023-08-07,경의선,서울역,4728,6004,10732,8
2023-08-07,경의선,홍대입구,1843,2289,4132,8
2023-08-07,공항철도 1호선,서울역,12661,11130,23791,8
2023-08-07,공항철도 1호선,홍대입구,13177,13008,26185,8
2023-08-07,분당선,선릉,14240,21561,35801,8
2023-08-07,신림선,신림,1720,2527,4247,8
2023-08-08,신림선,신림,1786,2369,4155,8
2023-08-08,분당선,선릉,14704,22340,37044,8
2023-08-08,공항철도 1호선,홍대입구,13529,13597,27126,8
2023-08-08,공항철도 1호선,서울역,12187,10484,22671,8
2023-08-08,경의선,홍대입구,1985,2372,4357,8
2023-08-08,경의선,서울역,4777,5930,10707,8
2023-08-08,경부선,가산디지털단지,17906,20670,38576,8
2023-08-08,경부선,서울역,8171,2476,10647,8
2023-08-08,9호선,고속터미널,13960,18712,32672,8
2023-08-08,8호선,잠실(송파구청),16558,18960,35518,8
2023-08-08,7호선,가산디지털단지,49077,49222,98299,8
2023-08-08,7호선,고속터미널,17165,14377,31542,8
2023-08-08,4호선,사당,26226,22211,48437,8
2023-08-08,4호선,서울역,13449,20678,34127,8
2023-08-08,3호선,고속터미널,44203,40805,85008,8
2023-08-08,2호선,홍대입구,65049,68963,134012,8
2023-08-08,2호선,구로디지털단지,60807,60592,121399,8
2023-08-08,2호선,신림,54623,51984,106607,8
2023-08-08,2호선,사당,39041,42754,81795,8
2023-08-08,2호선,강남,88556,84955,173511,8
2023-08-08,2호선,선릉,64766,56783,121549,8
2023-08-08,2호선,잠실(송파구청),80719,80191,160910,8
2023-08-08,1호선,서울역,53033,50121,103154,8
2023-08-09,분당선,선릉,14669,22161,36830,8
2023-08-09,공항철도 1호선,홍대입구,13000,13148,26148,8
2023-08-09,공항철도 1호선,서울역,13037,11208,24245,8
2023-08-09,경의선,홍대입구,1957,2407,4364,8
2023-08-09,경의선,서울역,4868,6053,10921,8
2023-08-09,경부선,가산디지털단지,18091,20770,38861,8
2023-08-09,경부선,서울역,8822,2516,11338,8
2023-08-09,9호선,고속터미널,13673,18358,32031,8
2023-08-09,8호선,잠실(송파구청),16696,19130,35826,8
2023-08-09,7호선,가산디지털단지,48656,48642,97298,8
2023-08-09,7호선,고속터미널,16992,14267,31259,8
2023-08-09,4호선,사당,26816,22982,49798,8
2023-08-09,4호선,서울역,13640,20857,34497,8
2023-08-09,3호선,고속터미널,43180,40175,83355,8
2023-08-09,2호선,홍대입구,63698,68169,131867,8
2023-08-09,2호선,구로디지털단지,61213,61087,122300,8
2023-08-09,2호선,신림,55927,53012,108939,8
2023-08-09,2호선,사당,39899,43965,83864,8
2023-08-09,2호선,강남,88103,84444,172547,8
2023-08-09,2호선,선릉,64092,56085,120177,8
2023-08-09,2호선,잠실(송파구청),79272,78953,158225,8
2023-08-09,1호선,서울역,54351,50920,105271,8
2023-08-09,신림선,신림,1851,2518,4369,8
2023-08-10,공항철도 1호선,홍대입구,8902,8988,17890,8
2023-08-10,공항철도 1호선,서울역,9410,8153,17563,8
2023-08-10,경의선,홍대입구,1234,1560,2794,8
2023-08-10,경의선,서울역,3811,4622,8433,8
2023-08-10,경부선,가산디지털단지,14197,17222,31419,8
2023-08-10,경부선,서울역,4244,1726,5970,8
2023-08-10,9호선,고속터미널,10560,14533,25093,8
2023-08-10,8호선,잠실(송파구청),13546,14900,28446,8
2023-08-10,7호선,가산디지털단지,44305,42909,87214,8
2023-08-10,7호선,고속터미널,14325,11953,26278,8
2023-08-10,4호선,사당,19540,16745,36285,8
2023-08-10,4호선,서울역,10859,15576,26435,8
2023-08-10,3호선,고속터미널,34216,31702,65918,8
2023-08-10,2호선,홍대입구,44545,46248,90793,8
2023-08-10,2호선,구로디지털단지,50928,50665,101593,8
2023-08-10,2호선,신림,46523,43846,90369,8
2023-08-10,2호선,사당,29532,31470,61002,8
2023-08-10,2호선,강남,66121,62510,128631,8
2023-08-10,2호선,선릉,51867,45307,97174,8
2023-08-10,2호선,잠실(송파구청),58550,58765,117315,8
2023-08-10,1호선,서울역,39811,37689,77500,8
2023-08-10,신림선,신림,1524,2064,3588,8
2023-08-10,분당선,선릉,12419,18096,30515,8
2023-08-11,경의선,서울역,4807,5753,10560,8
2023-08-11,경의선,홍대입구,2030,2585,4615,8
2023-08-11,7호선,가산디지털단지,46410,46252,92662,8
2023-08-11,8호선,잠실(송파구청),16256,19028,35284,8
2023-08-11,9호선,고속터미널,14813,22749,37562,8
2023-08-11,경부선,서울역,9974,3836,13810,8
2023-08-11,경부선,가산디지털단지,17327,19301,36628,8
2023-08-11,분당선,선릉,14031,21105,35136,8
2023-08-11,공항철도 1호선,홍대입구,13697,14155,27852,8
2023-08-11,공항철도 1호선,서울역,14422,13896,28318,8
2023-08-11,1호선,서울역,56487,56598,113085,8
2023-08-11,2호선,잠실(송파구청),76352,76806,153158,8
2023-08-11,2호선,선릉,60433,53223,113656,8
2023-08-11,2호선,강남,86594,84447,171041,8
2023-08-11,2호선,사당,39425,44353,83778,8
2023-08-11,2호선,신림,55760,51373,107133,8
2023-08-11,2호선,구로디지털단지,59083,58463,117546,8
2023-08-11,2호선,홍대입구,66154,74802,140956,8
2023-08-11,3호선,고속터미널,48212,52597,100809,8
2023-08-11,4호선,서울역,12955,23096,36051,8
2023-08-11,4호선,사당,26616,23189,49805,8
2023-08-11,신림선,신림,1740,2323,4063,8
2023-08-11,7호선,고속터미널,18762,15646,34408,8
2023-08-12,신림선,신림,1270,1770,3040,8
2023-08-12,분당선,선릉,5376,8308,13684,8
2023-08-12,공항철도 1호선,홍대입구,16988,17090,34078,8
2023-08-12,공항철도 1호선,서울역,13067,13350,26417,8
2023-08-12,경의선,홍대입구,2389,3297,5686,8
2023-08-12,경의선,서울역,1370,1639,3009,8
2023-08-12,경부선,가산디지털단지,6302,7683,13985,8
2023-08-12,경부선,서울역,9029,3370,12399,8
2023-08-12,9호선,고속터미널,14498,23565,38063,8
2023-08-12,8호선,잠실(송파구청),13963,16119,30082,8
2023-08-12,7호선,가산디지털단지,13338,12192,25530,8
2023-08-12,7호선,고속터미널,15411,12166,27577,8
2023-08-12,4호선,사당,21403,19432,40835,8
2023-08-12,4호선,서울역,6734,17077,23811,8
2023-08-12,3호선,고속터미널,50904,54072,104976,8
2023-08-12,2호선,홍대입구,76220,87252,163472,8
2023-08-12,2호선,구로디지털단지,34718,33122,67840,8
2023-08-12,2호선,신림,43021,39169,82190,8
2023-08-12,2호선,사당,31672,35082,66754,8
2023-08-12,2호선,강남,56524,55711,112235,8
2023-08-12,2호선,선릉,26213,22600,48813,8
2023-08-12,2호선,잠실(송파구청),69297,67655,136952,8
2023-08-12,1호선,서울역,40511,42284,82795,8
2023-08-13,1호선,서울역,33863,32727,66590,8
2023-08-13,신림선,신림,1112,1701,2813,8
2023-08-13,분당선,선릉,3070,4289,7359,8
2023-08-13,공항철도 1호선,홍대입구,15698,14682,30380,8
2023-08-13,공항철도 1호선,서울역,13052,11886,24938,8
2023-08-13,경의선,홍대입구,2172,2759,4931,8
2023-08-13,경의선,서울역,1211,1161,2372,8
2023-08-13,경부선,가산디지털단지,4594,5920,10514,8
2023-08-13,경부선,서울역,9670,2686,12356,8
2023-08-13,9호선,고속터미널,12199,18043,30242,8
2023-08-13,8호선,잠실(송파구청),11452,12866,24318,8
2023-08-13,7호선,가산디지털단지,9818,9328,19146,8
2023-08-13,7호선,고속터미널,13600,8536,22136,8
2023-08-13,4호선,사당,16136,14919,31055,8
2023-08-13,4호선,서울역,5645,14260,19905,8
2023-08-13,3호선,고속터미널,43628,39716,83344,8
2023-08-13,2호선,홍대입구,66746,68792,135538,8
2023-08-13,2호선,구로디지털단지,25261,24359,49620,8
2023-08-13,2호선,신림,33083,32404,65487,8
2023-08-13,2호선,사당,22022,24769,46791,8
2023-08-13,2호선,강남,34069,32662,66731,8
2023-08-13,2호선,선릉,14336,12101,26437,8
2023-08-13,2호선,잠실(송파구청),57995,54799,112794,8
2023-08-14,신림선,신림,1655,2383,4038,8
2023-08-14,분당선,선릉,11807,18011,29818,8
2023-08-14,공항철도 1호선,홍대입구,15503,15433,30936,8
2023-08-14,공항철도 1호선,서울역,13530,11289,24819,8
2023-08-14,경의선,홍대입구,2254,2829,5083,8
2023-08-14,경의선,서울역,4148,5196,9344,8
2023-08-14,경부선,가산디지털단지,13590,15772,29362,8
2023-08-14,경부선,서울역,9449,2853,12302,8
2023-08-14,9호선,고속터미널,14731,20171,34902,8
2023-08-14,8호선,잠실(송파구청),15712,18156,33868,8
2023-08-14,7호선,가산디지털단지,36675,36548,73223,8
2023-08-14,7호선,고속터미널,17480,13596,31076,8
2023-08-14,4호선,사당,19621,20750,40371,8
2023-08-14,4호선,서울역,11033,19476,30509,8
2023-08-14,3호선,고속터미널,48429,44543,92972,8
2023-08-14,2호선,홍대입구,69919,77568,147487,8
2023-08-14,2호선,구로디지털단지,52747,52868,105615,8
2023-08-14,2호선,신림,51220,49316,100536,8
2023-08-14,2호선,사당,39426,39361,78787,8
2023-08-14,2호선,강남,80018,77631,157649,8
2023-08-14,2호선,선릉,52605,46396,99001,8
2023-08-14,2호선,잠실(송파구청),78684,77495,156179,8
2023-08-14,1호선,서울역,51785,47123,98908,8
2023-08-15,2호선,잠실(송파구청),58972,56408,115380,8
2023-08-15,신림선,신림,1290,1792,3082,8
2023-08-15,분당선,선릉,3463,5166,8629,8
2023-08-15,공항철도 1호선,홍대입구,14013,13351,27364,8
2023-08-15,공항철도 1호선,서울역,11600,10050,21650,8
2023-08-15,경의선,홍대입구,2020,2585,4605,8
2023-08-15,경의선,서울역,1437,1266,2703,8
2023-08-15,경부선,가산디지털단지,5185,7068,12253,8
2023-08-15,경부선,서울역,9292,2215,11507,8
2023-08-15,9호선,고속터미널,12665,16812,29477,8
2023-08-15,8호선,잠실(송파구청),13613,15107,28720,8
2023-08-15,7호선,가산디지털단지,11057,10734,21791,8
2023-08-15,7호선,고속터미널,12939,8140,21079,8
2023-08-15,4호선,사당,16359,15163,31522,8
2023-08-15,4호선,서울역,5866,12589,18455,8
2023-08-15,3호선,고속터미널,45442,38604,84046,8
2023-08-15,2호선,홍대입구,63308,66482,129790,8
2023-08-15,2호선,구로디지털단지,27452,27126,54578,8
2023-08-15,2호선,신림,35221,34427,69648,8
2023-08-15,2호선,사당,23263,25894,49157,8
2023-08-15,2호선,강남,36335,34562,70897,8
2023-08-15,1호선,서울역,37417,32761,70178,8
2023-08-15,2호선,선릉,17496,15664,33160,8
2023-08-16,3호선,고속터미널,44808,41161,85969,8
2023-08-16,7호선,가산디지털단지,48494,48769,97263,8
2023-08-16,8호선,잠실(송파구청),16217,18905,35122,8
2023-08-16,경부선,서울역,9869,2977,12846,8
2023-08-16,경부선,가산디지털단지,18219,20644,38863,8
2023-08-16,신림선,신림,1818,2512,4330,8
2023-08-16,분당선,선릉,14749,22541,37290,8
2023-08-16,공항철도 1호선,홍대입구,14084,13679,27763,8
2023-08-16,공항철도 1호선,서울역,13356,11884,25240,8
2023-08-16,경의선,홍대입구,2057,2495,4552,8
2023-08-16,경의선,서울역,5028,6358,11386,8
2023-08-16,9호선,고속터미널,14469,19036,33505,8
2023-08-16,7호선,고속터미널,18011,14569,32580,8
2023-08-16,4호선,사당,26469,22277,48746,8
2023-08-16,4호선,서울역,13676,21943,35619,8
2023-08-16,2호선,구로디지털단지,61761,61618,123379,8
2023-08-16,2호선,신림,56184,53952,110136,8
2023-08-16,2호선,사당,39368,43154,82522,8
2023-08-16,2호선,강남,88618,84595,173213,8
2023-08-16,2호선,선릉,64254,56494,120748,8
2023-08-16,2호선,잠실(송파구청),78973,78612,157585,8
2023-08-16,1호선,서울역,55993,52948,108941,8
2023-08-16,2호선,홍대입구,65794,70228,136022,8
2023-08-17,1호선,서울역,56750,53284,110034,8
2023-08-17,2호선,잠실(송파구청),80814,80735,161549,8
2023-08-17,2호선,선릉,65197,57565,122762,8
2023-08-17,2호선,강남,90290,86203,176493,8
2023-08-17,2호선,사당,40709,44691,85400,8
2023-08-17,2호선,신림,56738,53851,110589,8
2023-08-17,2호선,구로디지털단지,62159,62268,124427,8
2023-08-17,2호선,홍대입구,67104,72167,139271,8
2023-08-17,3호선,고속터미널,45271,42571,87842,8
2023-08-17,4호선,서울역,13891,22050,35941,8
2023-08-17,4호선,사당,27163,23219,50382,8
2023-08-17,7호선,고속터미널,17519,14758,32277,8
2023-08-17,7호선,가산디지털단지,48882,49406,98288,8
2023-08-17,8호선,잠실(송파구청),16603,19192,35795,8
2023-08-17,9호선,고속터미널,14647,19612,34259,8
2023-08-17,경부선,서울역,9149,3016,12165,8
2023-08-17,경부선,가산디지털단지,18278,20668,38946,8
2023-08-17,경의선,서울역,5083,6256,11339,8
2023-08-17,경의선,홍대입구,2068,2450,4518,8
2023-08-17,공항철도 1호선,서울역,13383,11547,24930,8
2023-08-17,공항철도 1호선,홍대입구,13854,13728,27582,8
2023-08-17,분당선,선릉,15284,22822,38106,8
2023-08-17,신림선,신림,1823,2484,4307,8
2023-08-18,1호선,서울역,60234,58547,118781,8
2023-08-18,2호선,잠실(송파구청),82954,82681,165635,8
2023-08-18,2호선,선릉,64452,56658,121110,8
2023-08-18,2호선,강남,92542,90049,182591,8
2023-08-18,2호선,사당,43075,47846,90921,8
2023-08-18,2호선,신림,58357,54440,112797,8
2023-08-18,2호선,구로디지털단지,63131,62486,125617,8
2023-08-18,2호선,홍대입구,71519,81420,152939,8
2023-08-18,3호선,고속터미널,52504,52829,105333,8
2023-08-18,4호선,서울역,13973,24198,38171,8
2023-08-18,4호선,사당,28675,25210,53885,8
2023-08-18,7호선,고속터미널,19831,15961,35792,8
2023-08-18,7호선,가산디지털단지,49101,48676,97777,8
2023-08-18,8호선,잠실(송파구청),17436,19990,37426,8
2023-08-18,9호선,고속터미널,16321,23666,39987,8
2023-08-18,경부선,서울역,11347,3814,15161,8
2023-08-18,경부선,가산디지털단지,18119,20533,38652,8
2023-08-18,경의선,서울역,5017,6312,11329,8
2023-08-18,경의선,홍대입구,2209,2756,4965,8
2023-08-18,공항철도 1호선,서울역,15206,13699,28905,8
2023-08-18,공항철도 1호선,홍대입구,14764,15083,29847,8
2023-08-18,분당선,선릉,14913,22572,37485,8
2023-08-18,신림선,신림,1868,2569,4437,8
2023-08-19,1호선,서울역,42180,40992,83172,8
2023-08-19,2호선,잠실(송파구청),71469,69966,141435,8
2023-08-19,2호선,선릉,27056,23528,50584,8
2023-08-19,2호선,강남,59408,58474,117882,8
2023-08-19,2호선,사당,34219,38107,72326,8
2023-08-19,2호선,신림,45101,41810,86911,8
2023-08-19,2호선,구로디지털단지,36845,35975,72820,8
2023-08-19,2호선,홍대입구,77446,88477,165923,8
2023-08-19,3호선,고속터미널,54586,52682,107268,8
2023-08-19,4호선,서울역,7396,18226,25622,8
2023-08-19,4호선,사당,23628,21683,45311,8
2023-08-19,7호선,고속터미널,16294,12669,28963,8
2023-08-19,7호선,가산디지털단지,14046,12840,26886,8
2023-08-19,8호선,잠실(송파구청),15083,18001,33084,8
2023-08-19,9호선,고속터미널,15576,24015,39591,8
2023-08-19,경부선,서울역,10088,3226,13314,8
2023-08-19,경부선,가산디지털단지,6582,8003,14585,8
2023-08-19,경의선,서울역,1479,1639,3118,8
2023-08-19,경의선,홍대입구,2357,2793,5150,8
2023-08-19,공항철도 1호선,서울역,13434,12845,26279,8
2023-08-19,공항철도 1호선,홍대입구,17284,17212,34496,8
2023-08-19,분당선,선릉,5398,8612,14010,8
2023-08-19,신림선,신림,1393,1884,3277,8
2023-08-20,1호선,서울역,35060,33389,68449,8
2023-08-20,2호선,잠실(송파구청),53300,50921,104221,8
2023-08-20,2호선,선릉,14897,12538,27435,8
2023-08-20,2호선,강남,34665,33089,67754,8
2023-08-20,2호선,사당,23676,25897,49573,8
2023-08-20,2호선,신림,33397,32205,65602,8
2023-08-20,2호선,구로디지털단지,25598,25061,50659,8
2023-08-20,2호선,홍대입구,60890,62095,122985,8
2023-08-20,3호선,고속터미널,45622,41394,87016,8
2023-08-20,4호선,서울역,5589,14573,20162,8
2023-08-20,4호선,사당,16772,16000,32772,8
2023-08-20,7호선,고속터미널,14182,9115,23297,8
2023-08-20,7호선,가산디지털단지,9849,9483,19332,8
2023-08-20,8호선,잠실(송파구청),11857,13198,25055,8
2023-08-20,9호선,고속터미널,12378,18076,30454,8
2023-08-20,경부선,서울역,10123,2791,12914,8
2023-08-20,경부선,가산디지털단지,4714,6241,10955,8
2023-08-20,경의선,서울역,1312,1151,2463,8
2023-08-20,경의선,홍대입구,2053,2413,4466,8
2023-08-20,공항철도 1호선,서울역,13291,11655,24946,8
2023-08-20,공항철도 1호선,홍대입구,14676,13285,27961,8
2023-08-20,분당선,선릉,3123,4516,7639,8
2023-08-20,신림선,신림,1136,1747,2883,8
2023-08-21,2호선,잠실(송파구청),73392,73405,146797,8
2023-08-21,2호선,선릉,63032,55717,118749,8
2023-08-21,2호선,강남,85151,82034,167185,8
2023-08-21,2호선,사당,38448,41962,80410,8
2023-08-21,2호선,신림,54386,51638,106024,8
2023-08-21,2호선,구로디지털단지,60886,60653,121539,8
2023-08-21,2호선,홍대입구,62716,66475,129191,8
2023-08-21,3호선,고속터미널,39326,35247,74573,8
2023-08-21,4호선,서울역,13301,20837,34138,8
2023-08-21,4호선,사당,25712,21993,47705,8
2023-08-21,7호선,고속터미널,17313,14198,31511,8
2023-08-21,7호선,가산디지털단지,49599,49908,99507,8
2023-08-21,8호선,잠실(송파구청),15855,17846,33701,8
2023-08-21,9호선,고속터미널,13603,17706,31309,8
2023-08-21,경부선,서울역,8809,2978,11787,8
2023-08-21,경부선,가산디지털단지,18251,20726,38977,8
2023-08-21,경의선,서울역,5056,6424,11480,8
2023-08-21,경의선,홍대입구,1904,2252,4156,8
2023-08-21,공항철도 1호선,서울역,13463,11326,24789,8
2023-08-21,공항철도 1호선,홍대입구,13300,13019,26319,8
2023-08-21,분당선,선릉,14669,22066,36735,8
2023-08-21,신림선,신림,1886,2570,4456,8
2023-08-21,1호선,서울역,54037,50946,104983,8
2023-08-22,분당선,선릉,14901,22721,37622,8
2023-08-22,신림선,신림,1836,2491,4327,8
2023-08-22,1호선,서울역,53919,50717,104636,8
2023-08-22,2호선,잠실(송파구청),76637,76296,152933,8
2023-08-22,2호선,선릉,64611,56248,120859,8
2023-08-22,2호선,강남,87258,82923,170181,8
2023-08-22,2호선,사당,38951,42436,81387,8
2023-08-22,2호선,신림,54862,52029,106891,8
2023-08-22,2호선,구로디지털단지,61454,60824,122278,8
2023-08-22,2호선,홍대입구,62653,66477,129130,8
2023-08-22,3호선,고속터미널,44053,40420,84473,8
2023-08-22,4호선,서울역,13498,20577,34075,8
2023-08-22,4호선,사당,26573,22142,48715,8
2023-08-22,7호선,고속터미널,16934,14421,31355,8
2023-08-22,7호선,가산디지털단지,50145,49841,99986,8
2023-08-22,8호선,잠실(송파구청),15998,18117,34115,8
2023-08-22,9호선,고속터미널,13576,18303,31879,8
2023-08-22,경부선,서울역,8078,2798,10876,8
2023-08-22,경부선,가산디지털단지,18153,20763,38916,8
2023-08-22,경의선,서울역,4838,5943,10781,8
2023-08-22,경의선,홍대입구,1798,2368,4166,8
2023-08-22,공항철도 1호선,서울역,12203,10529,22732,8
2023-08-22,공항철도 1호선,홍대입구,12928,12858,25786,8
2023-08-23,3호선,고속터미널,42133,38893,81026,8
2023-08-23,1호선,서울역,54058,50503,104561,8
2023-08-23,2호선,잠실(송파구청),74536,74263,148799,8
2023-08-23,2호선,선릉,63057,55043,118100,8
2023-08-23,2호선,강남,84811,80986,165797,8
2023-08-23,2호선,사당,38833,42076,80909,8
2023-08-23,2호선,신림,54371,51357,105728,8
2023-08-23,2호선,구로디지털단지,60298,60185,120483,8
2023-08-23,2호선,홍대입구,60681,65132,125813,8
2023-08-23,4호선,서울역,13467,21779,35246,8
2023-08-23,4호선,사당,25685,22072,47757,8
2023-08-23,7호선,고속터미널,16101,13558,29659,8
2023-08-23,7호선,가산디지털단지,48786,48697,97483,8
2023-08-23,8호선,잠실(송파구청),15868,17967,33835,8
2023-08-23,9호선,고속터미널,12944,17781,30725,8
2023-08-23,경부선,서울역,8355,2856,11211,8
2023-08-23,경부선,가산디지털단지,17686,20247,37933,8
2023-08-23,경의선,서울역,4736,5746,10482,8
2023-08-23,경의선,홍대입구,1822,2108,3930,8
2023-08-23,공항철도 1호선,서울역,12583,10492,23075,8
2023-08-23,공항철도 1호선,홍대입구,12413,12373,24786,8
2023-08-23,분당선,선릉,14921,22338,37259,8
2023-08-23,신림선,신림,1703,2429,4132,8
2023-08-24,2호선,잠실(송파구청),76892,76851,153743,8
2023-08-24,2호선,선릉,64804,56582,121386,8
2023-08-24,2호선,강남,87685,84327,172012,8
2023-08-24,2호선,사당,40548,44775,85323,8
2023-08-24,2호선,신림,56670,53387,110057,8
2023-08-24,2호선,구로디지털단지,62616,62098,124714,8
2023-08-24,2호선,홍대입구,66025,71143,137168,8
2023-08-24,신림선,신림,1864,2514,4378,8
2023-08-24,3호선,고속터미널,44155,41571,85726,8
2023-08-24,4호선,서울역,13894,22138,36032,8
2023-08-24,4호선,사당,27034,23219,50253,8
2023-08-24,7호선,고속터미널,16763,14793,31556,8
2023-08-24,7호선,가산디지털단지,49120,49864,98984,8
2023-08-24,8호선,잠실(송파구청),15894,18457,34351,8
2023-08-24,9호선,고속터미널,14369,18995,33364,8
2023-08-24,경부선,서울역,8672,2880,11552,8
2023-08-24,경부선,가산디지털단지,18309,20775,39084,8
2023-08-24,경의선,서울역,4972,6098,11070,8
2023-08-24,경의선,홍대입구,1991,2488,4479,8
2023-08-24,공항철도 1호선,서울역,12889,11679,24568,8
2023-08-24,공항철도 1호선,홍대입구,13577,13622,27199,8
2023-08-24,분당선,선릉,14996,22707,37703,8
2023-08-24,1호선,서울역,55781,52507,108288,8
2023-08-25,신림선,신림,1927,2642,4569,8
2023-08-25,1호선,서울역,62461,60265,122726,8
2023-08-25,2호선,잠실(송파구청),84000,83425,167425,8
2023-08-25,2호선,선릉,64735,56723,121458,8
2023-08-25,2호선,강남,92651,90180,182831,8
2023-08-25,2호선,사당,43698,48963,92661,8
2023-08-25,2호선,신림,59265,55190,114455,8
2023-08-25,2호선,구로디지털단지,63795,63513,127308,8
2023-08-25,2호선,홍대입구,74099,84537,158636,8
2023-08-25,3호선,고속터미널,53438,54528,107966,8
2023-08-25,4호선,서울역,14624,25249,39873,8
2023-08-25,4호선,사당,29473,25877,55350,8
2023-08-25,7호선,고속터미널,20306,16385,36691,8
2023-08-25,7호선,가산디지털단지,49612,49493,99105,8
2023-08-25,8호선,잠실(송파구청),16875,20120,36995,8
2023-08-25,9호선,고속터미널,16886,24139,41025,8
2023-08-25,경부선,서울역,11336,4077,15413,8
2023-08-25,경부선,가산디지털단지,18677,21102,39779,8
2023-08-25,경의선,서울역,5270,6413,11683,8
2023-08-25,경의선,홍대입구,2183,2761,4944,8
2023-08-25,공항철도 1호선,서울역,15957,14069,30026,8
2023-08-25,공항철도 1호선,홍대입구,16044,16405,32449,8
2023-08-25,분당선,선릉,14997,22775,37772,8
2023-08-26,신림선,신림,1325,1922,3247,8
2023-08-26,분당선,선릉,5904,9343,15247,8
2023-08-26,공항철도 1호선,홍대입구,17964,18106,36070,8
2023-08-26,공항철도 1호선,서울역,13974,13641,27615,8
2023-08-26,경의선,홍대입구,2503,3121,5624,8
2023-08-26,경의선,서울역,1663,1751,3414,8
2023-08-26,경부선,가산디지털단지,6674,8079,14753,8
2023-08-26,경부선,서울역,10858,3358,14216,8
2023-08-26,9호선,고속터미널,16640,25117,41757,8
2023-08-26,8호선,잠실(송파구청),15008,17868,32876,8
2023-08-26,7호선,가산디지털단지,14396,13202,27598,8
2023-08-26,7호선,고속터미널,17551,13697,31248,8
2023-08-26,4호선,사당,24051,21804,45855,8
2023-08-26,4호선,서울역,8051,19674,27725,8
2023-08-26,3호선,고속터미널,57094,55572,112666,8
2023-08-26,2호선,홍대입구,78722,90231,168953,8
2023-08-26,2호선,구로디지털단지,37441,36218,73659,8
2023-08-26,2호선,신림,45777,41887,87664,8
2023-08-26,2호선,사당,35319,39816,75135,8
2023-08-26,2호선,강남,61040,59975,121015,8
2023-08-26,2호선,선릉,28699,25031,53730,8
2023-08-26,2호선,잠실(송파구청),76241,73641,149882,8
2023-08-26,1호선,서울역,45668,44143,89811,8
2023-08-27,2호선,구로디지털단지,26628,25968,52596,8
2023-08-27,2호선,신림,34633,33870,68503,8
2023-08-27,2호선,사당,24424,26830,51254,8
2023-08-27,2호선,강남,35705,33840,69545,8
2023-08-27,2호선,선릉,16356,13445,29801,8
2023-08-27,2호선,잠실(송파구청),55106,51668,106774,8
2023-08-27,1호선,서울역,35591,34128,69719,8
2023-08-27,신림선,신림,1135,1645,2780,8
2023-08-27,분당선,선릉,3243,4928,8171,8
2023-08-27,공항철도 1호선,홍대입구,14940,13546,28486,8
2023-08-27,공항철도 1호선,서울역,13950,12603,26553,8
2023-08-27,경의선,홍대입구,2074,2432,4506,8
2023-08-27,경의선,서울역,1281,1247,2528,8
2023-08-27,경부선,가산디지털단지,5029,6515,11544,8
2023-08-27,경부선,서울역,10552,2743,13295,8
2023-08-27,9호선,고속터미널,13365,19788,33153,8
2023-08-27,8호선,잠실(송파구청),11574,12797,24371,8
2023-08-27,7호선,가산디지털단지,9934,9438,19372,8
2023-08-27,7호선,고속터미널,15482,9925,25407,8
2023-08-27,4호선,사당,17549,16301,33850,8
2023-08-27,4호선,서울역,5637,14538,20175,8
2023-08-27,3호선,고속터미널,47757,43499,91256,8
2023-08-27,2호선,홍대입구,64228,64854,129082,8
2023-08-28,2호선,선릉,62865,55442,118307,8
2023-08-28,1호선,서울역,55172,51646,106818,8
2023-08-28,2호선,잠실(송파구청),71565,72379,143944,8
2023-08-28,2호선,강남,83286,79875,163161,8
2023-08-28,2호선,사당,37796,41367,79163,8
2023-08-28,2호선,신림,53771,51361,105132,8
2023-08-28,2호선,구로디지털단지,60980,60964,121944,8
2023-08-28,2호선,홍대입구,60410,64976,125386,8
2023-08-28,3호선,고속터미널,43497,39474,82971,8
2023-08-28,4호선,서울역,13497,21056,34553,8
2023-08-28,4호선,사당,25557,22435,47992,8
2023-08-28,7호선,고속터미널,17423,14215,31638,8
2023-08-28,7호선,가산디지털단지,49701,50203,99904,8
2023-08-28,8호선,잠실(송파구청),15314,17787,33101,8
2023-08-28,9호선,고속터미널,13603,17872,31475,8
2023-08-28,경부선,서울역,9243,2981,12224,8
2023-08-28,경부선,가산디지털단지,18255,20908,39163,8
2023-08-28,경의선,서울역,4994,6252,11246,8
2023-08-28,경의선,홍대입구,1736,2129,3865,8
2023-08-28,공항철도 1호선,서울역,13387,11749,25136,8
2023-08-28,공항철도 1호선,홍대입구,12939,12452,25391,8
2023-08-28,분당선,선릉,14635,22399,37034,8
2023-08-28,신림선,신림,1696,2498,4194,8
2023-08-29,분당선,선릉,15026,22826,37852,8
2023-08-29,공항철도 1호선,홍대입구,12267,12222,24489,8
2023-08-29,공항철도 1호선,서울역,12509,11294,23803,8
2023-08-29,경의선,홍대입구,1747,2216,3963,8
2023-08-29,경의선,서울역,4989,6075,11064,8
2023-08-29,경부선,가산디지털단지,18297,20962,39259,8
2023-08-29,경부선,서울역,8578,2750,11328,8
2023-08-29,9호선,고속터미널,13708,18398,32106,8
2023-08-29,8호선,잠실(송파구청),15948,18055,34003,8
2023-08-29,7호선,가산디지털단지,50011,50077,100088,8
2023-08-29,7호선,고속터미널,16590,14514,31104,8
2023-08-29,4호선,사당,26690,22667,49357,8
2023-08-29,4호선,서울역,13787,21063,34850,8
2023-08-29,2호선,선릉,64315,56601,120916,8
2023-08-29,2호선,강남,84900,81261,166161,8
2023-08-29,2호선,사당,38863,42359,81222,8
2023-08-29,2호선,신림,54655,51826,106481,8
2023-08-29,2호선,구로디지털단지,61183,60883,122066,8
2023-08-29,2호선,홍대입구,59373,63192,122565,8
2023-08-29,3호선,고속터미널,42745,38736,81481,8
2023-08-29,신림선,신림,1747,2403,4150,8
2023-08-29,1호선,서울역,54380,50394,104774,8
2023-08-29,2호선,잠실(송파구청),73336,73592,146928,8
2023-08-30,신림선,신림,1843,2553,4396,8
2023-08-30,분당선,선릉,15101,23040,38141,8
2023-08-30,공항철도 1호선,홍대입구,13337,13396,26733,8
2023-08-30,공항철도 1호선,서울역,12768,11155,23923,8
2023-08-30,경의선,홍대입구,1900,2381,4281,8
2023-08-30,경의선,서울역,5049,6393,11442,8
2023-08-30,경부선,가산디지털단지,18585,21166,39751,8
2023-08-30,경부선,서울역,8482,2854,11336,8
2023-08-30,9호선,고속터미널,13999,18440,32439,8
2023-08-30,8호선,잠실(송파구청),16597,18721,35318,8
2023-08-30,7호선,가산디지털단지,50916,50629,101545,8
2023-08-30,7호선,고속터미널,16928,14811,31739,8
2023-08-30,4호선,사당,27458,24351,51809,8
2023-08-30,4호선,서울역,14396,22243,36639,8
2023-08-30,3호선,고속터미널,43320,40225,83545,8
2023-08-30,2호선,홍대입구,63759,68681,132440,8
2023-08-30,2호선,구로디지털단지,63398,62766,126164,8
2023-08-30,2호선,신림,57627,54758,112385,8
2023-08-30,2호선,사당,40991,44771,85762,8
2023-08-30,2호선,강남,86204,82167,168371,8
2023-08-30,2호선,선릉,65650,57541,123191,8
2023-08-30,2호선,잠실(송파구청),77735,77454,155189,8
2023-08-30,1호선,서울역,55750,52073,107823,8
2023-08-31,신림선,신림,1829,2651,4480,8
2023-08-31,1호선,서울역,56177,52340,108517,8
2023-08-31,2호선,잠실(송파구청),78698,78536,157234,8
2023-08-31,2호선,선릉,65787,58376,124163,8
2023-08-31,2호선,강남,86876,83806,170682,8
2023-08-31,2호선,사당,42157,46204,88361,8
2023-08-31,2호선,신림,58087,54910,112997,8
2023-08-31,2호선,구로디지털단지,64255,63958,128213,8
2023-08-31,2호선,홍대입구,64911,70566,135477,8
2023-08-31,3호선,고속터미널,45802,42098,87900,8
2023-08-31,4호선,서울역,13996,21853,35849,8
2023-08-31,4호선,사당,28438,24471,52909,8
2023-08-31,7호선,고속터미널,17179,14895,32074,8
2023-08-31,7호선,가산디지털단지,50056,50823,100879,8
2023-08-31,8호선,잠실(송파구청),16073,18773,34846,8
2023-08-31,9호선,고속터미널,14535,19248,33783,8
2023-08-31,경부선,서울역,8490,2911,11401,8
2023-08-31,경부선,가산디지털단지,18809,21262,40071,8
2023-08-31,경의선,서울역,5172,6390,11562,8
2023-08-31,경의선,홍대입구,1981,2464,4445,8
2023-08-31,공항철도 1호선,서울역,12959,11722,24681,8
2023-08-31,공항철도 1호선,홍대입구,13675,13674,27349,8
2023-08-31,분당선,선릉,15038,23024,38062,8
2023-09-01,9호선,고속터미널,17237,23837,41074,9
2023-09-01,경부선,서울역,10610,3713,14323,9
2023-09-01,경부선,가산디지털단지,18829,21365,40194,9
2023-09-01,경의선,서울역,5436,6701,12137,9
2023-09-01,경의선,홍대입구,2331,2971,5302,9
2023-09-01,공항철도 1호선,서울역,15498,13257,28755,9
2023-09-01,공항철도 1호선,홍대입구,14656,15425,30081,9
2023-09-01,분당선,선릉,14901,22774,37675,9
2023-09-01,7호선,가산디지털단지,50109,50104,100213,9
2023-09-01,7호선,고속터미널,20150,16208,36358,9
2023-09-01,2호선,선릉,64125,56615,120740,9
2023-09-01,4호선,사당,30321,26799,57120,9
2023-09-01,4호선,서울역,14404,24185,38589,9
2023-09-01,3호선,고속터미널,53978,53382,107360,9
2023-09-01,2호선,홍대입구,71723,81971,153694,9
2023-09-01,2호선,구로디지털단지,65035,64566,129601,9
2023-09-01,2호선,신림,60036,56297,116333,9
2023-09-01,2호선,사당,44862,49501,94363,9
2023-09-01,2호선,강남,89775,88434,178209,9
2023-09-01,2호선,잠실(송파구청),82980,83296,166276,9
2023-09-01,1호선,서울역,61380,58750,120130,9
2023-09-01,8호선,잠실(송파구청),16806,19947,36753,9
2023-09-01,신림선,신림,1901,2640,4541,9
2023-09-02,신림선,신림,1423,2015,3438,9
2023-09-02,1호선,서울역,46631,45660,92291,9
2023-09-02,2호선,잠실(송파구청),75131,72864,147995,9
2023-09-02,2호선,선릉,28318,24845,53163,9
2023-09-02,2호선,강남,61186,59872,121058,9
2023-09-02,2호선,사당,37334,42165,79499,9
2023-09-02,2호선,신림,47002,43942,90944,9
2023-09-02,2호선,구로디지털단지,38139,37155,75294,9
2023-09-02,2호선,홍대입구,79471,92453,171924,9
2023-09-02,3호선,고속터미널,58839,55832,114671,9
2023-09-02,4호선,서울역,8137,18891,27028,9
2023-09-02,4호선,사당,25960,23918,49878,9
2023-09-02,7호선,고속터미널,17629,13266,30895,9
2023-09-02,7호선,가산디지털단지,14559,13417,27976,9
2023-09-02,8호선,잠실(송파구청),14984,17536,32520,9
2023-09-02,9호선,고속터미널,17636,26381,44017,9
2023-09-02,경부선,서울역,11074,3137,14211,9
2023-09-02,경부선,가산디지털단지,6661,8261,14922,9
2023-09-02,경의선,서울역,1647,1836,3483,9
2023-09-02,경의선,홍대입구,2540,3248,5788,9
2023-09-02,공항철도 1호선,서울역,13670,13299,26969,9
2023-09-02,공항철도 1호선,홍대입구,17452,17467,34919,9
2023-09-02,분당선,선릉,6032,9315,15347,9
2023-09-03,1호선,서울역,35828,34248,70076,9
2023-09-03,2호선,잠실(송파구청),53931,49842,103773,9
2023-09-03,2호선,선릉,15493,12979,28472,9
2023-09-03,2호선,강남,34732,32836,67568,9
2023-09-03,2호선,사당,24482,26390,50872,9
2023-09-03,2호선,신림,34795,33753,68548,9
2023-09-03,2호선,구로디지털단지,27280,26432,53712,9
2023-09-03,2호선,홍대입구,59056,59605,118661,9
2023-09-03,3호선,고속터미널,47894,43659,91553,9
2023-09-03,4호선,서울역,5805,15336,21141,9
2023-09-03,4호선,사당,16669,16558,33227,9
2023-09-03,7호선,고속터미널,14431,9673,24104,9
2023-09-03,7호선,가산디지털단지,10079,9605,19684,9
2023-09-03,8호선,잠실(송파구청),11294,12635,23929,9
2023-09-03,9호선,고속터미널,13714,20662,34376,9
2023-09-03,경부선,서울역,10229,2884,13113,9
2023-09-03,경부선,가산디지털단지,4996,6471,11467,9
2023-09-03,경의선,서울역,1365,1249,2614,9
2023-09-03,경의선,홍대입구,2054,2455,4509,9
2023-09-03,공항철도 1호선,서울역,13586,12385,25971,9
2023-09-03,공항철도 1호선,홍대입구,13968,12776,26744,9
2023-09-03,분당선,선릉,3171,4907,8078,9
2023-09-03,신림선,신림,1139,1516,2655,9
2023-09-04,신림선,신림,1889,2592,4481,9
2023-09-04,분당선,선릉,15195,23039,38234,9
2023-09-04,공항철도 1호선,홍대입구,12570,12153,24723,9
2023-09-04,공항철도 1호선,서울역,12355,11023,23378,9
2023-09-04,경의선,홍대입구,1979,2268,4247,9
2023-09-04,경의선,서울역,5360,6734,12094,9
2023-09-04,경부선,가산디지털단지,19023,21431,40454,9
2023-09-04,경부선,서울역,8564,2766,11330,9
2023-09-04,9호선,고속터미널,14078,19162,33240,9
2023-09-04,8호선,잠실(송파구청),15240,17643,32883,9
2023-09-04,7호선,가산디지털단지,50829,51424,102253,9
2023-09-04,7호선,고속터미널,17410,14735,32145,9
2023-09-04,4호선,사당,22930,23716,46646,9
2023-09-04,4호선,서울역,13370,20655,34025,9
2023-09-04,3호선,고속터미널,42679,39920,82599,9
2023-09-04,2호선,홍대입구,62042,65456,127498,9
2023-09-04,2호선,구로디지털단지,62814,62712,125526,9
2023-09-04,2호선,신림,56540,53722,110262,9
2023-09-04,2호선,사당,44074,43469,87543,9
2023-09-04,2호선,강남,84797,81538,166335,9
2023-09-04,2호선,선릉,64841,56993,121834,9
2023-09-04,2호선,잠실(송파구청),72379,72659,145038,9
2023-09-04,1호선,서울역,53446,50884,104330,9
2023-09-05,8호선,잠실(송파구청),16399,18679,35078,9
2023-09-05,9호선,고속터미널,14086,18313,32399,9
2023-09-05,경부선,서울역,7659,2518,10177,9
2023-09-05,경부선,가산디지털단지,19102,21751,40853,9
2023-09-05,경의선,서울역,5354,6699,12053,9
2023-09-05,경의선,홍대입구,2032,2354,4386,9
2023-09-05,공항철도 1호선,서울역,12175,10423,22598,9
2023-09-05,공항철도 1호선,홍대입구,12544,12418,24962,9
2023-09-05,분당선,선릉,15803,23567,39370,9
2023-09-05,신림선,신림,1884,2617,4501,9
2023-09-05,2호선,잠실(송파구청),77702,78062,155764,9
2023-09-05,1호선,서울역,54615,51483,106098,9
2023-09-05,2호선,선릉,66529,58444,124973,9
2023-09-05,2호선,강남,86917,83653,170570,9
2023-09-05,2호선,사당,42296,46316,88612,9
2023-09-05,2호선,신림,57680,54985,112665,9
2023-09-05,2호선,구로디지털단지,64297,63870,128167,9
2023-09-05,2호선,홍대입구,64013,66841,130854,9
2023-09-05,3호선,고속터미널,43294,40174,83468,9
2023-09-05,4호선,서울역,14099,21094,35193,9
2023-09-05,4호선,사당,28551,24807,53358,9
2023-09-05,7호선,고속터미널,16709,14936,31645,9
2023-09-05,7호선,가산디지털단지,51513,51834,103347,9
2023-09-06,9호선,고속터미널,14539,18844,33383,9
2023-09-06,8호선,잠실(송파구청),16233,19243,35476,9
2023-09-06,7호선,가산디지털단지,50760,51571,102331,9
2023-09-06,7호선,고속터미널,16542,14716,31258,9
2023-09-06,4호선,서울역,14213,21956,36169,9
2023-09-06,분당선,선릉,15402,23606,39008,9
2023-09-06,4호선,사당,28857,25316,54173,9
2023-09-06,2호선,잠실(송파구청),80127,80388,160515,9
2023-09-06,2호선,선릉,66575,58041,124616,9
2023-09-06,공항철도 1호선,홍대입구,12862,12857,25719,9
2023-09-06,공항철도 1호선,서울역,12192,10704,22896,9
2023-09-06,1호선,서울역,54965,51861,106826,9
2023-09-06,3호선,고속터미널,44023,40400,84423,9
2023-09-06,경부선,서울역,7790,2608,10398,9
2023-09-06,경부선,가산디지털단지,18978,21514,40492,9
2023-09-06,2호선,강남,87262,83325,170587,9
2023-09-06,2호선,사당,42735,46698,89433,9
2023-09-06,2호선,신림,58792,55958,114750,9
2023-09-06,2호선,구로디지털단지,64428,64159,128587,9
2023-09-06,신림선,신림,1959,2634,4593,9
2023-09-06,2호선,홍대입구,64937,68820,133757,9
2023-09-06,경의선,홍대입구,2028,2384,4412,9
2023-09-06,경의선,서울역,5331,6664,11995,9
2023-09-07,2호선,홍대입구,65767,70385,136152,9
2023-09-07,4호선,서울역,14472,22511,36983,9
2023-09-07,4호선,사당,27271,25768,53039,9
2023-09-07,7호선,고속터미널,17224,15125,32349,9
2023-09-07,7호선,가산디지털단지,50910,51576,102486,9
2023-09-07,8호선,잠실(송파구청),16150,19093,35243,9
2023-09-07,9호선,고속터미널,15352,19399,34751,9
2023-09-07,경부선,서울역,8439,2830,11269,9
2023-09-07,경부선,가산디지털단지,18890,21540,40430,9
2023-09-07,경의선,서울역,5435,6902,12337,9
2023-09-07,경의선,홍대입구,2006,2394,4400,9
2023-09-07,공항철도 1호선,서울역,13195,11073,24268,9
2023-09-07,공항철도 1호선,홍대입구,13034,13228,26262,9
2023-09-07,분당선,선릉,15572,23862,39434,9
2023-09-07,신림선,신림,1886,2654,4540,9
2023-09-07,3호선,고속터미널,46116,41955,88071,9
2023-09-07,1호선,서울역,55807,52934,108741,9
2023-09-07,2호선,잠실(송파구청),79499,80417,159916,9
2023-09-07,2호선,선릉,67514,59315,126829,9
2023-09-07,2호선,강남,88495,84845,173340,9
2023-09-07,2호선,사당,45889,48045,93934,9
2023-09-07,2호선,신림,58757,56065,114822,9
2023-09-07,2호선,구로디지털단지,64765,64435,129200,9
2023-09-08,경부선,가산디지털단지,19152,21660,40812,9
2023-09-08,경의선,서울역,5731,6976,12707,9
2023-09-08,경의선,홍대입구,2206,2934,5140,9
2023-09-08,3호선,고속터미널,55734,55134,110868,9
2023-09-08,공항철도 1호선,서울역,15419,13780,29199,9
2023-09-08,공항철도 1호선,홍대입구,14945,15465,30410,9
2023-09-08,분당선,선릉,15092,23344,38436,9
2023-09-08,신림선,신림,1957,2719,4676,9
2023-09-08,7호선,고속터미널,20044,16458,36502,9
2023-09-08,7호선,가산디지털단지,50718,50577,101295,9
2023-09-08,8호선,잠실(송파구청),16924,19997,36921,9
2023-09-08,4호선,사당,31152,27741,58893,9
2023-09-08,4호선,서울역,14876,25214,40090,9
2023-09-08,9호선,고속터미널,18078,24504,42582,9
2023-09-08,경부선,서울역,11291,3848,15139,9
2023-09-08,2호선,홍대입구,72856,83579,156435,9
2023-09-08,1호선,서울역,61807,60124,121931,9
2023-09-08,2호선,잠실(송파구청),83951,85112,169063,9
2023-09-08,2호선,선릉,65771,57806,123577,9
2023-09-08,2호선,강남,92708,90409,183117,9
2023-09-08,2호선,사당,46273,51403,97676,9
2023-09-08,2호선,신림,60895,57862,118757,9
2023-09-08,2호선,구로디지털단지,66033,65356,131389,9
2023-09-09,1호선,서울역,46174,44443,90617,9
2023-09-09,2호선,잠실(송파구청),77725,74855,152580,9
2023-09-09,2호선,선릉,29834,25795,55629,9
2023-09-09,2호선,사당,39305,44429,83734,9
2023-09-09,2호선,신림,48315,45112,93427,9
2023-09-09,2호선,구로디지털단지,39025,37638,76663,9
2023-09-09,2호선,홍대입구,82810,96089,178899,9
2023-09-09,3호선,고속터미널,60525,57118,117643,9
2023-09-09,4호선,서울역,7819,19187,27006,9
2023-09-09,4호선,사당,26644,24459,51103,9
2023-09-09,7호선,고속터미널,17828,13699,31527,9
2023-09-09,7호선,가산디지털단지,14883,13556,28439,9
2023-09-09,8호선,잠실(송파구청),15136,17834,32970,9
2023-09-09,9호선,고속터미널,18261,26810,45071,9
2023-09-09,경부선,서울역,10978,3371,14349,9
2023-09-09,경부선,가산디지털단지,6929,8698,15627,9
2023-09-09,경의선,서울역,1738,1865,3603,9
2023-09-09,경의선,홍대입구,2559,3634,6193,9
2023-09-09,공항철도 1호선,서울역,14035,13364,27399,9
2023-09-09,공항철도 1호선,홍대입구,17971,18117,36088,9
2023-09-09,분당선,선릉,5998,9572,15570,9
2023-09-09,신림선,신림,1359,2012,3371,9
2023-09-09,2호선,강남,63600,62548,126148,9
2023-09-10,신림선,신림,1183,1717,2900,9
2023-09-10,1호선,서울역,35190,34633,69823,9
2023-09-10,7호선,고속터미널,15685,10322,26007,9
2023-09-10,7호선,가산디지털단지,10934,10355,21289,9
2023-09-10,8호선,잠실(송파구청),11337,12470,23807,9
2023-09-10,9호선,고속터미널,15233,22217,37450,9
2023-09-10,경부선,서울역,10916,2796,13712,9
2023-09-10,경부선,가산디지털단지,5318,6845,12163,9
2023-09-10,4호선,사당,18744,17982,36726,9
2023-09-10,4호선,서울역,5895,15037,20932,9
2023-09-10,분당선,선릉,3197,4908,8105,9
2023-09-10,공항철도 1호선,홍대입구,14653,13315,27968,9
2023-09-10,공항철도 1호선,서울역,13666,12497,26163,9
2023-09-10,3호선,고속터미널,51026,46732,97758,9
2023-09-10,경의선,서울역,1359,1183,2542,9
2023-09-10,경의선,홍대입구,2038,2457,4495,9
2023-09-10,2호선,잠실(송파구청),54936,51472,106408,9
2023-09-10,2호선,선릉,16238,13414,29652,9
2023-09-10,2호선,강남,36749,34566,71315,9
2023-09-10,2호선,홍대입구,64830,64094,128924,9
2023-09-10,2호선,구로디지털단지,27979,26663,54642,9
2023-09-10,2호선,신림,35451,34427,69878,9
2023-09-10,2호선,사당,26306,29260,55566,9
2023-09-11,2호선,홍대입구,62113,65556,127669,9
2023-09-11,1호선,서울역,54614,52209,106823,9
2023-09-11,2호선,잠실(송파구청),73242,74027,147269,9
2023-09-11,2호선,선릉,65060,57712,122772,9
2023-09-11,2호선,강남,84662,81275,165937,9
2023-09-11,2호선,사당,40576,44162,84738,9
2023-09-11,2호선,신림,56712,54362,111074,9
2023-09-11,2호선,구로디지털단지,63255,62912,126167,9
2023-09-11,3호선,고속터미널,44033,41183,85216,9
2023-09-11,4호선,서울역,13743,21274,35017,9
2023-09-11,4호선,사당,27355,24141,51496,9
2023-09-11,7호선,고속터미널,17291,14861,32152,9
2023-09-11,7호선,가산디지털단지,50959,51523,102482,9
2023-09-11,8호선,잠실(송파구청),15279,18029,33308,9
2023-09-11,9호선,고속터미널,14301,19042,33343,9
2023-09-11,경부선,서울역,8556,2893,11449,9
2023-09-11,경부선,가산디지털단지,18997,21647,40644,9
2023-09-11,경의선,서울역,5445,6960,12405,9
2023-09-11,경의선,홍대입구,2049,2325,4374,9
2023-09-11,공항철도 1호선,서울역,13587,11746,25333,9
2023-09-11,공항철도 1호선,홍대입구,12678,12311,24989,9
2023-09-11,분당선,선릉,15175,23241,38416,9
2023-09-11,신림선,신림,1883,2549,4432,9
2023-09-12,신림선,신림,1870,2623,4493,9
2023-09-12,분당선,선릉,15566,23611,39177,9
2023-09-12,공항철도 1호선,홍대입구,12800,12545,25345,9
2023-09-12,공항철도 1호선,서울역,12227,10558,22785,9
2023-09-12,경의선,홍대입구,2124,2490,4614,9
2023-09-12,경의선,서울역,5500,6914,12414,9
2023-09-12,경부선,가산디지털단지,19628,21951,41579,9
2023-09-12,경부선,서울역,7813,2626,10439,9
2023-09-12,9호선,고속터미널,14363,18423,32786,9
2023-09-12,8호선,잠실(송파구청),15730,18225,33955,9
2023-09-12,7호선,가산디지털단지,50670,51511,102181,9
2023-09-12,7호선,고속터미널,17001,15059,32060,9
2023-09-12,4호선,사당,28620,25444,54064,9
2023-09-12,4호선,서울역,14270,21104,35374,9
2023-09-12,3호선,고속터미널,43527,40121,83648,9
2023-09-12,2호선,홍대입구,64660,67882,132542,9
2023-09-12,2호선,구로디지털단지,64159,63628,127787,9
2023-09-12,2호선,신림,58181,55381,113562,9
2023-09-12,2호선,사당,43420,46720,90140,9
2023-09-12,2호선,강남,87049,83438,170487,9
2023-09-12,2호선,선릉,66611,58732,125343,9
2023-09-12,2호선,잠실(송파구청),77205,77759,154964,9
2023-09-12,1호선,서울역,54309,51850,106159,9
2023-09-13,1호선,서울역,56370,53252,109622,9
2023-09-13,2호선,잠실(송파구청),76645,77001,153646,9
2023-09-13,2호선,선릉,65956,57751,123707,9
2023-09-13,2호선,강남,85912,81797,167709,9
2023-09-13,2호선,사당,42919,46707,89626,9
2023-09-13,2호선,신림,58146,55630,113776,9
2023-09-13,2호선,구로디지털단지,63932,62941,126873,9
2023-09-13,2호선,홍대입구,64492,68911,133403,9
2023-09-13,3호선,고속터미널,44796,40471,85267,9
2023-09-13,4호선,서울역,14823,22504,37327,9
2023-09-13,4호선,사당,29349,26402,55751,9
2023-09-13,7호선,고속터미널,17165,15087,32252,9
2023-09-13,7호선,가산디지털단지,51346,50916,102262,9
2023-09-13,8호선,잠실(송파구청),16452,18671,35123,9
2023-09-13,9호선,고속터미널,14075,18471,32546,9
2023-09-13,경부선,서울역,8131,2762,10893,9
2023-09-13,경부선,가산디지털단지,18735,21623,40358,9
2023-09-13,경의선,서울역,5451,6844,12295,9
2023-09-13,경의선,홍대입구,2021,2583,4604,9
2023-09-13,공항철도 1호선,서울역,12877,10942,23819,9
2023-09-13,공항철도 1호선,홍대입구,12382,12820,25202,9
2023-09-13,분당선,선릉,15595,23494,39089,9
2023-09-13,신림선,신림,1858,2719,4577,9
2023-09-14,2호선,홍대입구,69790,77159,146949,9
2023-09-14,1호선,서울역,57730,54098,111828,9
2023-09-14,2호선,잠실(송파구청),78625,79469,158094,9
2023-09-14,3호선,고속터미널,47970,43161,91131,9
2023-09-14,4호선,서울역,14960,22800,37760,9
2023-09-14,4호선,사당,30342,27699,58041,9
2023-09-14,7호선,고속터미널,18262,15342,33604,9
2023-09-14,7호선,가산디지털단지,50251,51446,101697,9
2023-09-14,8호선,잠실(송파구청),15793,18751,34544,9
2023-09-14,9호선,고속터미널,15758,20072,35830,9
2023-09-14,경부선,서울역,7592,2597,10189,9
2023-09-14,경부선,가산디지털단지,19273,21964,41237,9
2023-09-14,경의선,서울역,5037,6771,11808,9
2023-09-14,경의선,홍대입구,2100,2838,4938,9
2023-09-14,공항철도 1호선,서울역,13591,11515,25106,9
2023-09-14,공항철도 1호선,홍대입구,13497,14118,27615,9
2023-09-14,분당선,선릉,14890,23968,38858,9
2023-09-14,신림선,신림,1873,2654,4527,9
2023-09-14,2호선,선릉,66562,59208,125770,9
2023-09-14,2호선,강남,87750,84524,172274,9
2023-09-14,2호선,사당,45028,49419,94447,9
2023-09-14,2호선,신림,59243,55955,115198,9
2023-09-14,2호선,구로디지털단지,64758,64391,129149,9
2023-09-15,신림선,신림,1879,2601,4480,9
2023-09-15,분당선,선릉,13938,23114,37052,9
2023-09-15,공항철도 1호선,홍대입구,14779,15761,30540,9
2023-09-15,공항철도 1호선,서울역,15187,13009,28196,9
2023-09-15,경의선,홍대입구,2139,2935,5074,9
2023-09-15,경의선,서울역,4421,5900,10321,9
2023-09-15,경부선,가산디지털단지,18548,21057,39605,9
2023-09-15,경부선,서울역,9316,3262,12578,9
2023-09-15,9호선,고속터미널,17980,24743,42723,9
2023-09-15,8호선,잠실(송파구청),16622,19868,36490,9
2023-09-15,7호선,가산디지털단지,49709,50049,99758,9
2023-09-15,7호선,고속터미널,22108,16921,39029,9
2023-09-15,4호선,사당,31316,27913,59229,9
2023-09-15,4호선,서울역,14895,23334,38229,9
2023-09-15,3호선,고속터미널,57157,56351,113508,9
2023-09-15,2호선,홍대입구,76495,90355,166850,9
2023-09-15,2호선,구로디지털단지,64795,64104,128899,9
2023-09-15,2호선,신림,60069,56737,116806,9
2023-09-15,2호선,사당,46236,51141,97377,9
2023-09-15,2호선,강남,91056,89249,180305,9
2023-09-15,2호선,선릉,65054,57673,122727,9
2023-09-15,2호선,잠실(송파구청),82715,84504,167219,9
2023-09-15,1호선,서울역,58324,55170,113494,9
2023-09-16,1호선,서울역,43595,41481,85076,9
2023-09-16,2호선,잠실(송파구청),75282,72412,147694,9
2023-09-16,2호선,선릉,30101,26636,56737,9
2023-09-16,2호선,강남,64910,62662,127572,9
2023-09-16,2호선,사당,39208,43292,82500,9
2023-09-16,2호선,신림,47505,44846,92351,9
2023-09-16,2호선,구로디지털단지,38674,37969,76643,9
2023-09-16,2호선,홍대입구,83054,92664,175718,9
2023-09-16,3호선,고속터미널,60872,58567,119439,9
2023-09-16,4호선,서울역,8214,17860,26074,9
2023-09-16,4호선,사당,26240,24459,50699,9
2023-09-16,7호선,고속터미널,19596,14133,33729,9
2023-09-16,7호선,가산디지털단지,15239,14172,29411,9
2023-09-16,8호선,잠실(송파구청),15421,17808,33229,9
2023-09-16,9호선,고속터미널,17635,26714,44349,9
2023-09-16,경부선,서울역,8914,2780,11694,9
2023-09-16,경부선,가산디지털단지,7185,9267,16452,9
2023-09-16,경의선,서울역,1335,1460,2795,9
2023-09-16,경의선,홍대입구,2177,3045,5222,9
2023-09-16,공항철도 1호선,서울역,13670,12456,26126,9
2023-09-16,공항철도 1호선,홍대입구,17224,17507,34731,9
2023-09-16,분당선,선릉,5571,9633,15204,9
2023-09-16,신림선,신림,1476,2062,3538,9
2023-09-17,1호선,서울역,33001,32418,65419,9
2023-09-17,2호선,잠실(송파구청),57312,52943,110255,9
2023-09-17,2호선,선릉,16750,14588,31338,9
2023-09-17,2호선,강남,37199,34921,72120,9
2023-09-17,2호선,사당,25912,28493,54405,9
2023-09-17,2호선,신림,35553,33855,69408,9
2023-09-17,2호선,구로디지털단지,28621,27444,56065,9
2023-09-17,2호선,홍대입구,64154,64615,128769,9
2023-09-17,3호선,고속터미널,52957,47673,100630,9
2023-09-17,4호선,서울역,5953,13952,19905,9
2023-09-17,4호선,사당,17984,17003,34987,9
2023-09-17,7호선,고속터미널,16519,10228,26747,9
2023-09-17,7호선,가산디지털단지,10881,10408,21289,9
2023-09-17,8호선,잠실(송파구청),11827,13042,24869,9
2023-09-17,9호선,고속터미널,14951,22340,37291,9
2023-09-17,경부선,서울역,8082,2337,10419,9
2023-09-17,경부선,가산디지털단지,5568,7139,12707,9
2023-09-17,경의선,서울역,1093,1168,2261,9
2023-09-17,경의선,홍대입구,1838,2247,4085,9
2023-09-17,공항철도 1호선,서울역,12929,11618,24547,9
2023-09-17,공항철도 1호선,홍대입구,13848,12615,26463,9
2023-09-17,분당선,선릉,3276,5261,8537,9
2023-09-17,신림선,신림,1138,1600,2738,9
2023-09-18,1호선,서울역,54534,51928,106462,9
2023-09-18,2호선,잠실(송파구청),74925,75089,150014,9
2023-09-18,2호선,선릉,65514,57959,123473,9
2023-09-18,2호선,강남,85743,82168,167911,9
2023-09-18,2호선,사당,41090,45037,86127,9
2023-09-18,2호선,신림,57090,54218,111308,9
2023-09-18,2호선,구로디지털단지,63649,62941,126590,9
2023-09-18,2호선,홍대입구,63176,66215,129391,9
2023-09-18,3호선,고속터미널,44957,42749,87706,9
2023-09-18,4호선,서울역,14131,21692,35823,9
2023-09-18,4호선,사당,27519,24328,51847,9
2023-09-18,7호선,고속터미널,18137,15588,33725,9
2023-09-18,7호선,가산디지털단지,50812,51578,102390,9
2023-09-18,8호선,잠실(송파구청),15145,17770,32915,9
2023-09-18,9호선,고속터미널,14721,19756,34477,9
2023-09-18,경부선,서울역,8453,2782,11235,9
2023-09-18,경부선,가산디지털단지,19006,21441,40447,9
2023-09-18,경의선,서울역,4634,6137,10771,9
2023-09-18,경의선,홍대입구,1928,2289,4217,9
2023-09-18,공항철도 1호선,서울역,13559,12417,25976,9
2023-09-18,공항철도 1호선,홍대입구,12999,12579,25578,9
2023-09-18,분당선,선릉,14728,22812,37540,9
2023-09-18,신림선,신림,1873,2668,4541,9
2023-09-19,신림선,신림,1910,2549,4459,9
2023-09-19,분당선,선릉,15282,23581,38863,9
2023-09-19,공항철도 1호선,홍대입구,12521,12422,24943,9
2023-09-19,공항철도 1호선,서울역,12776,11093,23869,9
2023-09-19,경의선,홍대입구,1970,2250,4220,9
2023-09-19,경의선,서울역,5347,6695,12042,9
2023-09-19,경부선,가산디지털단지,19462,22009,41471,9
2023-09-19,경부선,서울역,7912,2580,10492,9
2023-09-19,9호선,고속터미널,14572,18677,33249,9
2023-09-19,8호선,잠실(송파구청),15390,18095,33485,9
2023-09-19,7호선,가산디지털단지,51083,51963,103046,9
2023-09-19,7호선,고속터미널,17235,15362,32597,9
2023-09-19,4호선,사당,28886,25283,54169,9
2023-09-19,4호선,서울역,14643,21983,36626,9
2023-09-19,3호선,고속터미널,44000,41125,85125,9
2023-09-19,2호선,홍대입구,63934,66985,130919,9
2023-09-19,2호선,구로디지털단지,64577,63998,128575,9
2023-09-19,2호선,신림,58264,55878,114142,9
2023-09-19,2호선,사당,43544,47052,90596,9
2023-09-19,2호선,강남,87505,83925,171430,9
2023-09-19,2호선,선릉,67073,58974,126047,9
2023-09-19,2호선,잠실(송파구청),76328,76342,152670,9
2023-09-19,1호선,서울역,54560,52374,106934,9
2023-09-20,신림선,신림,1877,2654,4531,9
2023-09-20,분당선,선릉,15279,23530,38809,9
2023-09-20,공항철도 1호선,홍대입구,11836,11910,23746,9
2023-09-20,공항철도 1호선,서울역,12405,10669,23074,9
2023-09-20,경의선,홍대입구,1851,2284,4135,9
2023-09-20,경의선,서울역,5032,6455,11487,9
2023-09-20,경부선,가산디지털단지,18483,21447,39930,9
2023-09-20,경부선,서울역,7993,2765,10758,9
2023-09-20,9호선,고속터미널,13980,18162,32142,9
2023-09-20,8호선,잠실(송파구청),16232,18988,35220,9
2023-09-20,7호선,가산디지털단지,51017,51173,102190,9
2023-09-20,7호선,고속터미널,16608,14320,30928,9
2023-09-20,4호선,사당,28062,25020,53082,9
2023-09-20,4호선,서울역,14732,22385,37117,9
2023-09-20,3호선,고속터미널,44231,40411,84642,9
2023-09-20,2호선,홍대입구,60229,63751,123980,9
2023-09-20,2호선,구로디지털단지,62841,62510,125351,9
2023-09-20,2호선,신림,57473,54397,111870,9
2023-09-20,2호선,사당,41874,45386,87260,9
2023-09-20,2호선,강남,85344,82019,167363,9
2023-09-20,2호선,선릉,65508,57786,123294,9
2023-09-20,2호선,잠실(송파구청),75976,76946,152922,9
2023-09-20,1호선,서울역,56263,52962,109225,9
2023-09-21,신림선,신림,1938,2525,4463,9
2023-09-21,1호선,서울역,57207,54340,111547,9
2023-09-21,2호선,잠실(송파구청),78948,80091,159039,9
2023-09-21,2호선,선릉,66998,59389,126387,9
2023-09-21,2호선,강남,88734,84841,173575,9
2023-09-21,2호선,사당,44196,48645,92841,9
2023-09-21,2호선,신림,59193,56251,115444,9
2023-09-21,2호선,구로디지털단지,65236,64937,130173,9
2023-09-21,2호선,홍대입구,66328,71314,137642,9
2023-09-21,3호선,고속터미널,46244,42312,88556,9
2023-09-21,4호선,서울역,14538,22517,37055,9
2023-09-21,4호선,사당,29491,26080,55571,9
2023-09-21,7호선,고속터미널,17323,14963,32286,9
2023-09-21,7호선,가산디지털단지,50593,51725,102318,9
2023-09-21,8호선,잠실(송파구청),16055,18830,34885,9
2023-09-21,9호선,고속터미널,15383,19444,34827,9
2023-09-21,경부선,서울역,8304,2811,11115,9
2023-09-21,경부선,가산디지털단지,19560,22284,41844,9
2023-09-21,경의선,서울역,5358,6898,12256,9
2023-09-21,경의선,홍대입구,2149,2520,4669,9
2023-09-21,공항철도 1호선,서울역,13520,11308,24828,9
2023-09-21,공항철도 1호선,홍대입구,13065,13407,26472,9
2023-09-21,분당선,선릉,15164,23529,38693,9
2023-09-22,9호선,고속터미널,18405,24583,42988,9
2023-09-22,8호선,잠실(송파구청),16634,20410,37044,9
2023-09-22,7호선,가산디지털단지,50200,50892,101092,9
2023-09-22,7호선,고속터미널,20237,16358,36595,9
2023-09-22,4호선,사당,31452,28530,59982,9
2023-09-22,4호선,서울역,14906,24947,39853,9
2023-09-22,3호선,고속터미널,56381,52798,109179,9
2023-09-22,2호선,홍대입구,74105,84668,158773,9
2023-09-22,2호선,구로디지털단지,66434,65598,132032,9
2023-09-22,2호선,신림,61330,58357,119687,9
2023-09-22,2호선,사당,46592,51602,98194,9
2023-09-22,2호선,강남,93236,91978,185214,9
2023-09-22,2호선,선릉,66291,58462,124753,9
2023-09-22,2호선,잠실(송파구청),87055,87863,174918,9
2023-09-22,1호선,서울역,63033,58863,121896,9
2023-09-22,경부선,서울역,10581,3694,14275,9
2023-09-22,경부선,가산디지털단지,19970,22208,42178,9
2023-09-22,경의선,서울역,5310,6699,12009,9
2023-09-22,경의선,홍대입구,2468,3115,5583,9
2023-09-22,공항철도 1호선,서울역,15593,13539,29132,9
2023-09-22,공항철도 1호선,홍대입구,15365,16354,31719,9
2023-09-22,분당선,선릉,15107,23633,38740,9
2023-09-22,신림선,신림,1902,2605,4507,9
2023-09-23,경부선,가산디지털단지,7356,9127,16483,9
2023-09-23,경부선,서울역,10437,3207,13644,9
2023-09-23,4호선,사당,25316,23363,48679,9
2023-09-23,4호선,서울역,8778,20125,28903,9
2023-09-23,3호선,고속터미널,60732,56533,117265,9
2023-09-23,2호선,홍대입구,80659,93668,174327,9
2023-09-23,2호선,구로디지털단지,39206,37995,77201,9
2023-09-23,2호선,신림,48104,44704,92808,9
2023-09-23,2호선,사당,37114,41332,78446,9
2023-09-23,2호선,강남,62307,61762,124069,9
2023-09-23,2호선,선릉,29360,25808,55168,9
2023-09-23,2호선,잠실(송파구청),75947,72721,148668,9
2023-09-23,1호선,서울역,47627,46274,93901,9
2023-09-23,9호선,고속터미널,19123,27093,46216,9
2023-09-23,8호선,잠실(송파구청),15014,17385,32399,9
2023-09-23,7호선,가산디지털단지,15271,13934,29205,9
2023-09-23,7호선,고속터미널,17947,13824,31771,9
2023-09-23,신림선,신림,1380,1988,3368,9
2023-09-23,분당선,선릉,6029,9467,15496,9
2023-09-23,공항철도 1호선,홍대입구,18179,18107,36286,9
2023-09-23,공항철도 1호선,서울역,14329,13766,28095,9
2023-09-23,경의선,홍대입구,2557,3619,6176,9
2023-09-23,경의선,서울역,1870,1961,3831,9
2023-09-24,1호선,서울역,33956,33669,67625,9
2023-09-24,2호선,잠실(송파구청),54959,51144,106103,9
2023-09-24,2호선,선릉,16062,13573,29635,9
2023-09-24,2호선,강남,35890,34247,70137,9
2023-09-24,2호선,사당,25433,28054,53487,9
2023-09-24,2호선,신림,36146,34604,70750,9
2023-09-24,2호선,구로디지털단지,27905,26592,54497,9
2023-09-24,2호선,홍대입구,61522,60989,122511,9
2023-09-24,3호선,고속터미널,47771,45612,93383,9
2023-09-24,4호선,서울역,5854,15134,20988,9
2023-09-24,4호선,사당,17805,16998,34803,9
2023-09-24,7호선,고속터미널,13183,9825,23008,9
2023-09-24,7호선,가산디지털단지,11065,10529,21594,9
2023-09-24,8호선,잠실(송파구청),11331,12695,24026,9
2023-09-24,9호선,고속터미널,14583,22412,36995,9
2023-09-24,경부선,서울역,9310,2540,11850,9
2023-09-24,경부선,가산디지털단지,5591,6859,12450,9
2023-09-24,경의선,서울역,1226,1189,2415,9
2023-09-24,경의선,홍대입구,2018,2541,4559,9
2023-09-24,공항철도 1호선,서울역,12770,12113,24883,9
2023-09-24,공항철도 1호선,홍대입구,14279,12736,27015,9
2023-09-24,분당선,선릉,3265,5056,8321,9
2023-09-24,신림선,신림,1126,1613,2739,9
2023-09-25,2호선,선릉,66134,58239,124373,9
2023-09-25,2호선,강남,87394,83311,170705,9
2023-09-25,2호선,사당,40807,44536,85343,9
2023-09-25,2호선,신림,57817,54987,112804,9
2023-09-25,2호선,구로디지털단지,64340,63860,128200,9
2023-09-25,1호선,서울역,54350,53955,108305,9
2023-09-25,2호선,잠실(송파구청),74363,75079,149442,9
2023-09-25,2호선,홍대입구,61441,63796,125237,9
2023-09-25,3호선,고속터미널,44416,43373,87789,9
2023-09-25,4호선,서울역,13796,21900,35696,9
2023-09-25,4호선,사당,27863,24498,52361,9
2023-09-25,7호선,고속터미널,17096,15212,32308,9
2023-09-25,7호선,가산디지털단지,51589,51990,103579,9
2023-09-25,8호선,잠실(송파구청),15598,18173,33771,9
2023-09-25,9호선,고속터미널,14458,19401,33859,9
2023-09-25,경부선,서울역,7983,2942,10925,9
2023-09-25,경부선,가산디지털단지,19638,22298,41936,9
2023-09-25,경의선,서울역,5284,6978,12262,9
2023-09-25,경의선,홍대입구,1989,2259,4248,9
2023-09-25,공항철도 1호선,서울역,12123,11881,24004,9
2023-09-25,공항철도 1호선,홍대입구,12482,12107,24589,9
2023-09-25,분당선,선릉,15102,23325,38427,9
2023-09-25,신림선,신림,1882,2525,4407,9
2023-09-26,신림선,신림,1865,2592,4457,9
2023-09-26,분당선,선릉,15522,23566,39088,9
2023-09-26,공항철도 1호선,홍대입구,11928,12089,24017,9
2023-09-26,공항철도 1호선,서울역,11361,12311,23672,9
2023-09-26,경의선,홍대입구,1978,2330,4308,9
2023-09-26,경의선,서울역,5681,6995,12676,9
2023-09-26,경부선,가산디지털단지,19238,21687,40925,9
2023-09-26,경부선,서울역,7156,3759,10915,9
2023-09-26,9호선,고속터미널,14372,20621,34993,9
2023-09-26,8호선,잠실(송파구청),16031,19102,35133,9
2023-09-26,7호선,가산디지털단지,51296,51393,102689,9
2023-09-26,7호선,고속터미널,17145,16181,33326,9
2023-09-26,4호선,사당,28139,24461,52600,9
2023-09-26,4호선,서울역,15025,24091,39116,9
2023-09-26,3호선,고속터미널,44304,49542,93846,9
2023-09-26,2호선,홍대입구,60902,64533,125435,9
2023-09-26,2호선,구로디지털단지,64180,63066,127246,9
2023-09-26,2호선,신림,57750,54159,111909,9
2023-09-26,2호선,사당,41621,45081,86702,9
2023-09-26,2호선,강남,86986,83971,170957,9
2023-09-26,2호선,선릉,65621,57591,123212,9
2023-09-26,2호선,잠실(송파구청),74771,76415,151186,9
2023-09-26,1호선,서울역,56667,61507,118174,9
2023-09-27,1호선,서울역,52985,62529,115514,9
2023-09-27,2호선,잠실(송파구청),75388,78864,154252,9
2023-09-27,2호선,선릉,58340,51028,109368,9
2023-09-27,2호선,강남,84116,82168,166284,9
2023-09-27,2호선,사당,39525,43268,82793,9
2023-09-27,2호선,신림,59807,52526,112333,9
2023-09-27,2호선,구로디지털단지,62547,61026,123573,9
2023-09-27,2호선,홍대입구,65236,72398,137634,9
2023-09-27,3호선,고속터미널,50601,76527,127128,9
2023-09-27,4호선,서울역,12514,23648,36162,9
2023-09-27,4호선,사당,28408,24048,52456,9
2023-09-27,7호선,고속터미널,18288,18755,37043,9
2023-09-27,7호선,가산디지털단지,47987,47018,95005,9
2023-09-27,8호선,잠실(송파구청),16157,19489,35646,9
2023-09-27,9호선,고속터미널,15836,29533,45369,9
2023-09-27,경부선,서울역,8231,4681,12912,9
2023-09-27,경부선,가산디지털단지,18571,20484,39055,9
2023-09-27,경의선,서울역,5224,6910,12134,9
2023-09-27,경의선,홍대입구,2251,2709,4960,9
2023-09-27,공항철도 1호선,서울역,14189,13557,27746,9
2023-09-27,공항철도 1호선,홍대입구,13660,13419,27079,9
2023-09-27,분당선,선릉,13385,20547,33932,9
2023-09-27,신림선,신림,1937,2491,4428,9
2023-09-28,1호선,서울역,32536,42287,74823,9
2023-09-28,2호선,잠실(송파구청),44462,44551,89013,9
2023-09-28,2호선,선릉,10885,8848,19733,9
2023-09-28,2호선,강남,27877,27668,55545,9
2023-09-28,2호선,사당,16125,17767,33892,9
2023-09-28,2호선,신림,30656,23335,53991,9
2023-09-28,2호선,구로디지털단지,21825,18695,40520,9
2023-09-28,2호선,홍대입구,46373,49487,95860,9
2023-09-28,3호선,고속터미널,29735,57779,87514,9
2023-09-28,4호선,서울역,4672,14474,19146,9
2023-09-28,4호선,사당,13099,10801,23900,9
2023-09-28,7호선,고속터미널,9029,11646,20675,9
2023-09-28,7호선,가산디지털단지,9914,8064,17978,9
2023-09-28,8호선,잠실(송파구청),8879,10443,19322,9
2023-09-28,9호선,고속터미널,9486,24299,33785,9
2023-09-28,경부선,서울역,6061,3457,9518,9
2023-09-28,경부선,가산디지털단지,5580,5616,11196,9
2023-09-28,경의선,서울역,1219,1370,2589,9
2023-09-28,경의선,홍대입구,1518,1781,3299,9
2023-09-28,공항철도 1호선,서울역,10816,12195,23011,9
2023-09-28,공항철도 1호선,홍대입구,10433,9949,20382,9
2023-09-28,분당선,선릉,2240,3066,5306,9
2023-09-28,신림선,신림,818,1063,1881,9
2023-09-29,1호선,서울역,33444,36413,69857,9
2023-09-29,2호선,잠실(송파구청),41170,39500,80670,9
2023-09-29,2호선,선릉,6614,5545,12159,9
2023-09-29,2호선,강남,16006,15797,31803,9
2023-09-29,2호선,사당,11433,12872,24305,9
2023-09-29,2호선,신림,21477,20750,42227,9
2023-09-29,2호선,구로디지털단지,16478,15758,32236,9
2023-09-29,2호선,홍대입구,38334,45135,83469,9
2023-09-29,3호선,고속터미널,24012,29195,53207,9
2023-09-29,4호선,서울역,4894,13442,18336,9
2023-09-29,4호선,사당,10061,8670,18731,9
2023-09-29,7호선,고속터미널,10720,7001,17721,9
2023-09-29,7호선,가산디지털단지,6999,6229,13228,9
2023-09-29,8호선,잠실(송파구청),7554,8602,16156,9
2023-09-29,9호선,고속터미널,7336,12978,20314,9
2023-09-29,경부선,서울역,7101,2644,9745,9
2023-09-29,경부선,가산디지털단지,4212,5314,9526,9
2023-09-29,경의선,서울역,1223,1197,2420,9
2023-09-29,경의선,홍대입구,1068,1646,2714,9
2023-09-29,공항철도 1호선,서울역,11854,10847,22701,9
2023-09-29,공항철도 1호선,홍대입구,8097,8399,16496,9
2023-09-29,분당선,선릉,1424,2081,3505,9
2023-09-29,신림선,신림,677,926,1603,9
2023-09-30,1호선,서울역,38453,33466,71919,9
2023-09-30,2호선,잠실(송파구청),54572,51907,106479,9
2023-09-30,2호선,선릉,9419,8357,17776,9
2023-09-30,2호선,강남,23857,24451,48308,9
2023-09-30,2호선,사당,16498,19187,35685,9
2023-09-30,2호선,신림,23781,24936,48717,9
2023-09-30,2호선,구로디지털단지,19957,20447,40404,9
2023-09-30,2호선,홍대입구,52989,62358,115347,9
2023-09-30,3호선,고속터미널,44608,34512,79120,9
2023-09-30,4호선,서울역,5163,13263,18426,9
2023-09-30,4호선,사당,12613,11848,24461,9
2023-09-30,7호선,고속터미널,15769,7131,22900,9
2023-09-30,7호선,가산디지털단지,9124,8794,17918,9
2023-09-30,8호선,잠실(송파구청),10941,12712,23653,9
2023-09-30,9호선,고속터미널,12477,15491,27968,9
2023-09-30,경부선,서울역,8965,2338,11303,9
2023-09-30,경부선,가산디지털단지,4565,6273,10838,9
2023-09-30,경의선,서울역,1256,1182,2438,9
2023-09-30,경의선,홍대입구,1743,2457,4200,9
2023-09-30,공항철도 1호선,서울역,13079,10296,23375,9
2023-09-30,공항철도 1호선,홍대입구,11683,12149,23832,9
2023-09-30,분당선,선릉,2072,2973,5045,9
2023-09-30,신림선,신림,742,1257,1999,9
2023-10-01,1호선,서울역,39581,32157,71738,10
2023-10-01,2호선,잠실(송파구청),56774,53762,110536,10
2023-10-01,2호선,선릉,11011,9809,20820,10
2023-10-01,2호선,강남,27111,26970,54081,10
2023-10-01,2호선,사당,20793,23941,44734,10
2023-10-01,2호선,신림,28561,30478,59039,10
2023-10-01,2호선,구로디지털단지,24261,24598,48859,10
2023-10-01,2호선,홍대입구,60368,67802,128170,10
2023-10-01,3호선,고속터미널,54007,37086,91093,10
2023-10-01,4호선,서울역,5321,13314,18635,10
2023-10-01,4호선,사당,15657,14813,30470,10
2023-10-01,7호선,고속터미널,18993,7564,26557,10
2023-10-01,7호선,가산디지털단지,10136,9819,19955,10
2023-10-01,8호선,잠실(송파구청),11336,12630,23966,10
2023-10-01,9호선,고속터미널,15873,17310,33183,10
2023-10-01,경부선,서울역,10534,2282,12816,10
2023-10-01,경부선,가산디지털단지,5262,6921,12183,10
2023-10-01,경의선,서울역,1384,1116,2500,10
2023-10-01,경의선,홍대입구,2150,2802,4952,10
2023-10-01,공항철도 1호선,서울역,13062,10679,23741,10
2023-10-01,공항철도 1호선,홍대입구,13732,13956,27688,10
2023-10-01,분당선,선릉,2406,3369,5775,10
2023-10-01,신림선,신림,1012,1567,2579,10
2023-10-02,분당선,선릉,3266,5189,8455,10
2023-10-02,공항철도 1호선,홍대입구,15499,15071,30570,10
2023-10-02,공항철도 1호선,서울역,12575,10100,22675,10
2023-10-02,경의선,홍대입구,2256,2963,5219,10
2023-10-02,경의선,서울역,1623,1322,2945,10
2023-10-02,경부선,가산디지털단지,5850,7646,13496,10
2023-10-02,경부선,서울역,11043,1969,13012,10
2023-10-02,9호선,고속터미널,17067,19215,36282,10
2023-10-02,8호선,잠실(송파구청),12628,14253,26881,10
2023-10-02,7호선,가산디지털단지,11986,11683,23669,10
2023-10-02,7호선,고속터미널,21675,11107,32782,10
2023-10-02,4호선,사당,18174,16848,35022,10
2023-10-02,4호선,서울역,5690,12980,18670,10
2023-10-02,3호선,고속터미널,59877,42145,102022,10
2023-10-02,2호선,홍대입구,66060,75726,141786,10
2023-10-02,2호선,구로디지털단지,28218,28539,56757,10
2023-10-02,2호선,신림,34726,35293,70019,10
2023-10-02,2호선,사당,24965,28902,53867,10
2023-10-02,2호선,강남,39692,39721,79413,10
2023-10-02,2호선,선릉,16287,14813,31100,10
2023-10-02,2호선,잠실(송파구청),65799,62388,128187,10
2023-10-02,1호선,서울역,40485,31914,72399,10
2023-10-02,신림선,신림,1161,1782,2943,10
2023-10-03,3호선,고속터미널,54532,40965,95497,10
2023-10-03,4호선,서울역,5108,11270,16378,10
2023-10-03,4호선,사당,15664,15747,31411,10
2023-10-03,7호선,고속터미널,17891,8639,26530,10
2023-10-03,7호선,가산디지털단지,10901,10884,21785,10
2023-10-03,8호선,잠실(송파구청),11119,12227,23346,10
2023-10-03,9호선,고속터미널,14765,18892,33657,10
2023-10-03,경부선,서울역,12494,2301,14795,10
2023-10-03,경부선,가산디지털단지,5308,6933,12241,10
2023-10-03,경의선,서울역,1518,1317,2835,10
2023-10-03,경의선,홍대입구,1819,2426,4245,10
2023-10-03,공항철도 1호선,서울역,11298,10893,22191,10
2023-10-03,공항철도 1호선,홍대입구,12752,12084,24836,10
2023-10-03,분당선,선릉,3133,4797,7930,10
2023-10-03,신림선,신림,1066,1576,2642,10
2023-10-03,1호선,서울역,38065,30645,68710,10
2023-10-03,2호선,잠실(송파구청),53823,50267,104090,10
2023-10-03,2호선,선릉,15315,13667,28982,10
2023-10-03,2호선,강남,31540,30466,62006,10
2023-10-03,2호선,사당,22577,25520,48097,10
2023-10-03,2호선,신림,31794,32479,64273,10
2023-10-03,2호선,구로디지털단지,25437,25517,50954,10
2023-10-03,2호선,홍대입구,56751,59016,115767,10
2023-10-04,1호선,서울역,56075,49061,105136,10
2023-10-04,2호선,잠실(송파구청),70520,70775,141295,10
2023-10-04,2호선,선릉,62849,55329,118178,10
2023-10-04,2호선,강남,81446,78055,159501,10
2023-10-04,2호선,사당,38790,42404,81194,10
2023-10-04,2호선,신림,56180,54342,110522,10
2023-10-04,2호선,구로디지털단지,62506,62063,124569,10
2023-10-04,2호선,홍대입구,59157,62434,121591,10
2023-10-04,3호선,고속터미널,43762,38292,82054,10
2023-10-04,4호선,서울역,13301,19335,32636,10
2023-10-04,4호선,사당,26847,23574,50421,10
2023-10-04,7호선,고속터미널,18025,14238,32263,10
2023-10-04,7호선,가산디지털단지,51390,51132,102522,10
2023-10-04,8호선,잠실(송파구청),15335,17407,32742,10
2023-10-04,9호선,고속터미널,13753,17465,31218,10
2023-10-04,경부선,서울역,10166,2778,12944,10
2023-10-04,경부선,가산디지털단지,18865,21712,40577,10
2023-10-04,신림선,신림,1917,2752,4669,10
2023-10-04,분당선,선릉,14557,22535,37092,10
2023-10-04,공항철도 1호선,홍대입구,11995,12342,24337,10
2023-10-04,공항철도 1호선,서울역,12306,10067,22373,10
2023-10-04,경의선,서울역,5467,6811,12278,10
2023-10-04,경의선,홍대입구,1991,2462,4453,10
2023-10-05,3호선,고속터미널,44887,40700,85587,10
2023-10-05,1호선,서울역,54674,51257,105931,10
2023-10-05,신림선,신림,1871,2610,4481,10
2023-10-05,분당선,선릉,14936,23054,37990,10
2023-10-05,4호선,서울역,13943,20767,34710,10
2023-10-05,4호선,사당,28353,24510,52863,10
2023-10-05,7호선,고속터미널,17273,14877,32150,10
2023-10-05,7호선,가산디지털단지,51365,52094,103459,10
2023-10-05,8호선,잠실(송파구청),15725,18395,34120,10
2023-10-05,9호선,고속터미널,14612,18421,33033,10
2023-10-05,경부선,서울역,8236,2711,10947,10
2023-10-05,경부선,가산디지털단지,19454,22091,41545,10
2023-10-05,경의선,서울역,5425,6730,12155,10
2023-10-05,경의선,홍대입구,1914,2422,4336,10
2023-10-05,공항철도 1호선,서울역,12491,10232,22723,10
2023-10-05,공항철도 1호선,홍대입구,12730,13092,25822,10
2023-10-05,2호선,잠실(송파구청),75962,76998,152960,10
2023-10-05,2호선,선릉,65257,57762,123019,10
2023-10-05,2호선,강남,85942,83079,169021,10
2023-10-05,2호선,사당,41530,45975,87505,10
2023-10-05,2호선,신림,58504,56001,114505,10
2023-10-05,2호선,구로디지털단지,63914,63195,127109,10
2023-10-05,2호선,홍대입구,63599,67983,131582,10
2023-10-06,신림선,신림,1792,2652,4444,10
2023-10-06,분당선,선릉,15175,23172,38347,10
2023-10-06,공항철도 1호선,홍대입구,14709,15314,30023,10
2023-10-06,공항철도 1호선,서울역,16146,13652,29798,10
2023-10-06,경의선,홍대입구,2380,2999,5379,10
2023-10-06,경부선,가산디지털단지,19832,22379,42211,10
2023-10-06,경부선,서울역,10782,3917,14699,10
2023-10-06,9호선,고속터미널,17751,23290,41041,10
2023-10-06,8호선,잠실(송파구청),16936,20622,37558,10
2023-10-06,7호선,가산디지털단지,51149,51556,102705,10
2023-10-06,7호선,고속터미널,21136,16784,37920,10
2023-10-06,4호선,사당,30600,26622,57222,10
2023-10-06,4호선,서울역,14409,24031,38440,10
2023-10-06,3호선,고속터미널,54249,51882,106131,10
2023-10-06,2호선,홍대입구,70878,81225,152103,10
2023-10-06,2호선,구로디지털단지,65679,64913,130592,10
2023-10-06,2호선,신림,60868,58415,119283,10
2023-10-06,2호선,사당,44893,49757,94650,10
2023-10-06,2호선,강남,92517,90655,183172,10
2023-10-06,2호선,선릉,65164,57774,122938,10
2023-10-06,2호선,잠실(송파구청),84117,85001,169118,10
2023-10-06,1호선,서울역,63001,60133,123134,10
2023-10-06,경의선,서울역,5598,7205,12803,10
2023-10-07,1호선,서울역,50764,50534,101298,10
2023-10-07,2호선,잠실(송파구청),78015,75692,153707,10
2023-10-07,2호선,선릉,28949,25287,54236,10
2023-10-07,2호선,강남,59575,58912,118487,10
2023-10-07,2호선,사당,37662,42092,79754,10
2023-10-07,2호선,신림,48828,45102,93930,10
2023-10-07,2호선,구로디지털단지,39385,38092,77477,10
2023-10-07,2호선,홍대입구,81034,95743,176777,10
2023-10-07,3호선,고속터미널,62810,60242,123052,10
2023-10-07,4호선,서울역,8476,20816,29292,10
2023-10-07,4호선,사당,27211,24631,51842,10
2023-10-07,7호선,고속터미널,20034,14601,34635,10
2023-10-07,7호선,가산디지털단지,15439,14233,29672,10
2023-10-07,8호선,잠실(송파구청),14996,17733,32729,10
2023-10-07,9호선,고속터미널,21665,30735,52400,10
2023-10-07,경부선,서울역,11747,3839,15586,10
2023-10-07,경부선,가산디지털단지,7704,9634,17338,10
2023-10-07,경의선,서울역,1797,1921,3718,10
2023-10-07,경의선,홍대입구,2961,4222,7183,10
2023-10-07,공항철도 1호선,서울역,15250,14708,29958,10
2023-10-07,공항철도 1호선,홍대입구,18128,18078,36206,10
2023-10-07,분당선,선릉,5730,9315,15045,10
2023-10-07,신림선,신림,1640,2760,4400,10
2023-10-08,1호선,서울역,39909,37751,77660,10
2023-10-08,2호선,잠실(송파구청),66578,63084,129662,10
2023-10-08,2호선,선릉,16374,13724,30098,10
2023-10-08,2호선,강남,38231,37976,76207,10
2023-10-08,2호선,사당,27799,30730,58529,10
2023-10-08,2호선,신림,38583,36294,74877,10
2023-10-08,2호선,구로디지털단지,30269,28677,58946,10
2023-10-08,2호선,홍대입구,75355,80513,155868,10
2023-10-08,3호선,고속터미널,49159,47338,96497,10
2023-10-08,4호선,서울역,6814,17216,24030,10
2023-10-08,4호선,사당,19712,18369,38081,10
2023-10-08,7호선,고속터미널,13861,10122,23983,10
2023-10-08,7호선,가산디지털단지,11968,11021,22989,10
2023-10-08,8호선,잠실(송파구청),12803,14587,27390,10
2023-10-08,9호선,고속터미널,14478,22916,37394,10
2023-10-08,경부선,서울역,10581,2736,13317,10
2023-10-08,경부선,가산디지털단지,6126,7359,13485,10
2023-10-08,경의선,서울역,1370,1501,2871,10
2023-10-08,경의선,홍대입구,2569,3182,5751,10
2023-10-08,공항철도 1호선,서울역,14006,13135,27141,10
2023-10-08,공항철도 1호선,홍대입구,16787,15641,32428,10
2023-10-08,분당선,선릉,3187,4906,8093,10
2023-10-08,신림선,신림,1223,1660,2883,10
2023-10-09,1호선,서울역,40471,39491,79962,10
2023-10-09,2호선,잠실(송파구청),58545,54736,113281,10
2023-10-09,2호선,선릉,19261,16842,36103,10
2023-10-09,2호선,강남,35502,33917,69419,10
2023-10-09,2호선,사당,24861,27202,52063,10
2023-10-09,2호선,신림,33507,32923,66430,10
2023-10-09,2호선,구로디지털단지,27911,27681,55592,10
2023-10-09,2호선,홍대입구,61272,62329,123601,10
2023-10-09,3호선,고속터미널,50147,45267,95414,10
2023-10-09,4호선,서울역,6292,16230,22522,10
2023-10-09,4호선,사당,17623,16372,33995,10
2023-10-09,7호선,고속터미널,15601,10489,26090,10
2023-10-09,7호선,가산디지털단지,12160,11806,23966,10
2023-10-09,8호선,잠실(송파구청),12215,13525,25740,10
2023-10-09,9호선,고속터미널,14473,21314,35787,10
2023-10-09,경부선,서울역,10254,2510,12764,10
2023-10-09,경부선,가산디지털단지,5907,7052,12959,10
2023-10-09,경의선,서울역,1599,1529,3128,10
2023-10-09,경의선,홍대입구,1968,2414,4382,10
2023-10-09,공항철도 1호선,서울역,13915,12851,26766,10
2023-10-09,공항철도 1호선,홍대입구,13926,12436,26362,10
2023-10-09,분당선,선릉,3671,5635,9306,10
2023-10-09,신림선,신림,1027,1577,2604,10
2023-10-10,4호선,사당,28517,24841,53358,10
2023-10-10,4호선,서울역,13919,21275,35194,10
2023-10-10,3호선,고속터미널,43769,40572,84341,10
2023-10-10,2호선,홍대입구,63092,66120,129212,10
2023-10-10,2호선,구로디지털단지,64218,63984,128202,10
2023-10-10,2호선,신림,57691,55713,113404,10
2023-10-10,2호선,사당,42012,46001,88013,10
2023-10-10,2호선,강남,85899,82663,168562,10
2023-10-10,2호선,선릉,66486,58747,125233,10
2023-10-10,2호선,잠실(송파구청),74506,75466,149972,10
2023-10-10,7호선,고속터미널,17955,15330,33285,10
2023-10-10,7호선,가산디지털단지,51465,52185,103650,10
2023-10-10,8호선,잠실(송파구청),15327,17898,33225,10
2023-10-10,9호선,고속터미널,14965,18995,33960,10
2023-10-10,경부선,서울역,8684,2825,11509,10
2023-10-10,경부선,가산디지털단지,19823,22468,42291,10
2023-10-10,경의선,서울역,5618,7213,12831,10
2023-10-10,경의선,홍대입구,2109,2475,4584,10
2023-10-10,공항철도 1호선,서울역,12607,11147,23754,10
2023-10-10,공항철도 1호선,홍대입구,12779,12441,25220,10
2023-10-10,분당선,선릉,15315,23541,38856,10
2023-10-10,신림선,신림,1899,2689,4588,10
2023-10-10,1호선,서울역,56733,53360,110093,10
2023-10-11,신림선,신림,1869,2663,4532,10
2023-10-11,1호선,서울역,55663,53210,108873,10
2023-10-11,2호선,잠실(송파구청),78629,79666,158295,10
2023-10-11,2호선,선릉,66934,59316,126250,10
2023-10-11,2호선,강남,87328,84320,171648,10
2023-10-11,2호선,사당,42999,46404,89403,10
2023-10-11,2호선,신림,59475,56601,116076,10
2023-10-11,2호선,구로디지털단지,65198,64829,130027,10
2023-10-11,2호선,홍대입구,65635,69962,135597,10
2023-10-11,3호선,고속터미널,43660,40550,84210,10
2023-10-11,4호선,서울역,13921,21467,35388,10
2023-10-11,4호선,사당,28441,24726,53167,10
2023-10-11,7호선,고속터미널,17287,15078,32365,10
2023-10-11,7호선,가산디지털단지,51440,52464,103904,10
2023-10-11,8호선,잠실(송파구청),15920,18782,34702,10
2023-10-11,9호선,고속터미널,14766,19045,33811,10
2023-10-11,경부선,서울역,8107,2585,10692,10
2023-10-11,경부선,가산디지털단지,19945,22428,42373,10
2023-10-11,경의선,서울역,5468,7009,12477,10
2023-10-11,경의선,홍대입구,2323,2459,4782,10
2023-10-11,공항철도 1호선,서울역,12711,10666,23377,10
2023-10-11,공항철도 1호선,홍대입구,13221,13184,26405,10
2023-10-11,분당선,선릉,15494,23755,39249,10
2023-10-12,1호선,서울역,58351,54602,112953,10
2023-10-12,2호선,잠실(송파구청),82036,83021,165057,10
2023-10-12,2호선,선릉,66135,58607,124742,10
2023-10-12,2호선,강남,87782,85266,173048,10
2023-10-12,2호선,사당,44228,48480,92708,10
2023-10-12,2호선,신림,59357,56673,116030,10
2023-10-12,2호선,구로디지털단지,65148,64807,129955,10
2023-10-12,2호선,홍대입구,66939,71984,138923,10
2023-10-12,3호선,고속터미널,45545,41988,87533,10
2023-10-12,4호선,서울역,14322,22678,37000,10
2023-10-12,4호선,사당,29120,25823,54943,10
2023-10-12,신림선,신림,1797,2559,4356,10
2023-10-12,분당선,선릉,15300,23582,38882,10
2023-10-12,공항철도 1호선,홍대입구,13435,13547,26982,10
2023-10-12,공항철도 1호선,서울역,13395,11098,24493,10
2023-10-12,경의선,홍대입구,2137,2544,4681,10
2023-10-12,경의선,서울역,5570,6998,12568,10
2023-10-12,경부선,가산디지털단지,19851,22296,42147,10
2023-10-12,경부선,서울역,8575,2864,11439,10
2023-10-12,9호선,고속터미널,15303,19642,34945,10
2023-10-12,8호선,잠실(송파구청),15983,19262,35245,10
2023-10-12,7호선,가산디지털단지,50991,51935,102926,10
2023-10-12,7호선,고속터미널,17930,15846,33776,10
2023-10-13,신림선,신림,1892,2670,4562,10
2023-10-13,분당선,선릉,15006,23236,38242,10
2023-10-13,공항철도 1호선,홍대입구,15519,16533,32052,10
2023-10-13,공항철도 1호선,서울역,16729,14771,31500,10
2023-10-13,경의선,홍대입구,2759,3368,6127,10
2023-10-13,경의선,서울역,5718,7251,12969,10
2023-10-13,경부선,가산디지털단지,19875,22216,42091,10
2023-10-13,경부선,서울역,10798,3710,14508,10
2023-10-13,9호선,고속터미널,18551,25295,43846,10
2023-10-13,8호선,잠실(송파구청),17467,20999,38466,10
2023-10-13,7호선,가산디지털단지,50883,51379,102262,10
2023-10-13,7호선,고속터미널,21649,17067,38716,10
2023-10-13,4호선,사당,31514,28200,59714,10
2023-10-13,4호선,서울역,14600,25123,39723,10
2023-10-13,3호선,고속터미널,54938,52735,107673,10
2023-10-13,2호선,홍대입구,75842,86020,161862,10
2023-10-13,2호선,구로디지털단지,67139,66354,133493,10
2023-10-13,2호선,신림,61998,59329,121327,10
2023-10-13,2호선,사당,47065,51968,99033,10
2023-10-13,2호선,강남,93283,91309,184592,10
2023-10-13,2호선,선릉,65276,57644,122920,10
2023-10-13,2호선,잠실(송파구청),89992,91569,181561,10
2023-10-13,1호선,서울역,64439,60869,125308,10
2023-10-14,공항철도 1호선,홍대입구,17997,18258,36255,10
2023-10-14,공항철도 1호선,서울역,14900,14374,29274,10
2023-10-14,3호선,고속터미널,58739,57006,115745,10
2023-10-14,2호선,홍대입구,79765,91396,171161,10
2023-10-14,2호선,구로디지털단지,38775,37450,76225,10
2023-10-14,2호선,신림,46957,44056,91013,10
2023-10-14,2호선,사당,37679,41912,79591,10
2023-10-14,2호선,강남,60376,59736,120112,10
2023-10-14,2호선,선릉,29621,25641,55262,10
2023-10-14,2호선,잠실(송파구청),79263,78021,157284,10
2023-10-14,1호선,서울역,48853,47349,96202,10
2023-10-14,경의선,홍대입구,2404,3224,5628,10
2023-10-14,경의선,서울역,1732,2074,3806,10
2023-10-14,경부선,가산디지털단지,7017,8778,15795,10
2023-10-14,경부선,서울역,11297,3343,14640,10
2023-10-14,9호선,고속터미널,17575,26383,43958,10
2023-10-14,8호선,잠실(송파구청),15641,18921,34562,10
2023-10-14,7호선,가산디지털단지,14983,13757,28740,10
2023-10-14,7호선,고속터미널,17981,13862,31843,10
2023-10-14,4호선,사당,24449,22954,47403,10
2023-10-14,4호선,서울역,8196,20597,28793,10
2023-10-14,분당선,선릉,5838,9503,15341,10
2023-10-14,신림선,신림,1190,1769,2959,10
2023-10-15,1호선,서울역,39291,37929,77220,10
2023-10-15,9호선,고속터미널,15442,22618,38060,10
2023-10-15,7호선,고속터미널,15075,10294,25369,10
2023-10-15,2호선,잠실(송파구청),62727,58736,121463,10
2023-10-15,2호선,선릉,16634,14144,30778,10
2023-10-15,2호선,강남,36413,34710,71123,10
2023-10-15,경의선,홍대입구,2252,2568,4820,10
2023-10-15,경의선,서울역,1460,1388,2848,10
2023-10-15,2호선,사당,28572,30907,59479,10
2023-10-15,2호선,신림,37520,36137,73657,10
2023-10-15,2호선,구로디지털단지,30248,28973,59221,10
2023-10-15,2호선,홍대입구,65830,67007,132837,10
2023-10-15,8호선,잠실(송파구청),12310,13790,26100,10
2023-10-15,7호선,가산디지털단지,11535,10931,22466,10
2023-10-15,경부선,서울역,10446,2672,13118,10
2023-10-15,공항철도 1호선,서울역,14771,13131,27902,10
2023-10-15,공항철도 1호선,홍대입구,15792,14470,30262,10
2023-10-15,분당선,선릉,3202,5064,8266,10
2023-10-15,경부선,가산디지털단지,6009,7448,13457,10
2023-10-15,신림선,신림,1221,1687,2908,10
2023-10-15,3호선,고속터미널,48864,45899,94763,10
2023-10-15,4호선,서울역,6417,16773,23190,10
2023-10-15,4호선,사당,19675,18592,38267,10
2023-10-16,분당선,선릉,14970,23141,38111,10
2023-10-16,2호선,잠실(송파구청),72578,73114,145692,10
2023-10-16,신림선,신림,1822,2497,4319,10
2023-10-16,공항철도 1호선,홍대입구,12528,12332,24860,10
2023-10-16,공항철도 1호선,서울역,13350,11674,25024,10
2023-10-16,경의선,홍대입구,1997,2351,4348,10
2023-10-16,경의선,서울역,5580,7010,12590,10
2023-10-16,경부선,가산디지털단지,19746,22433,42179,10
2023-10-16,경부선,서울역,8608,2989,11597,10
2023-10-16,9호선,고속터미널,14205,18759,32964,10
2023-10-16,8호선,잠실(송파구청),15220,17470,32690,10
2023-10-16,7호선,가산디지털단지,51298,51957,103255,10
2023-10-16,7호선,고속터미널,17642,15111,32753,10
2023-10-16,1호선,서울역,57045,54169,111214,10
2023-10-16,2호선,선릉,64790,57085,121875,10
2023-10-16,2호선,강남,84638,81438,166076,10
2023-10-16,2호선,사당,40782,44648,85430,10
2023-10-16,2호선,신림,57151,54911,112062,10
2023-10-16,2호선,구로디지털단지,63666,63034,126700,10
2023-10-16,2호선,홍대입구,62860,65673,128533,10
2023-10-16,3호선,고속터미널,39258,36951,76209,10
2023-10-16,4호선,서울역,13842,22040,35882,10
2023-10-16,4호선,사당,27332,23797,51129,10
2023-10-17,3호선,고속터미널,45107,41557,86664,10
2023-10-17,2호선,홍대입구,64233,67141,131374,10
2023-10-17,2호선,구로디지털단지,64908,64306,129214,10
2023-10-17,2호선,신림,58277,55767,114044,10
2023-10-17,2호선,사당,43353,47403,90756,10
2023-10-17,2호선,강남,86659,83364,170023,10
2023-10-17,2호선,선릉,66293,58084,124377,10
2023-10-17,2호선,잠실(송파구청),79785,80305,160090,10
2023-10-17,1호선,서울역,57095,54284,111379,10
2023-10-17,4호선,서울역,14474,22476,36950,10
2023-10-17,4호선,사당,28729,25154,53883,10
2023-10-17,7호선,고속터미널,17528,15417,32945,10
2023-10-17,7호선,가산디지털단지,51331,52120,103451,10
2023-10-17,8호선,잠실(송파구청),15975,19110,35085,10
2023-10-17,9호선,고속터미널,14928,19826,34754,10
2023-10-17,경부선,서울역,8097,2706,10803,10
2023-10-17,경부선,가산디지털단지,19993,22471,42464,10
2023-10-17,경의선,서울역,5459,6968,12427,10
2023-10-17,경의선,홍대입구,2015,2436,4451,10
2023-10-17,공항철도 1호선,서울역,12646,11154,23800,10
2023-10-17,공항철도 1호선,홍대입구,13023,12736,25759,10
2023-10-17,분당선,선릉,15345,23589,38934,10
2023-10-17,신림선,신림,1862,2548,4410,10
2023-10-18,7호선,고속터미널,17401,15303,32704,10
2023-10-18,7호선,가산디지털단지,51108,51840,102948,10
2023-10-18,8호선,잠실(송파구청),16081,19160,35241,10
2023-10-18,9호선,고속터미널,15184,20085,35269,10
2023-10-18,경부선,서울역,8390,2693,11083,10
2023-10-18,경부선,가산디지털단지,20309,22832,43141,10
2023-10-18,경의선,서울역,5583,7114,12697,10
2023-10-18,경의선,홍대입구,2194,2588,4782,10
2023-10-18,공항철도 1호선,서울역,13086,10905,23991,10
2023-10-18,공항철도 1호선,홍대입구,13503,13544,27047,10
2023-10-18,분당선,선릉,15276,23661,38937,10
2023-10-18,신림선,신림,1827,2559,4386,10
2023-10-18,3호선,고속터미널,44940,41545,86485,10
2023-10-18,2호선,홍대입구,66045,70619,136664,10
2023-10-18,2호선,구로디지털단지,65047,64566,129613,10
2023-10-18,2호선,신림,59261,57021,116282,10
2023-10-18,2호선,사당,43517,47299,90816,10
2023-10-18,2호선,강남,86632,83408,170040,10
2023-10-18,2호선,선릉,66603,58581,125184,10
2023-10-18,2호선,잠실(송파구청),82558,82405,164963,10
2023-10-18,1호선,서울역,57911,54450,112361,10
2023-10-18,4호선,서울역,14630,22835,37465,10
2023-10-18,4호선,사당,28985,25402,54387,10
2023-10-19,1호선,서울역,58824,54892,113716,10
2023-10-19,7호선,가산디지털단지,50067,51460,101527,10
2023-10-19,8호선,잠실(송파구청),15691,19608,35299,10
2023-10-19,9호선,고속터미널,15060,19313,34373,10
2023-10-19,경부선,서울역,8609,2944,11553,10
2023-10-19,경부선,가산디지털단지,19613,22047,41660,10
2023-10-19,경의선,서울역,5512,6870,12382,10
2023-10-19,경의선,홍대입구,2139,2504,4643,10
2023-10-19,공항철도 1호선,서울역,13659,11518,25177,10
2023-10-19,공항철도 1호선,홍대입구,13726,13872,27598,10
2023-10-19,분당선,선릉,14917,23280,38197,10
2023-10-19,신림선,신림,1840,2488,4328,10
2023-10-19,7호선,고속터미널,17541,15174,32715,10
2023-10-19,2호선,잠실(송파구청),79247,80557,159804,10
2023-10-19,2호선,선릉,64470,57220,121690,10
2023-10-19,2호선,강남,85706,83434,169140,10
2023-10-19,2호선,사당,42875,46537,89412,10
2023-10-19,2호선,신림,57986,55039,113025,10
2023-10-19,2호선,구로디지털단지,63861,63279,127140,10
2023-10-19,2호선,홍대입구,66261,71031,137292,10
2023-10-19,3호선,고속터미널,45266,41750,87016,10
2023-10-19,4호선,서울역,14354,22866,37220,10
2023-10-19,4호선,사당,28281,24705,52986,10
2023-10-20,1호선,서울역,65770,62621,128391,10
2023-10-20,2호선,잠실(송파구청),92853,92619,185472,10
2023-10-20,2호선,선릉,65553,57508,123061,10
2023-10-20,2호선,강남,92691,91186,183877,10
2023-10-20,2호선,사당,47102,53016,100118,10
2023-10-20,2호선,신림,61884,59251,121135,10
2023-10-20,2호선,구로디지털단지,66321,65498,131819,10
2023-10-20,2호선,홍대입구,78565,88024,166589,10
2023-10-20,3호선,고속터미널,57260,55447,112707,10
2023-10-20,4호선,서울역,14951,26514,41465,10
2023-10-20,4호선,사당,31976,28210,60186,10
2023-10-20,7호선,고속터미널,20845,16981,37826,10
2023-10-20,7호선,가산디지털단지,50312,50310,100622,10
2023-10-20,8호선,잠실(송파구청),18005,21824,39829,10
2023-10-20,9호선,고속터미널,18216,25096,43312,10
2023-10-20,경부선,서울역,11606,3902,15508,10
2023-10-20,경부선,가산디지털단지,19491,22128,41619,10
2023-10-20,경의선,서울역,5475,7065,12540,10
2023-10-20,경의선,홍대입구,2491,3160,5651,10
2023-10-20,공항철도 1호선,서울역,16163,14596,30759,10
2023-10-20,공항철도 1호선,홍대입구,15762,16216,31978,10
2023-10-20,분당선,선릉,14942,23126,38068,10
2023-10-20,신림선,신림,1962,2723,4685,10
2023-10-21,4호선,사당,26492,25129,51621,10
2023-10-21,4호선,서울역,8681,21629,30310,10
2023-10-21,1호선,서울역,52513,50327,102840,10
2023-10-21,3호선,고속터미널,60501,58298,118799,10
2023-10-21,2호선,홍대입구,84166,95916,180082,10
2023-10-21,2호선,구로디지털단지,40342,39204,79546,10
2023-10-21,2호선,신림,49702,46749,96451,10
2023-10-21,2호선,사당,39636,44456,84092,10
2023-10-21,2호선,강남,61293,60078,121371,10
2023-10-21,2호선,선릉,29362,25462,54824,10
2023-10-21,2호선,잠실(송파구청),82968,80412,163380,10
2023-10-21,신림선,신림,1447,2090,3537,10
2023-10-21,분당선,선릉,6040,9512,15552,10
2023-10-21,공항철도 1호선,홍대입구,18754,18115,36869,10
2023-10-21,공항철도 1호선,서울역,15060,14530,29590,10
2023-10-21,경의선,홍대입구,2591,3388,5979,10
2023-10-21,경의선,서울역,1836,1987,3823,10
2023-10-21,경부선,가산디지털단지,7796,9859,17655,10
2023-10-21,경부선,서울역,12083,3462,15545,10
2023-10-21,9호선,고속터미널,18399,27940,46339,10
2023-10-21,8호선,잠실(송파구청),15942,19454,35396,10
2023-10-21,7호선,가산디지털단지,16260,14899,31159,10
2023-10-21,7호선,고속터미널,18866,13981,32847,10
2023-10-22,2호선,홍대입구,67141,68569,135710,10
2023-10-22,3호선,고속터미널,50098,45581,95679,10
2023-10-22,4호선,사당,19316,18238,37554,10
2023-10-22,4호선,서울역,6581,16950,23531,10
2023-10-22,신림선,신림,1174,1663,2837,10
2023-10-22,분당선,선릉,3381,5210,8591,10
2023-10-22,공항철도 1호선,홍대입구,15626,13974,29600,10
2023-10-22,공항철도 1호선,서울역,15024,13547,28571,10
2023-10-22,경의선,홍대입구,2162,2783,4945,10
2023-10-22,경의선,서울역,1545,1393,2938,10
2023-10-22,경부선,가산디지털단지,6295,7892,14187,10
2023-10-22,경부선,서울역,11479,2902,14381,10
2023-10-22,9호선,고속터미널,15379,22303,37682,10
2023-10-22,8호선,잠실(송파구청),11696,13547,25243,10
2023-10-22,7호선,가산디지털단지,12100,11726,23826,10
2023-10-22,7호선,고속터미널,15975,10280,26255,10
2023-10-22,1호선,서울역,39440,39218,78658,10
2023-10-22,2호선,잠실(송파구청),60283,55762,116045,10
2023-10-22,2호선,선릉,16674,13971,30645,10
2023-10-22,2호선,강남,34312,32827,67139,10
2023-10-22,2호선,사당,28031,29821,57852,10
2023-10-22,2호선,신림,36437,34984,71421,10
2023-10-22,2호선,구로디지털단지,28974,27735,56709,10
2023-10-23,2호선,홍대입구,64033,66530,130563,10
2023-10-23,3호선,고속터미널,43819,41144,84963,10
2023-10-23,4호선,서울역,14014,22523,36537,10
2023-10-23,4호선,사당,26955,23558,50513,10
2023-10-23,7호선,고속터미널,17064,14643,31707,10
2023-10-23,7호선,가산디지털단지,50537,51293,101830,10
2023-10-23,8호선,잠실(송파구청),15252,17925,33177,10
2023-10-23,9호선,고속터미널,14514,19513,34027,10
2023-10-23,경부선,서울역,9044,2885,11929,10
2023-10-23,경부선,가산디지털단지,19761,22383,42144,10
2023-10-23,경의선,서울역,5356,6981,12337,10
2023-10-23,경의선,홍대입구,1996,2346,4342,10
2023-10-23,공항철도 1호선,서울역,14171,12534,26705,10
2023-10-23,공항철도 1호선,홍대입구,13444,12982,26426,10
2023-10-23,분당선,선릉,14856,22845,37701,10
2023-10-23,신림선,신림,1808,2511,4319,10
2023-10-23,1호선,서울역,57943,55539,113482,10
2023-10-23,2호선,잠실(송파구청),75871,76259,152130,10
2023-10-23,2호선,선릉,63725,56604,120329,10
2023-10-23,2호선,강남,83376,80300,163676,10
2023-10-23,2호선,사당,40218,43950,84168,10
2023-10-23,2호선,신림,56756,54667,111423,10
2023-10-23,2호선,구로디지털단지,63669,63075,126744,10
2023-10-24,4호선,사당,28597,24382,52979,10
2023-10-24,4호선,서울역,14277,21943,36220,10
2023-10-24,3호선,고속터미널,42405,40188,82593,10
2023-10-24,2호선,홍대입구,64400,67767,132167,10
2023-10-24,2호선,구로디지털단지,64963,64253,129216,10
2023-10-24,2호선,신림,57911,55547,113458,10
2023-10-24,2호선,사당,42335,46566,88901,10
2023-10-24,2호선,강남,85955,82768,168723,10
2023-10-24,2호선,선릉,66898,58871,125769,10
2023-10-24,2호선,잠실(송파구청),78487,79361,157848,10
2023-10-24,1호선,서울역,56940,53749,110689,10
2023-10-24,신림선,신림,1795,2407,4202,10
2023-10-24,분당선,선릉,15344,23469,38813,10
2023-10-24,공항철도 1호선,홍대입구,13241,12911,26152,10
2023-10-24,공항철도 1호선,서울역,12939,11380,24319,10
2023-10-24,경의선,홍대입구,2095,2459,4554,10
2023-10-24,경의선,서울역,5480,7043,12523,10
2023-10-24,경부선,가산디지털단지,19731,22497,42228,10
2023-10-24,경부선,서울역,8031,2672,10703,10
2023-10-24,9호선,고속터미널,14436,18794,33230,10
2023-10-24,8호선,잠실(송파구청),15826,18484,34310,10
2023-10-24,7호선,가산디지털단지,51300,51915,103215,10
2023-10-24,7호선,고속터미널,16980,15224,32204,10
2023-10-25,2호선,홍대입구,66739,71139,137878,10
2023-10-25,2호선,구로디지털단지,65400,64855,130255,10
2023-10-25,2호선,신림,59727,57499,117226,10
2023-10-25,2호선,사당,43814,47383,91197,10
2023-10-25,2호선,강남,86575,83049,169624,10
2023-10-25,2호선,선릉,66416,58264,124680,10
2023-10-25,2호선,잠실(송파구청),80887,81657,162544,10
2023-10-25,신림선,신림,1837,2575,4412,10
2023-10-25,1호선,서울역,57700,55408,113108,10
2023-10-25,분당선,선릉,14999,23448,38447,10
2023-10-25,공항철도 1호선,홍대입구,14031,13750,27781,10
2023-10-25,공항철도 1호선,서울역,13181,11430,24611,10
2023-10-25,경의선,홍대입구,2280,2672,4952,10
2023-10-25,경의선,서울역,5458,6714,12172,10
2023-10-25,경부선,가산디지털단지,20072,22560,42632,10
2023-10-25,경부선,서울역,8455,2723,11178,10
2023-10-25,9호선,고속터미널,14907,19359,34266,10
2023-10-25,8호선,잠실(송파구청),16281,19314,35595,10
2023-10-25,7호선,가산디지털단지,50896,51530,102426,10
2023-10-25,7호선,고속터미널,17248,15188,32436,10
2023-10-25,4호선,사당,28860,25337,54197,10
2023-10-25,4호선,서울역,14485,22394,36879,10
2023-10-25,3호선,고속터미널,43573,40263,83836,10
2023-10-26,2호선,구로디지털단지,64470,63826,128296,10
2023-10-26,2호선,신림,58680,56121,114801,10
2023-10-26,2호선,사당,43484,47576,91060,10
2023-10-26,2호선,강남,86366,83563,169929,10
2023-10-26,2호선,선릉,66003,58404,124407,10
2023-10-26,2호선,잠실(송파구청),81608,82496,164104,10
2023-10-26,1호선,서울역,59730,56591,116321,10
2023-10-26,신림선,신림,1830,2550,4380,10
2023-10-26,분당선,선릉,15216,23472,38688,10
2023-10-26,공항철도 1호선,홍대입구,13909,13854,27763,10
2023-10-26,공항철도 1호선,서울역,13849,11846,25695,10
2023-10-26,경의선,홍대입구,2181,2585,4766,10
2023-10-26,경의선,서울역,5550,6991,12541,10
2023-10-26,경부선,가산디지털단지,19813,22273,42086,10
2023-10-26,경부선,서울역,8953,2821,11774,10
2023-10-26,9호선,고속터미널,15165,19346,34511,10
2023-10-26,8호선,잠실(송파구청),15986,18871,34857,10
2023-10-26,7호선,가산디지털단지,50094,50829,100923,10
2023-10-26,7호선,고속터미널,17586,14959,32545,10
2023-10-26,4호선,사당,28826,25048,53874,10
2023-10-26,4호선,서울역,14632,23488,38120,10
2023-10-26,3호선,고속터미널,44682,41589,86271,10
2023-10-26,2호선,홍대입구,68566,73371,141937,10
2023-10-27,공항철도 1호선,서울역,16336,14358,30694,10
2023-10-27,공항철도 1호선,홍대입구,16398,16520,32918,10
2023-10-27,분당선,선릉,14513,22727,37240,10
2023-10-27,신림선,신림,1803,2482,4285,10
2023-10-27,1호선,서울역,65841,64141,129982,10
2023-10-27,2호선,잠실(송파구청),91292,91915,183207,10
2023-10-27,2호선,선릉,64154,56464,120618,10
2023-10-27,2호선,강남,91273,90063,181336,10
2023-10-27,2호선,사당,46602,52406,99008,10
2023-10-27,2호선,신림,61217,58251,119468,10
2023-10-27,2호선,구로디지털단지,65347,64898,130245,10
2023-10-27,2호선,홍대입구,75749,88201,163950,10
2023-10-27,3호선,고속터미널,55455,55101,110556,10
2023-10-27,4호선,서울역,14942,25957,40899,10
2023-10-27,4호선,사당,31249,27895,59144,10
2023-10-27,7호선,고속터미널,21392,16744,38136,10
2023-10-27,7호선,가산디지털단지,49599,49872,99471,10
2023-10-27,8호선,잠실(송파구청),17393,21281,38674,10
2023-10-27,9호선,고속터미널,18104,24653,42757,10
2023-10-27,경부선,서울역,11621,3907,15528,10
2023-10-27,경부선,가산디지털단지,20005,22405,42410,10
2023-10-27,경의선,서울역,5726,6958,12684,10
2023-10-27,경의선,홍대입구,2456,3183,5639,10
2023-10-28,1호선,서울역,53466,52472,105938,10
2023-10-28,2호선,잠실(송파구청),83429,79996,163425,10
2023-10-28,2호선,선릉,29664,25773,55437,10
2023-10-28,2호선,강남,61357,60921,122278,10
2023-10-28,2호선,사당,40508,46058,86566,10
2023-10-28,2호선,신림,50050,46615,96665,10
2023-10-28,2호선,구로디지털단지,40425,39108,79533,10
2023-10-28,2호선,홍대입구,85176,102119,187295,10
2023-10-28,3호선,고속터미널,59938,59231,119169,10
2023-10-28,4호선,서울역,8849,22701,31550,10
2023-10-28,4호선,사당,27025,25851,52876,10
2023-10-28,7호선,고속터미널,18697,13886,32583,10
2023-10-28,7호선,가산디지털단지,15866,14668,30534,10
2023-10-28,8호선,잠실(송파구청),15676,18595,34271,10
2023-10-28,9호선,고속터미널,17492,26144,43636,10
2023-10-28,경부선,서울역,12199,3427,15626,10
2023-10-28,경부선,가산디지털단지,7878,9495,17373,10
2023-10-28,경의선,서울역,2002,2207,4209,10
2023-10-28,경의선,홍대입구,2967,3963,6930,10
2023-10-28,공항철도 1호선,서울역,15428,14928,30356,10
2023-10-28,공항철도 1호선,홍대입구,19880,19825,39705,10
2023-10-28,분당선,선릉,5963,9665,15628,10
2023-10-28,신림선,신림,1395,1983,3378,10
2023-10-29,2호선,잠실(송파구청),62686,57995,120681,10
2023-10-29,2호선,선릉,16336,13822,30158,10
2023-10-29,2호선,강남,35796,33350,69146,10
2023-10-29,2호선,사당,28463,30804,59267,10
2023-10-29,2호선,신림,37015,35920,72935,10
2023-10-29,2호선,구로디지털단지,29330,28513,57843,10
2023-10-29,2호선,홍대입구,67995,67699,135694,10
2023-10-29,3호선,고속터미널,50558,46643,97201,10
2023-10-29,1호선,서울역,42279,40662,82941,10
2023-10-29,신림선,신림,1186,1776,2962,10
2023-10-29,분당선,선릉,3200,5120,8320,10
2023-10-29,공항철도 1호선,홍대입구,16360,14391,30751,10
2023-10-29,공항철도 1호선,서울역,14416,13632,28048,10
2023-10-29,경의선,홍대입구,2357,2883,5240,10
2023-10-29,경의선,서울역,1617,1612,3229,10
2023-10-29,경부선,가산디지털단지,5971,7450,13421,10
2023-10-29,경부선,서울역,11533,2914,14447,10
2023-10-29,9호선,고속터미널,15175,21674,36849,10
2023-10-29,8호선,잠실(송파구청),12257,13569,25826,10
2023-10-29,7호선,가산디지털단지,11400,10857,22257,10
2023-10-29,7호선,고속터미널,17318,10836,28154,10
2023-10-29,4호선,사당,20258,19021,39279,10
2023-10-29,4호선,서울역,6637,18270,24907,10
2023-10-30,1호선,서울역,58053,54734,112787,10
2023-10-30,신림선,신림,1777,2476,4253,10
2023-10-30,분당선,선릉,14765,22833,37598,10
2023-10-30,공항철도 1호선,홍대입구,13090,12956,26046,10
2023-10-30,공항철도 1호선,서울역,13610,11952,25562,10
2023-10-30,경의선,홍대입구,2054,2437,4491,10
2023-10-30,경의선,서울역,5691,6997,12688,10
2023-10-30,경부선,가산디지털단지,19784,22274,42058,10
2023-10-30,경부선,서울역,9474,2985,12459,10
2023-10-30,9호선,고속터미널,14554,19347,33901,10
2023-10-30,8호선,잠실(송파구청),15756,18399,34155,10
2023-10-30,7호선,가산디지털단지,50459,51445,101904,10
2023-10-30,7호선,고속터미널,18178,15343,33521,10
2023-10-30,4호선,사당,28008,24499,52507,10
2023-10-30,4호선,서울역,14119,22121,36240,10
2023-10-30,3호선,고속터미널,43556,41073,84629,10
2023-10-30,2호선,홍대입구,64125,67932,132057,10
2023-10-30,2호선,구로디지털단지,63530,62965,126495,10
2023-10-30,2호선,신림,57197,54311,111508,10
2023-10-30,2호선,사당,41217,45428,86645,10
2023-10-30,2호선,강남,83568,80824,164392,10
2023-10-30,2호선,선릉,64435,56518,120953,10
2023-10-30,2호선,잠실(송파구청),76567,77303,153870,10
2023-10-31,4호선,사당,28694,24904,53598,10
2023-10-31,4호선,서울역,14006,21074,35080,10
2023-10-31,1호선,서울역,56053,53068,109121,10
2023-10-31,3호선,고속터미널,42330,39585,81915,10
2023-10-31,2호선,구로디지털단지,64252,63720,127972,10
2023-10-31,2호선,신림,58160,55443,113603,10
2023-10-31,2호선,사당,43265,46641,89906,10
2023-10-31,2호선,강남,84919,82440,167359,10
2023-10-31,2호선,선릉,65657,57974,123631,10
2023-10-31,2호선,잠실(송파구청),78308,78801,157109,10
2023-10-31,2호선,홍대입구,66885,74653,141538,10
2023-10-31,7호선,고속터미널,17517,15436,32953,10
2023-10-31,7호선,가산디지털단지,50791,51620,102411,10
2023-10-31,8호선,잠실(송파구청),15798,18702,34500,10
2023-10-31,9호선,고속터미널,14323,18317,32640,10
2023-10-31,경부선,서울역,8090,2618,10708,10
2023-10-31,경부선,가산디지털단지,20212,22719,42931,10
2023-10-31,경의선,서울역,5505,6888,12393,10
2023-10-31,경의선,홍대입구,2162,2755,4917,10
2023-10-31,공항철도 1호선,서울역,12499,10842,23341,10
2023-10-31,공항철도 1호선,홍대입구,13381,13164,26545,10
2023-10-31,분당선,선릉,15210,23143,38353,10
2023-10-31,신림선,신림,1862,2554,4416,10
2023-11-01,1호선,서울역,55292,52681,107973,11
2023-11-01,2호선,잠실(송파구청),78504,78779,157283,11
2023-11-01,2호선,선릉,64545,56961,121506,11
2023-11-01,2호선,강남,83370,80354,163724,11
2023-11-01,2호선,사당,41856,45202,87058,11
2023-11-01,2호선,신림,58193,55772,113965,11
2023-11-01,2호선,구로디지털단지,64353,63856,128209,11
2023-11-01,2호선,홍대입구,66487,69615,136102,11
2023-11-01,3호선,고속터미널,42177,39104,81281,11
2023-11-01,4호선,서울역,14194,21453,35647,11
2023-11-01,4호선,사당,27346,24290,51636,11
2023-11-01,7호선,고속터미널,16716,14859,31575,11
2023-11-01,7호선,가산디지털단지,50391,51059,101450,11
2023-11-01,8호선,잠실(송파구청),15822,18982,34804,11
2023-11-01,9호선,고속터미널,14067,18765,32832,11
2023-11-01,경부선,서울역,7610,2649,10259,11
2023-11-01,경부선,가산디지털단지,19967,22511,42478,11
2023-11-01,경의선,서울역,5459,6998,12457,11
2023-11-01,경의선,홍대입구,2182,2517,4699,11
2023-11-01,공항철도 1호선,서울역,12289,10674,22963,11
2023-11-01,공항철도 1호선,홍대입구,13347,13194,26541,11
2023-11-01,분당선,선릉,15038,22735,37773,11
2023-11-01,신림선,신림,1793,2514,4307,11
2023-11-02,1호선,서울역,58096,56192,114288,11
2023-11-02,분당선,선릉,15135,23222,38357,11
2023-11-02,2호선,잠실(송파구청),83207,84006,167213,11
2023-11-02,2호선,선릉,64834,57904,122738,11
2023-11-02,2호선,강남,86463,83281,169744,11
2023-11-02,2호선,사당,42896,46812,89708,11
2023-11-02,2호선,신림,59011,56444,115455,11
2023-11-02,2호선,구로디지털단지,64091,63713,127804,11
2023-11-02,2호선,홍대입구,68462,73413,141875,11
2023-11-02,3호선,고속터미널,44962,41264,86226,11
2023-11-02,4호선,서울역,14215,22602,36817,11
2023-11-02,4호선,사당,28738,25365,54103,11
2023-11-02,7호선,고속터미널,17568,15246,32814,11
2023-11-02,7호선,가산디지털단지,50349,51265,101614,11
2023-11-02,8호선,잠실(송파구청),16377,19320,35697,11
2023-11-02,9호선,고속터미널,15010,19631,34641,11
2023-11-02,경부선,서울역,8558,2927,11485,11
2023-11-02,경부선,가산디지털단지,19917,22474,42391,11
2023-11-02,경의선,서울역,5609,7161,12770,11
2023-11-02,경의선,홍대입구,2250,2666,4916,11
2023-11-02,공항철도 1호선,서울역,13817,11522,25339,11
2023-11-02,공항철도 1호선,홍대입구,13709,13921,27630,11
2023-11-02,신림선,신림,1826,2555,4381,11
2023-11-03,신림선,신림,1832,2551,4383,11
2023-11-03,분당선,선릉,14553,22211,36764,11
2023-11-03,공항철도 1호선,홍대입구,15748,16470,32218,11
2023-11-03,공항철도 1호선,서울역,16649,14835,31484,11
2023-11-03,경의선,홍대입구,2406,3040,5446,11
2023-11-03,경의선,서울역,5570,7081,12651,11
2023-11-03,경부선,가산디지털단지,19845,22098,41943,11
2023-11-03,경부선,서울역,11546,4159,15705,11
2023-11-03,9호선,고속터미널,17796,24915,42711,11
2023-11-03,8호선,잠실(송파구청),17179,20905,38084,11
2023-11-03,7호선,가산디지털단지,49155,49532,98687,11
2023-11-03,7호선,고속터미널,21498,17030,38528,11
2023-11-03,4호선,사당,30517,27039,57556,11
2023-11-03,4호선,서울역,14506,25877,40383,11
2023-11-03,3호선,고속터미널,53979,54186,108165,11
2023-11-03,2호선,홍대입구,78259,89065,167324,11
2023-11-03,2호선,구로디지털단지,64988,64172,129160,11
2023-11-03,2호선,신림,60486,57755,118241,11
2023-11-03,2호선,사당,44946,50431,95377,11
2023-11-03,2호선,강남,90435,88464,178899,11
2023-11-03,2호선,선릉,62806,55642,118448,11
2023-11-03,2호선,잠실(송파구청),87825,88920,176745,11
2023-11-03,1호선,서울역,65431,63645,129076,11
2023-11-04,2호선,신림,49027,46062,95089,11
2023-11-04,2호선,홍대입구,86327,100490,186817,11
2023-11-04,2호선,구로디지털단지,39631,38584,78215,11
2023-11-04,3호선,고속터미널,58890,58216,117106,11
2023-11-04,2호선,사당,38968,43634,82602,11
2023-11-04,2호선,강남,60880,59857,120737,11
2023-11-04,2호선,선릉,28934,24978,53912,11
2023-11-04,2호선,잠실(송파구청),83726,80355,164081,11
2023-11-04,1호선,서울역,51951,50017,101968,11
2023-11-04,4호선,서울역,8743,22468,31211,11
2023-11-04,4호선,사당,26108,24302,50410,11
2023-11-04,7호선,고속터미널,18681,13986,32667,11
2023-11-04,7호선,가산디지털단지,15165,14007,29172,11
2023-11-04,8호선,잠실(송파구청),15390,18563,33953,11
2023-11-04,9호선,고속터미널,18435,27217,45652,11
2023-11-04,경부선,서울역,12215,3340,15555,11
2023-11-04,경부선,가산디지털단지,7584,9370,16954,11
2023-11-04,경의선,서울역,1956,2112,4068,11
2023-11-04,경의선,홍대입구,2744,3785,6529,11
2023-11-04,공항철도 1호선,서울역,15459,15013,30472,11
2023-11-04,공항철도 1호선,홍대입구,19816,19257,39073,11
2023-11-04,분당선,선릉,5727,9316,15043,11
2023-11-04,신림선,신림,1406,1913,3319,11
2023-11-05,신림선,신림,1023,1451,2474,11
2023-11-05,분당선,선릉,3098,4788,7886,11
2023-11-05,공항철도 1호선,홍대입구,14556,13411,27967,11
2023-11-05,공항철도 1호선,서울역,14977,13718,28695,11
2023-11-05,경의선,홍대입구,1938,2554,4492,11
2023-11-05,경의선,서울역,1347,1225,2572,11
2023-11-05,경부선,가산디지털단지,5169,6495,11664,11
2023-11-05,경부선,서울역,11446,2963,14409,11
2023-11-05,9호선,고속터미널,14130,21466,35596,11
2023-11-05,8호선,잠실(송파구청),12165,14835,27000,11
2023-11-05,7호선,가산디지털단지,9996,9615,19611,11
2023-11-05,7호선,고속터미널,16607,9941,26548,11
2023-11-05,4호선,사당,17420,16248,33668,11
2023-11-05,4호선,서울역,6310,17005,23315,11
2023-11-05,3호선,고속터미널,49994,45111,95105,11
2023-11-05,2호선,홍대입구,62082,62565,124647,11
2023-11-05,2호선,구로디지털단지,26895,26054,52949,11
2023-11-05,2호선,신림,34314,33346,67660,11
2023-11-05,2호선,사당,24982,27033,52015,11
2023-11-05,2호선,강남,33535,31592,65127,11
2023-11-05,2호선,선릉,15810,13803,29613,11
2023-11-05,2호선,잠실(송파구청),57753,55360,113113,11
2023-11-05,1호선,서울역,39768,39132,78900,11
2023-11-06,신림선,신림,1841,2522,4363,11
2023-11-06,분당선,선릉,14828,22765,37593,11
2023-11-06,공항철도 1호선,홍대입구,11784,11696,23480,11
2023-11-06,공항철도 1호선,서울역,13697,11812,25509,11
2023-11-06,경의선,홍대입구,1722,2129,3851,11
2023-11-06,경의선,서울역,5390,6818,12208,11
2023-11-06,경부선,가산디지털단지,19052,22106,41158,11
2023-11-06,경부선,서울역,9373,3171,12544,11
2023-11-06,9호선,고속터미널,13893,18916,32809,11
2023-11-06,8호선,잠실(송파구청),15373,17925,33298,11
2023-11-06,7호선,가산디지털단지,50988,51012,102000,11
2023-11-06,7호선,고속터미널,17277,14748,32025,11
2023-11-06,4호선,사당,26079,22513,48592,11
2023-11-06,4호선,서울역,13274,20851,34125,11
2023-11-06,3호선,고속터미널,43727,40907,84634,11
2023-11-06,2호선,홍대입구,60804,62686,123490,11
2023-11-06,2호선,구로디지털단지,61238,60847,122085,11
2023-11-06,2호선,신림,55415,52948,108363,11
2023-11-06,2호선,사당,38055,41495,79550,11
2023-11-06,2호선,강남,81763,78311,160074,11
2023-11-06,2호선,선릉,62052,55108,117160,11
2023-11-06,2호선,잠실(송파구청),71188,72459,143647,11
2023-11-06,1호선,서울역,56988,52844,109832,11
2023-11-07,1호선,서울역,56566,53233,109799,11
2023-11-07,2호선,잠실(송파구청),80630,81232,161862,11
2023-11-07,2호선,선릉,66295,58043,124338,11
2023-11-07,2호선,강남,86310,83282,169592,11
2023-11-07,2호선,사당,42090,46067,88157,11
2023-11-07,2호선,신림,58160,55673,113833,11
2023-11-07,2호선,구로디지털단지,63702,63128,126830,11
2023-11-07,2호선,홍대입구,65319,68758,134077,11
2023-11-07,3호선,고속터미널,44043,40421,84464,11
2023-11-07,4호선,서울역,14200,21376,35576,11
2023-11-07,4호선,사당,28521,24849,53370,11
2023-11-07,7호선,고속터미널,16907,15119,32026,11
2023-11-07,7호선,가산디지털단지,51922,51875,103797,11
2023-11-07,8호선,잠실(송파구청),16231,19263,35494,11
2023-11-07,9호선,고속터미널,14465,19090,33555,11
2023-11-07,경부선,서울역,7869,2592,10461,11
2023-11-07,경부선,가산디지털단지,19845,22588,42433,11
2023-11-07,경의선,서울역,5505,6820,12325,11
2023-11-07,경의선,홍대입구,1974,2390,4364,11
2023-11-07,공항철도 1호선,서울역,12155,10617,22772,11
2023-11-07,공항철도 1호선,홍대입구,12731,12766,25497,11
2023-11-07,분당선,선릉,15481,23726,39207,11
2023-11-07,신림선,신림,1851,2538,4389,11
2023-11-08,1호선,서울역,57960,55261,113221,11
2023-11-08,2호선,잠실(송파구청),81482,82607,164089,11
2023-11-08,2호선,선릉,65603,57625,123228,11
2023-11-08,2호선,강남,87468,84296,171764,11
2023-11-08,2호선,사당,43067,47296,90363,11
2023-11-08,2호선,신림,59227,56714,115941,11
2023-11-08,2호선,구로디지털단지,64640,64114,128754,11
2023-11-08,2호선,홍대입구,65921,70186,136107,11
2023-11-08,3호선,고속터미널,45209,41437,86646,11
2023-11-08,4호선,서울역,14452,22757,37209,11
2023-11-08,4호선,사당,28939,24984,53923,11
2023-11-08,7호선,고속터미널,16964,15040,32004,11
2023-11-08,7호선,가산디지털단지,51019,51767,102786,11
2023-11-08,8호선,잠실(송파구청),16420,19003,35423,11
2023-11-08,9호선,고속터미널,14977,19964,34941,11
2023-11-08,경부선,서울역,8657,2795,11452,11
2023-11-08,경부선,가산디지털단지,19832,22350,42182,11
2023-11-08,경의선,서울역,5552,6770,12322,11
2023-11-08,경의선,홍대입구,2072,2519,4591,11
2023-11-08,공항철도 1호선,서울역,12559,10778,23337,11
2023-11-08,공항철도 1호선,홍대입구,13232,13294,26526,11
2023-11-08,분당선,선릉,15260,23288,38548,11
2023-11-08,신림선,신림,1884,2676,4560,11
2023-11-09,2호선,선릉,63214,57134,120348,11
2023-11-09,2호선,잠실(송파구청),78806,79809,158615,11
2023-11-09,신림선,신림,1844,2600,4444,11
2023-11-09,1호선,서울역,58863,55613,114476,11
2023-11-09,4호선,사당,28850,25414,54264,11
2023-11-09,4호선,서울역,14203,22858,37061,11
2023-11-09,3호선,고속터미널,44764,41922,86686,11
2023-11-09,2호선,홍대입구,64370,69514,133884,11
2023-11-09,2호선,구로디지털단지,62717,61984,124701,11
2023-11-09,2호선,신림,57538,54159,111697,11
2023-11-09,2호선,사당,42514,46502,89016,11
2023-11-09,2호선,강남,83471,82645,166116,11
2023-11-09,분당선,선릉,15679,23394,39073,11
2023-11-09,공항철도 1호선,홍대입구,13097,13209,26306,11
2023-11-09,공항철도 1호선,서울역,13625,11555,25180,11
2023-11-09,경의선,홍대입구,1987,2370,4357,11
2023-11-09,경의선,서울역,5583,6700,12283,11
2023-11-09,경부선,가산디지털단지,19141,22479,41620,11
2023-11-09,경부선,서울역,9183,3020,12203,11
2023-11-09,9호선,고속터미널,15631,19981,35612,11
2023-11-09,8호선,잠실(송파구청),15728,18829,34557,11
2023-11-09,7호선,가산디지털단지,50147,51008,101155,11
2023-11-09,7호선,고속터미널,17716,15288,33004,11
2023-11-10,1호선,서울역,64472,62516,126988,11
2023-11-10,신림선,신림,1914,2728,4642,11
2023-11-10,분당선,선릉,14749,22334,37083,11
2023-11-10,공항철도 1호선,홍대입구,15056,15923,30979,11
2023-11-10,공항철도 1호선,서울역,16166,14405,30571,11
2023-11-10,경의선,홍대입구,2173,2918,5091,11
2023-11-10,경의선,서울역,5404,6763,12167,11
2023-11-10,경부선,가산디지털단지,18737,21744,40481,11
2023-11-10,경부선,서울역,11184,3934,15118,11
2023-11-10,9호선,고속터미널,18022,25037,43059,11
2023-11-10,8호선,잠실(송파구청),17311,20634,37945,11
2023-11-10,7호선,가산디지털단지,50001,49621,99622,11
2023-11-10,7호선,고속터미널,20600,16159,36759,11
2023-11-10,4호선,사당,31536,28532,60068,11
2023-11-10,4호선,서울역,14624,25705,40329,11
2023-11-10,3호선,고속터미널,55949,55342,111291,11
2023-11-10,2호선,홍대입구,74326,83852,158178,11
2023-11-10,2호선,구로디지털단지,63760,62481,126241,11
2023-11-10,2호선,신림,60064,56345,116409,11
2023-11-10,2호선,사당,45496,51619,97115,11
2023-11-10,2호선,강남,88806,88950,177756,11
2023-11-10,2호선,선릉,62316,55329,117645,11
2023-11-10,2호선,잠실(송파구청),87142,88534,175676,11
2023-11-11,경의선,서울역,1820,1990,3810,11
2023-11-11,경의선,홍대입구,2549,3527,6076,11
2023-11-11,공항철도 1호선,서울역,14899,14804,29703,11
2023-11-11,공항철도 1호선,홍대입구,18317,18331,36648,11
2023-11-11,분당선,선릉,5622,9187,14809,11
2023-11-11,신림선,신림,1426,2055,3481,11
2023-11-11,1호선,서울역,54305,53082,107387,11
2023-11-11,2호선,잠실(송파구청),82743,80763,163506,11
2023-11-11,2호선,선릉,29023,25211,54234,11
2023-11-11,2호선,강남,62371,61554,123925,11
2023-11-11,2호선,사당,39423,44206,83629,11
2023-11-11,2호선,신림,48941,46030,94971,11
2023-11-11,2호선,구로디지털단지,37839,37801,75640,11
2023-11-11,2호선,홍대입구,88883,101401,190284,11
2023-11-11,3호선,고속터미널,62661,61526,124187,11
2023-11-11,4호선,서울역,9060,22366,31426,11
2023-11-11,4호선,사당,27033,25341,52374,11
2023-11-11,7호선,고속터미널,18976,13930,32906,11
2023-11-11,7호선,가산디지털단지,16553,14959,31512,11
2023-11-11,8호선,잠실(송파구청),16623,19102,35725,11
2023-11-11,9호선,고속터미널,17759,27446,45205,11
2023-11-11,경부선,서울역,11581,3444,15025,11
2023-11-11,경부선,가산디지털단지,7443,9217,16660,11
2023-11-12,신림선,신림,1158,1556,2714,11
2023-11-12,분당선,선릉,2944,4867,7811,11
2023-11-12,공항철도 1호선,홍대입구,14681,13641,28322,11
2023-11-12,공항철도 1호선,서울역,14474,13150,27624,11
2023-11-12,경의선,홍대입구,1931,2557,4488,11
2023-11-12,경의선,서울역,1266,1275,2541,11
2023-11-12,경부선,가산디지털단지,5568,6987,12555,11
2023-11-12,경부선,서울역,11173,2798,13971,11
2023-11-12,9호선,고속터미널,14044,21332,35376,11
2023-11-12,8호선,잠실(송파구청),12615,13778,26393,11
2023-11-12,7호선,가산디지털단지,12188,11402,23590,11
2023-11-12,7호선,고속터미널,16541,10095,26636,11
2023-11-12,4호선,사당,18503,17190,35693,11
2023-11-12,4호선,서울역,6321,16998,23319,11
2023-11-12,3호선,고속터미널,52963,47683,100646,11
2023-11-12,2호선,홍대입구,66029,66251,132280,11
2023-11-12,2호선,구로디지털단지,26587,25291,51878,11
2023-11-12,2호선,신림,35468,34497,69965,11
2023-11-12,2호선,사당,26210,27928,54138,11
2023-11-12,2호선,강남,35958,33920,69878,11
2023-11-12,2호선,선릉,15815,13363,29178,11
2023-11-12,2호선,잠실(송파구청),60304,56541,116845,11
2023-11-12,1호선,서울역,38646,38236,76882,11
2023-11-13,공항철도 1호선,서울역,13493,12065,25558,11
2023-11-13,공항철도 1호선,홍대입구,12463,12479,24942,11
2023-11-13,분당선,선릉,14862,22648,37510,11
2023-11-13,신림선,신림,1813,2496,4309,11
2023-11-13,1호선,서울역,57190,53322,110512,11
2023-11-13,2호선,잠실(송파구청),77397,78351,155748,11
2023-11-13,2호선,선릉,63617,56042,119659,11
2023-11-13,2호선,강남,83500,80215,163715,11
2023-11-13,2호선,사당,39351,42687,82038,11
2023-11-13,2호선,신림,55875,53287,109162,11
2023-11-13,2호선,구로디지털단지,61731,61093,122824,11
2023-11-13,2호선,홍대입구,62581,65753,128334,11
2023-11-13,3호선,고속터미널,44436,41757,86193,11
2023-11-13,4호선,서울역,13617,21562,35179,11
2023-11-13,4호선,사당,28332,23448,51780,11
2023-11-13,7호선,고속터미널,17312,14630,31942,11
2023-11-13,7호선,가산디지털단지,50953,51064,102017,11
2023-11-13,8호선,잠실(송파구청),16245,18518,34763,11
2023-11-13,9호선,고속터미널,14317,19542,33859,11
2023-11-13,경부선,서울역,9408,2899,12307,11
2023-11-13,경부선,가산디지털단지,19244,21757,41001,11
2023-11-13,경의선,서울역,5379,6732,12111,11
2023-11-13,경의선,홍대입구,1894,2091,3985,11
2023-11-14,8호선,잠실(송파구청),15924,18586,34510,11
2023-11-14,3호선,고속터미널,43241,40730,83971,11
2023-11-14,4호선,서울역,14140,21725,35865,11
2023-11-14,4호선,사당,26435,24058,50493,11
2023-11-14,7호선,고속터미널,16995,15034,32029,11
2023-11-14,9호선,고속터미널,14050,18633,32683,11
2023-11-14,경부선,서울역,8235,2746,10981,11
2023-11-14,경부선,가산디지털단지,19768,22388,42156,11
2023-11-14,경의선,서울역,5408,6801,12209,11
2023-11-14,경의선,홍대입구,1891,2285,4176,11
2023-11-14,공항철도 1호선,서울역,12248,10627,22875,11
2023-11-14,공항철도 1호선,홍대입구,12541,12145,24686,11
2023-11-14,분당선,선릉,15336,23418,38754,11
2023-11-14,7호선,가산디지털단지,51280,51882,103162,11
2023-11-14,신림선,신림,1789,2545,4334,11
2023-11-14,1호선,서울역,56279,53091,109370,11
2023-11-14,2호선,잠실(송파구청),76904,77513,154417,11
2023-11-14,2호선,선릉,65265,57346,122611,11
2023-11-14,2호선,강남,86239,82664,168903,11
2023-11-14,2호선,사당,41066,44380,85446,11
2023-11-14,2호선,신림,57346,54697,112043,11
2023-11-14,2호선,구로디지털단지,63241,62612,125853,11
2023-11-14,2호선,홍대입구,63538,67333,130871,11
2023-11-15,1호선,서울역,57235,54674,111909,11
2023-11-15,2호선,잠실(송파구청),80425,81618,162043,11
2023-11-15,2호선,선릉,65744,57888,123632,11
2023-11-15,2호선,강남,86504,82849,169353,11
2023-11-15,2호선,사당,42654,45672,88326,11
2023-11-15,2호선,신림,59445,56824,116269,11
2023-11-15,2호선,구로디지털단지,64433,64216,128649,11
2023-11-15,2호선,홍대입구,67408,72013,139421,11
2023-11-15,3호선,고속터미널,44823,41421,86244,11
2023-11-15,4호선,서울역,14328,22572,36900,11
2023-11-15,4호선,사당,28887,24409,53296,11
2023-11-15,7호선,고속터미널,17488,15429,32917,11
2023-11-15,7호선,가산디지털단지,51026,51626,102652,11
2023-11-15,8호선,잠실(송파구청),16623,19506,36129,11
2023-11-15,9호선,고속터미널,14556,19199,33755,11
2023-11-15,경부선,서울역,8489,2918,11407,11
2023-11-15,경부선,가산디지털단지,19956,22447,42403,11
2023-11-15,경의선,서울역,5485,6864,12349,11
2023-11-15,경의선,홍대입구,2151,2477,4628,11
2023-11-15,공항철도 1호선,서울역,12608,11191,23799,11
2023-11-15,공항철도 1호선,홍대입구,13277,13233,26510,11
2023-11-15,분당선,선릉,15155,23163,38318,11
2023-11-15,신림선,신림,1899,2557,4456,11
2023-11-16,1호선,서울역,58309,55736,114045,11
2023-11-16,4호선,사당,27767,24318,52085,11
2023-11-16,7호선,고속터미널,17774,14923,32697,11
2023-11-16,7호선,가산디지털단지,49871,49894,99765,11
2023-11-16,8호선,잠실(송파구청),16653,19405,36058,11
2023-11-16,9호선,고속터미널,14999,20104,35103,11
2023-11-16,경부선,서울역,9138,3306,12444,11
2023-11-16,경부선,가산디지털단지,18743,21468,40211,11
2023-11-16,경의선,서울역,5379,6784,12163,11
2023-11-16,경의선,홍대입구,2026,2439,4465,11
2023-11-16,공항철도 1호선,서울역,14398,12313,26711,11
2023-11-16,공항철도 1호선,홍대입구,13221,13505,26726,11
2023-11-16,분당선,선릉,14850,22924,37774,11
2023-11-16,신림선,신림,1808,2573,4381,11
2023-11-16,2호선,홍대입구,67294,72824,140118,11
2023-11-16,2호선,구로디지털단지,62162,61663,123825,11
2023-11-16,2호선,신림,57353,54537,111890,11
2023-11-16,2호선,사당,41119,45071,86190,11
2023-11-16,2호선,강남,84622,80883,165505,11
2023-11-16,2호선,선릉,63409,55684,119093,11
2023-11-16,2호선,잠실(송파구청),79186,79596,158782,11
2023-11-16,3호선,고속터미널,46851,43395,90246,11
2023-11-16,4호선,서울역,14295,23798,38093,11
2023-11-17,1호선,서울역,65625,63843,129468,11
2023-11-17,2호선,잠실(송파구청),86758,87249,174007,11
2023-11-17,2호선,선릉,64398,56847,121245,11
2023-11-17,2호선,강남,91071,90234,181305,11
2023-11-17,2호선,사당,45278,49823,95101,11
2023-11-17,2호선,신림,60957,57950,118907,11
2023-11-17,2호선,구로디지털단지,64219,63269,127488,11
2023-11-17,신림선,신림,1880,2522,4402,11
2023-11-17,분당선,선릉,14812,22949,37761,11
2023-11-17,공항철도 1호선,홍대입구,15548,16132,31680,11
2023-11-17,공항철도 1호선,서울역,16152,14451,30603,11
2023-11-17,경의선,홍대입구,2282,3074,5356,11
2023-11-17,경의선,서울역,5428,6877,12305,11
2023-11-17,경부선,가산디지털단지,18898,21601,40499,11
2023-11-17,경부선,서울역,12484,4357,16841,11
2023-11-17,9호선,고속터미널,17800,25084,42884,11
2023-11-17,8호선,잠실(송파구청),18215,21385,39600,11
2023-11-17,7호선,가산디지털단지,49529,48934,98463,11
2023-11-17,7호선,고속터미널,21509,16869,38378,11
2023-11-17,4호선,사당,29019,27278,56297,11
2023-11-17,4호선,서울역,14715,26392,41107,11
2023-11-17,3호선,고속터미널,57875,57944,115819,11
2023-11-17,2호선,홍대입구,81406,90735,172141,11
2023-11-18,공항철도 1호선,서울역,14819,14391,29210,11
2023-11-18,공항철도 1호선,홍대입구,18539,18019,36558,11
2023-11-18,분당선,선릉,6152,9752,15904,11
2023-11-18,2호선,홍대입구,90391,101208,191599,11
2023-11-18,2호선,구로디지털단지,38134,36970,75104,11
2023-11-18,2호선,신림,47617,44468,92085,11
2023-11-18,2호선,사당,38687,42798,81485,11
2023-11-18,2호선,강남,62670,61921,124591,11
2023-11-18,2호선,선릉,29015,25395,54410,11
2023-11-18,2호선,잠실(송파구청),81937,81574,163511,11
2023-11-18,1호선,서울역,51050,48851,99901,11
2023-11-18,9호선,고속터미널,17466,26750,44216,11
2023-11-18,신림선,신림,1391,1911,3302,11
2023-11-18,8호선,잠실(송파구청),16811,19449,36260,11
2023-11-18,7호선,가산디지털단지,15605,14316,29921,11
2023-11-18,7호선,고속터미널,19649,14438,34087,11
2023-11-18,경부선,서울역,12679,3446,16125,11
2023-11-18,경부선,가산디지털단지,7041,8860,15901,11
2023-11-18,3호선,고속터미널,63084,61539,124623,11
2023-11-18,경의선,서울역,1813,1922,3735,11
2023-11-18,경의선,홍대입구,2491,3204,5695,11
2023-11-18,4호선,사당,25000,23656,48656,11
2023-11-18,4호선,서울역,8268,22095,30363,11
2023-11-19,분당선,선릉,3417,5220,8637,11
2023-11-19,공항철도 1호선,홍대입구,15439,13768,29207,11
2023-11-19,공항철도 1호선,서울역,14623,13351,27974,11
2023-11-19,1호선,서울역,41184,40337,81521,11
2023-11-19,2호선,잠실(송파구청),61151,57085,118236,11
2023-11-19,2호선,선릉,16738,14302,31040,11
2023-11-19,2호선,강남,37120,35442,72562,11
2023-11-19,2호선,사당,26762,29025,55787,11
2023-11-19,2호선,신림,36519,35377,71896,11
2023-11-19,2호선,구로디지털단지,28019,27234,55253,11
2023-11-19,2호선,홍대입구,69081,69525,138606,11
2023-11-19,8호선,잠실(송파구청),12460,13671,26131,11
2023-11-19,3호선,고속터미널,52496,47936,100432,11
2023-11-19,경의선,서울역,1398,1310,2708,11
2023-11-19,경의선,홍대입구,2162,2634,4796,11
2023-11-19,7호선,가산디지털단지,11577,11262,22839,11
2023-11-19,7호선,고속터미널,17406,10661,28067,11
2023-11-19,9호선,고속터미널,14695,21955,36650,11
2023-11-19,경부선,서울역,11859,2935,14794,11
2023-11-19,경부선,가산디지털단지,5822,7582,13404,11
2023-11-19,4호선,서울역,6310,18669,24979,11
2023-11-19,4호선,사당,18579,17806,36385,11
2023-11-19,신림선,신림,1129,1523,2652,11
2023-11-20,신림선,신림,1836,2570,4406,11
2023-11-20,분당선,선릉,15521,23439,38960,11
2023-11-20,공항철도 1호선,홍대입구,13087,12698,25785,11
2023-11-20,공항철도 1호선,서울역,13271,11764,25035,11
2023-11-20,경의선,홍대입구,2023,2389,4412,11
2023-11-20,경의선,서울역,5647,6855,12502,11
2023-11-20,경부선,가산디지털단지,19504,22020,41524,11
2023-11-20,경부선,서울역,10180,3068,13248,11
2023-11-20,9호선,고속터미널,14471,19614,34085,11
2023-11-20,8호선,잠실(송파구청),15520,17959,33479,11
2023-11-20,7호선,가산디지털단지,51057,51470,102527,11
2023-11-20,7호선,고속터미널,17826,15012,32838,11
2023-11-20,4호선,사당,24754,23349,48103,11
2023-11-20,4호선,서울역,14003,22251,36254,11
2023-11-20,3호선,고속터미널,44994,42508,87502,11
2023-11-20,2호선,홍대입구,64680,67874,132554,11
2023-11-20,2호선,구로디지털단지,62439,61769,124208,11
2023-11-20,2호선,신림,56343,54070,110413,11
2023-11-20,2호선,사당,39078,42513,81591,11
2023-11-20,2호선,강남,83644,80300,163944,11
2023-11-20,2호선,선릉,64545,57071,121616,11
2023-11-20,2호선,잠실(송파구청),74565,74900,149465,11
2023-11-20,1호선,서울역,59142,55442,114584,11
2023-11-21,경부선,서울역,8334,2670,11004,11
2023-11-21,1호선,서울역,56944,53698,110642,11
2023-11-21,2호선,잠실(송파구청),79946,80773,160719,11
2023-11-21,2호선,선릉,67243,59279,126522,11
2023-11-21,2호선,강남,86780,83204,169984,11
2023-11-21,2호선,사당,42657,45552,88209,11
2023-11-21,2호선,신림,57827,55320,113147,11
2023-11-21,2호선,구로디지털단지,64058,63477,127535,11
2023-11-21,2호선,홍대입구,65634,69111,134745,11
2023-11-21,3호선,고속터미널,44671,41524,86195,11
2023-11-21,4호선,서울역,14381,21816,36197,11
2023-11-21,4호선,사당,28163,24890,53053,11
2023-11-21,7호선,고속터미널,17514,15278,32792,11
2023-11-21,7호선,가산디지털단지,51148,51797,102945,11
2023-11-21,8호선,잠실(송파구청),16624,18963,35587,11
2023-11-21,9호선,고속터미널,14570,19051,33621,11
2023-11-21,경부선,가산디지털단지,19872,22409,42281,11
2023-11-21,경의선,서울역,5482,6654,12136,11
2023-11-21,경의선,홍대입구,2111,2553,4664,11
2023-11-21,공항철도 1호선,서울역,12660,10795,23455,11
2023-11-21,공항철도 1호선,홍대입구,13337,13020,26357,11
2023-11-21,분당선,선릉,16204,24323,40527,11
2023-11-21,신림선,신림,1833,2619,4452,11
2023-11-22,3호선,고속터미널,44264,41447,85711,11
2023-11-22,4호선,서울역,14555,22039,36594,11
2023-11-22,4호선,사당,25139,22571,47710,11
2023-11-22,7호선,고속터미널,17357,15221,32578,11
2023-11-22,7호선,가산디지털단지,50854,51708,102562,11
2023-11-22,8호선,잠실(송파구청),16600,19449,36049,11
2023-11-22,9호선,고속터미널,14807,19294,34101,11
2023-11-22,경부선,서울역,8702,2753,11455,11
2023-11-22,경부선,가산디지털단지,20002,22424,42426,11
2023-11-22,경의선,서울역,5609,6922,12531,11
2023-11-22,경의선,홍대입구,2175,2556,4731,11
2023-11-22,공항철도 1호선,서울역,12879,11020,23899,11
2023-11-22,공항철도 1호선,홍대입구,13527,13439,26966,11
2023-11-22,분당선,선릉,15616,24082,39698,11
2023-11-22,1호선,서울역,56946,53904,110850,11
2023-11-22,신림선,신림,1905,2589,4494,11
2023-11-22,2호선,잠실(송파구청),80719,81450,162169,11
2023-11-22,2호선,선릉,66418,58337,124755,11
2023-11-22,2호선,강남,85452,82181,167633,11
2023-11-22,2호선,사당,41121,43854,84975,11
2023-11-22,2호선,신림,59099,56817,115916,11
2023-11-22,2호선,구로디지털단지,64575,64096,128671,11
2023-11-22,2호선,홍대입구,66890,71342,138232,11
2023-11-23,1호선,서울역,60336,56951,117287,11
2023-11-23,2호선,잠실(송파구청),82247,82882,165129,11
2023-11-23,2호선,선릉,66438,59105,125543,11
2023-11-23,2호선,강남,87315,84608,171923,11
2023-11-23,2호선,사당,43704,47124,90828,11
2023-11-23,2호선,신림,58462,56201,114663,11
2023-11-23,2호선,구로디지털단지,64475,63845,128320,11
2023-11-23,2호선,홍대입구,71149,75092,146241,11
2023-11-23,3호선,고속터미널,46582,43846,90428,11
2023-11-23,4호선,서울역,14598,23706,38304,11
2023-11-23,4호선,사당,28234,24933,53167,11
2023-11-23,7호선,고속터미널,17992,15241,33233,11
2023-11-23,7호선,가산디지털단지,50661,51401,102062,11
2023-11-23,8호선,잠실(송파구청),16893,19498,36391,11
2023-11-23,9호선,고속터미널,15472,20062,35534,11
2023-11-23,경부선,서울역,9615,3069,12684,11
2023-11-23,경부선,가산디지털단지,19855,22629,42484,11
2023-11-23,경의선,서울역,5570,6892,12462,11
2023-11-23,경의선,홍대입구,2051,2549,4600,11
2023-11-23,공항철도 1호선,서울역,14070,11832,25902,11
2023-11-23,공항철도 1호선,홍대입구,13506,14030,27536,11
2023-11-23,분당선,선릉,15829,24167,39996,11
2023-11-23,신림선,신림,1849,2527,4376,11
2023-11-24,1호선,서울역,66788,64176,130964,11
2023-11-24,2호선,선릉,64421,56976,121397,11
2023-11-24,2호선,강남,93897,91730,185627,11
2023-11-24,2호선,사당,46121,50101,96222,11
2023-11-24,2호선,신림,60695,57494,118189,11
2023-11-24,2호선,구로디지털단지,64120,63458,127578,11
2023-11-24,2호선,홍대입구,79849,89141,168990,11
2023-11-24,7호선,고속터미널,21336,16850,38186,11
2023-11-24,7호선,가산디지털단지,50482,50051,100533,11
2023-11-24,8호선,잠실(송파구청),19210,22251,41461,11
2023-11-24,9호선,고속터미널,17779,25171,42950,11
2023-11-24,경부선,서울역,12311,4215,16526,11
2023-11-24,경부선,가산디지털단지,19118,21512,40630,11
2023-11-24,경의선,서울역,5403,7006,12409,11
2023-11-24,경의선,홍대입구,2179,3026,5205,11
2023-11-24,공항철도 1호선,서울역,15893,14325,30218,11
2023-11-24,공항철도 1호선,홍대입구,15162,15706,30868,11
2023-11-24,분당선,선릉,15104,23432,38536,11
2023-11-24,신림선,신림,1916,2621,4537,11
2023-11-24,3호선,고속터미널,57731,58320,116051,11
2023-11-24,4호선,서울역,14812,26515,41327,11
2023-11-24,4호선,사당,31133,27240,58373,11
2023-11-24,2호선,잠실(송파구청),88533,90113,178646,11
2023-11-25,1호선,서울역,52452,50279,102731,11
2023-11-25,신림선,신림,1408,1872,3280,11
2023-11-25,분당선,선릉,6126,9644,15770,11
2023-11-25,공항철도 1호선,홍대입구,17796,18084,35880,11
2023-11-25,공항철도 1호선,서울역,15381,14552,29933,11
2023-11-25,경의선,홍대입구,2406,3299,5705,11
2023-11-25,경의선,서울역,1659,2048,3707,11
2023-11-25,경부선,가산디지털단지,7317,9126,16443,11
2023-11-25,경부선,서울역,12394,3481,15875,11
2023-11-25,9호선,고속터미널,17250,26688,43938,11
2023-11-25,8호선,잠실(송파구청),18419,20795,39214,11
2023-11-25,7호선,가산디지털단지,16349,15011,31360,11
2023-11-25,7호선,고속터미널,19556,14131,33687,11
2023-11-25,4호선,사당,25434,24338,49772,11
2023-11-25,4호선,서울역,8156,22536,30692,11
2023-11-25,3호선,고속터미널,62125,60910,123035,11
2023-11-25,2호선,홍대입구,87883,99560,187443,11
2023-11-25,2호선,구로디지털단지,38473,37534,76007,11
2023-11-25,2호선,신림,47764,45790,93554,11
2023-11-25,2호선,사당,39061,39973,79034,11
2023-11-25,2호선,강남,63286,62344,125630,11
2023-11-25,2호선,선릉,29398,25497,54895,11
2023-11-25,2호선,잠실(송파구청),86230,85037,171267,11
2023-11-26,분당선,선릉,3385,5025,8410,11
2023-11-26,1호선,서울역,39131,39698,78829,11
2023-11-26,2호선,잠실(송파구청),62421,59512,121933,11
2023-11-26,2호선,선릉,16243,13758,30001,11
2023-11-26,2호선,강남,35802,33955,69757,11
2023-11-26,2호선,사당,25957,24853,50810,11
2023-11-26,2호선,신림,36210,34751,70961,11
2023-11-26,2호선,구로디지털단지,27369,26481,53850,11
2023-11-26,2호선,홍대입구,67856,68767,136623,11
2023-11-26,3호선,고속터미널,51172,47804,98976,11
2023-11-26,4호선,서울역,6406,17039,23445,11
2023-11-26,4호선,사당,18110,17425,35535,11
2023-11-26,7호선,고속터미널,17229,10901,28130,11
2023-11-26,7호선,가산디지털단지,11648,11290,22938,11
2023-11-26,8호선,잠실(송파구청),14220,15341,29561,11
2023-11-26,9호선,고속터미널,14244,21508,35752,11
2023-11-26,경부선,서울역,12031,2999,15030,11
2023-11-26,경부선,가산디지털단지,5774,7288,13062,11
2023-11-26,경의선,서울역,1412,1344,2756,11
2023-11-26,공항철도 1호선,홍대입구,14805,13207,28012,11
2023-11-26,공항철도 1호선,서울역,14459,13283,27742,11
2023-11-26,경의선,홍대입구,1994,2545,4539,11
2023-11-26,신림선,신림,1094,1637,2731,11
2023-11-27,신림선,신림,1809,2488,4297,11
2023-11-27,4호선,사당,26337,23184,49521,11
2023-11-27,4호선,서울역,13531,21914,35445,11
2023-11-27,3호선,고속터미널,39888,37816,77704,11
2023-11-27,2호선,홍대입구,63069,65938,129007,11
2023-11-27,2호선,구로디지털단지,61892,60842,122734,11
2023-11-27,2호선,신림,55762,53636,109398,11
2023-11-27,2호선,사당,39245,42638,81883,11
2023-11-27,2호선,강남,82636,79853,162489,11
2023-11-27,2호선,선릉,63569,56250,119819,11
2023-11-27,2호선,잠실(송파구청),77440,78884,156324,11
2023-11-27,1호선,서울역,57817,53656,111473,11
2023-11-27,7호선,고속터미널,18138,14807,32945,11
2023-11-27,7호선,가산디지털단지,50377,50919,101296,11
2023-11-27,8호선,잠실(송파구청),16260,19062,35322,11
2023-11-27,9호선,고속터미널,13899,18702,32601,11
2023-11-27,경부선,서울역,9880,3100,12980,11
2023-11-27,경부선,가산디지털단지,19290,21811,41101,11
2023-11-27,경의선,서울역,5316,6720,12036,11
2023-11-27,경의선,홍대입구,1854,2257,4111,11
2023-11-27,공항철도 1호선,서울역,13279,11669,24948,11
2023-11-27,공항철도 1호선,홍대입구,12919,12590,25509,11
2023-11-27,분당선,선릉,15202,23266,38468,11
2023-11-28,신림선,신림,1904,2641,4545,11
2023-11-28,분당선,선릉,15674,24354,40028,11
2023-11-28,공항철도 1호선,홍대입구,12698,12633,25331,11
2023-11-28,공항철도 1호선,서울역,11913,10447,22360,11
2023-11-28,경의선,홍대입구,2113,2470,4583,11
2023-11-28,경의선,서울역,5350,6562,11912,11
2023-11-28,경부선,가산디지털단지,19586,22208,41794,11
2023-11-28,경부선,서울역,8196,2597,10793,11
2023-11-28,9호선,고속터미널,14656,19487,34143,11
2023-11-28,8호선,잠실(송파구청),17584,20072,37656,11
2023-11-28,7호선,가산디지털단지,51539,51818,103357,11
2023-11-28,7호선,고속터미널,17608,15242,32850,11
2023-11-28,2호선,강남,86646,83448,170094,11
2023-11-28,2호선,사당,42521,46020,88541,11
2023-11-28,2호선,신림,57802,55519,113321,11
2023-11-28,2호선,구로디지털단지,63569,62764,126333,11
2023-11-28,2호선,홍대입구,65936,68938,134874,11
2023-11-28,1호선,서울역,56667,53456,110123,11
2023-11-28,2호선,잠실(송파구청),84065,84724,168789,11
2023-11-28,2호선,선릉,67376,59023,126399,11
2023-11-28,3호선,고속터미널,45370,43030,88400,11
2023-11-28,4호선,서울역,14119,21691,35810,11
2023-11-28,4호선,사당,28451,25102,53553,11
2023-11-29,2호선,잠실(송파구청),83843,84014,167857,11
2023-11-29,2호선,선릉,65457,57815,123272,11
2023-11-29,2호선,강남,85706,82167,167873,11
2023-11-29,2호선,사당,42862,46026,88888,11
2023-11-29,2호선,신림,58278,56049,114327,11
2023-11-29,2호선,구로디지털단지,64113,63332,127445,11
2023-11-29,2호선,홍대입구,66340,69733,136073,11
2023-11-29,3호선,고속터미널,44719,41728,86447,11
2023-11-29,4호선,서울역,14481,22010,36491,11
2023-11-29,4호선,사당,28538,25054,53592,11
2023-11-29,7호선,고속터미널,17090,15154,32244,11
2023-11-29,7호선,가산디지털단지,51369,51429,102798,11
2023-11-29,8호선,잠실(송파구청),18330,21328,39658,11
2023-11-29,9호선,고속터미널,14172,18807,32979,11
2023-11-29,경부선,서울역,7945,2546,10491,11
2023-11-29,경부선,가산디지털단지,19350,22185,41535,11
2023-11-29,경의선,서울역,5304,6703,12007,11
2023-11-29,경의선,홍대입구,1964,2421,4385,11
2023-11-29,공항철도 1호선,서울역,11896,10526,22422,11
2023-11-29,공항철도 1호선,홍대입구,12866,13055,25921,11
2023-11-29,분당선,선릉,15750,23758,39508,11
2023-11-29,신림선,신림,1896,2609,4505,11
2023-11-29,1호선,서울역,56412,52727,109139,11
2023-11-30,경의선,홍대입구,1905,2344,4249,11
2023-11-30,경의선,서울역,5169,6471,11640,11
2023-11-30,7호선,고속터미널,17522,14892,32414,11
2023-11-30,7호선,가산디지털단지,50823,51136,101959,11
2023-11-30,8호선,잠실(송파구청),18056,20636,38692,11
2023-11-30,2호선,홍대입구,65738,69811,135549,11
2023-11-30,2호선,구로디지털단지,62905,62363,125268,11
2023-11-30,2호선,신림,57749,55328,113077,11
2023-11-30,2호선,사당,43073,46742,89815,11
2023-11-30,2호선,강남,85538,82178,167716,11
2023-11-30,2호선,선릉,65416,57768,123184,11
2023-11-30,2호선,잠실(송파구청),86158,87260,173418,11
2023-11-30,9호선,고속터미널,14695,19133,33828,11
2023-11-30,경부선,서울역,8737,2817,11554,11
2023-11-30,경부선,가산디지털단지,18999,21766,40765,11
2023-11-30,1호선,서울역,56499,53692,110191,11
2023-11-30,신림선,신림,1907,2609,4516,11
2023-11-30,분당선,선릉,15324,23643,38967,11
2023-11-30,공항철도 1호선,홍대입구,12615,12875,25490,11
2023-11-30,공항철도 1호선,서울역,12707,10557,23264,11
2023-11-30,3호선,고속터미널,46566,43494,90060,11
2023-11-30,4호선,서울역,13907,21717,35624,11
2023-11-30,4호선,사당,28717,25192,53909,11
2023-12-01,2호선,홍대입구,74538,84106,158644,12
2023-12-01,3호선,고속터미널,56181,56150,112331,12
2023-12-01,4호선,서울역,14544,25538,40082,12
2023-12-01,4호선,사당,31153,28339,59492,12
2023-12-01,7호선,고속터미널,20987,16460,37447,12
2023-12-01,7호선,가산디지털단지,50273,49916,100189,12
2023-12-01,8호선,잠실(송파구청),19146,22483,41629,12
2023-12-01,9호선,고속터미널,17256,24124,41380,12
2023-12-01,1호선,서울역,64002,61361,125363,12
2023-12-01,경부선,서울역,11837,3848,15685,12
2023-12-01,경부선,가산디지털단지,19090,21772,40862,12
2023-12-01,경의선,서울역,5479,6791,12270,12
2023-12-01,경의선,홍대입구,2326,2834,5160,12
2023-12-01,공항철도 1호선,서울역,15250,13473,28723,12
2023-12-01,공항철도 1호선,홍대입구,14729,15742,30471,12
2023-12-01,분당선,선릉,15272,23546,38818,12
2023-12-01,신림선,신림,1906,2609,4515,12
2023-12-01,2호선,잠실(송파구청),88761,89458,178219,12
2023-12-01,2호선,선릉,64427,56897,121324,12
2023-12-01,2호선,강남,91911,90600,182511,12
2023-12-01,2호선,사당,46855,51654,98509,12
2023-12-01,2호선,신림,60166,57456,117622,12
2023-12-01,2호선,구로디지털단지,64186,63192,127378,12
2023-12-02,1호선,서울역,48627,47919,96546,12
2023-12-02,2호선,잠실(송파구청),83939,82233,166172,12
2023-12-02,2호선,선릉,28707,25107,53814,12
2023-12-02,2호선,강남,63559,62800,126359,12
2023-12-02,2호선,사당,41518,45653,87171,12
2023-12-02,2호선,신림,48327,46236,94563,12
2023-12-02,2호선,구로디지털단지,39776,38482,78258,12
2023-12-02,2호선,홍대입구,83703,95031,178734,12
2023-12-02,3호선,고속터미널,61481,59867,121348,12
2023-12-02,4호선,서울역,7769,20454,28223,12
2023-12-02,4호선,사당,26481,26135,52616,12
2023-12-02,7호선,고속터미널,18994,14070,33064,12
2023-12-02,7호선,가산디지털단지,15547,14498,30045,12
2023-12-02,8호선,잠실(송파구청),17939,20579,38518,12
2023-12-02,9호선,고속터미널,17134,25564,42698,12
2023-12-02,경부선,서울역,11998,3331,15329,12
2023-12-02,경부선,가산디지털단지,7445,9415,16860,12
2023-12-02,경의선,서울역,1817,1964,3781,12
2023-12-02,경의선,홍대입구,2421,3278,5699,12
2023-12-02,공항철도 1호선,서울역,14031,14033,28064,12
2023-12-02,공항철도 1호선,홍대입구,17346,17636,34982,12
2023-12-02,신림선,신림,1421,1808,3229,12
2023-12-02,분당선,선릉,5909,9416,15325,12
2023-12-03,신림선,신림,1178,1695,2873,12
2023-12-03,분당선,선릉,3114,4893,8007,12
2023-12-03,공항철도 1호선,홍대입구,14645,13294,27939,12
2023-12-03,공항철도 1호선,서울역,13754,12754,26508,12
2023-12-03,경의선,홍대입구,1975,2653,4628,12
2023-12-03,경의선,서울역,1415,1393,2808,12
2023-12-03,경부선,가산디지털단지,5555,7134,12689,12
2023-12-03,경부선,서울역,11109,2830,13939,12
2023-12-03,9호선,고속터미널,13409,20457,33866,12
2023-12-03,8호선,잠실(송파구청),14191,15284,29475,12
2023-12-03,7호선,가산디지털단지,10955,10617,21572,12
2023-12-03,7호선,고속터미널,15418,10382,25800,12
2023-12-03,4호선,사당,17815,17220,35035,12
2023-12-03,4호선,서울역,5966,16102,22068,12
2023-12-03,3호선,고속터미널,49725,46983,96708,12
2023-12-03,2호선,홍대입구,64490,64142,128632,12
2023-12-03,2호선,구로디지털단지,27850,26830,54680,12
2023-12-03,2호선,신림,35766,35050,70816,12
2023-12-03,2호선,사당,26429,28589,55018,12
2023-12-03,2호선,강남,36608,34042,70650,12
2023-12-03,2호선,선릉,15633,13350,28983,12
2023-12-03,2호선,잠실(송파구청),60839,57942,118781,12
2023-12-03,1호선,서울역,38359,37801,76160,12
2023-12-04,1호선,서울역,56029,53066,109095,12
2023-12-04,2호선,잠실(송파구청),79733,79869,159602,12
2023-12-04,2호선,선릉,64196,56769,120965,12
2023-12-04,2호선,강남,83232,80053,163285,12
2023-12-04,2호선,사당,41275,43762,85037,12
2023-12-04,2호선,신림,56196,53953,110149,12
2023-12-04,2호선,구로디지털단지,62398,61753,124151,12
2023-12-04,2호선,홍대입구,63392,66288,129680,12
2023-12-04,3호선,고속터미널,43894,41558,85452,12
2023-12-04,4호선,서울역,13565,20949,34514,12
2023-12-04,4호선,사당,25713,23607,49320,12
2023-12-04,7호선,고속터미널,17776,15044,32820,12
2023-12-04,7호선,가산디지털단지,50806,51063,101869,12
2023-12-04,8호선,잠실(송파구청),16496,19206,35702,12
2023-12-04,9호선,고속터미널,14336,19147,33483,12
2023-12-04,경부선,서울역,9050,2880,11930,12
2023-12-04,경부선,가산디지털단지,19578,22164,41742,12
2023-12-04,경의선,서울역,5411,6821,12232,12
2023-12-04,경의선,홍대입구,2016,2429,4445,12
2023-12-04,공항철도 1호선,서울역,12647,11639,24286,12
2023-12-04,공항철도 1호선,홍대입구,13028,12526,25554,12
2023-12-04,분당선,선릉,15275,23360,38635,12
2023-12-04,신림선,신림,1809,2500,4309,12
2023-12-05,1호선,서울역,55419,52489,107908,12
2023-12-05,2호선,잠실(송파구청),81581,82475,164056,12
2023-12-05,2호선,선릉,66585,58616,125201,12
2023-12-05,2호선,사당,45958,46926,92884,12
2023-12-05,2호선,신림,57612,55656,113268,12
2023-12-05,2호선,구로디지털단지,64019,63667,127686,12
2023-12-05,2호선,홍대입구,64056,67088,131144,12
2023-12-05,3호선,고속터미널,44222,41160,85382,12
2023-12-05,4호선,서울역,13925,20760,34685,12
2023-12-05,4호선,사당,26629,25287,51916,12
2023-12-05,7호선,고속터미널,17118,15307,32425,12
2023-12-05,7호선,가산디지털단지,51715,52164,103879,12
2023-12-05,8호선,잠실(송파구청),16808,19655,36463,12
2023-12-05,9호선,고속터미널,14489,18533,33022,12
2023-12-05,경부선,서울역,7806,2477,10283,12
2023-12-05,경부선,가산디지털단지,19839,22370,42209,12
2023-12-05,경의선,서울역,5416,6501,11917,12
2023-12-05,경의선,홍대입구,2149,2588,4737,12
2023-12-05,공항철도 1호선,서울역,11322,10142,21464,12
2023-12-05,공항철도 1호선,홍대입구,12800,12573,25373,12
2023-12-05,분당선,선릉,15771,24375,40146,12
2023-12-05,신림선,신림,1886,2647,4533,12
2023-12-05,2호선,강남,86587,83463,170050,12
2023-12-06,1호선,서울역,56035,52695,108730,12
2023-12-06,2호선,잠실(송파구청),81772,81671,163443,12
2023-12-06,2호선,선릉,65958,58311,124269,12
2023-12-06,2호선,강남,85787,82175,167962,12
2023-12-06,2호선,사당,45096,46782,91878,12
2023-12-06,2호선,신림,57641,55432,113073,12
2023-12-06,2호선,구로디지털단지,63610,63100,126710,12
2023-12-06,2호선,홍대입구,62896,65961,128857,12
2023-12-06,3호선,고속터미널,44487,41477,85964,12
2023-12-06,4호선,서울역,14249,21076,35325,12
2023-12-06,4호선,사당,26455,24917,51372,12
2023-12-06,7호선,고속터미널,16877,15051,31928,12
2023-12-06,7호선,가산디지털단지,51235,51349,102584,12
2023-12-06,8호선,잠실(송파구청),17111,20438,37549,12
2023-12-06,9호선,고속터미널,14291,18869,33160,12
2023-12-06,경부선,서울역,8045,2593,10638,12
2023-12-06,경부선,가산디지털단지,19636,22216,41852,12
2023-12-06,경의선,서울역,5219,6582,11801,12
2023-12-06,경의선,홍대입구,2001,2357,4358,12
2023-12-06,공항철도 1호선,서울역,11366,9765,21131,12
2023-12-06,공항철도 1호선,홍대입구,12287,12358,24645,12
2023-12-06,분당선,선릉,15684,23910,39594,12
2023-12-06,신림선,신림,1859,2540,4399,12
2023-12-07,신림선,신림,1981,2751,4732,12
2023-12-07,4호선,사당,27507,26011,53518,12
2023-12-07,4호선,서울역,14709,23019,37728,12
2023-12-07,3호선,고속터미널,45964,43161,89125,12
2023-12-07,2호선,홍대입구,66446,70878,137324,12
2023-12-07,2호선,구로디지털단지,64833,64206,129039,12
2023-12-07,2호선,신림,59100,56731,115831,12
2023-12-07,2호선,사당,47436,49384,96820,12
2023-12-07,2호선,강남,87923,85058,172981,12
2023-12-07,2호선,선릉,65877,58532,124409,12
2023-12-07,2호선,잠실(송파구청),86180,86322,172502,12
2023-12-07,1호선,서울역,57435,55318,112753,12
2023-12-07,7호선,고속터미널,17798,15500,33298,12
2023-12-07,7호선,가산디지털단지,50755,51370,102125,12
2023-12-07,8호선,잠실(송파구청),17411,20563,37974,12
2023-12-07,9호선,고속터미널,15216,19351,34567,12
2023-12-07,경부선,서울역,9146,2874,12020,12
2023-12-07,경부선,가산디지털단지,20075,22522,42597,12
2023-12-07,경의선,서울역,5325,6731,12056,12
2023-12-07,경의선,홍대입구,2109,2578,4687,12
2023-12-07,공항철도 1호선,서울역,12518,10701,23219,12
2023-12-07,공항철도 1호선,홍대입구,13284,13284,26568,12
2023-12-07,분당선,선릉,15470,24052,39522,12
2023-12-08,신림선,신림,1923,2633,4556,12
2023-12-08,분당선,선릉,15095,23920,39015,12
2023-12-08,공항철도 1호선,홍대입구,15301,15737,31038,12
2023-12-08,공항철도 1호선,서울역,14906,13679,28585,12
2023-12-08,경의선,홍대입구,2351,2981,5332,12
2023-12-08,경의선,서울역,5473,6970,12443,12
2023-12-08,경부선,가산디지털단지,19953,22221,42174,12
2023-12-08,경부선,서울역,11692,3722,15414,12
2023-12-08,9호선,고속터미널,17058,23497,40555,12
2023-12-08,8호선,잠실(송파구청),17954,21428,39382,12
2023-12-08,7호선,가산디지털단지,49775,50168,99943,12
2023-12-08,7호선,고속터미널,20620,16681,37301,12
2023-12-08,1호선,서울역,64952,63747,128699,12
2023-12-08,2호선,잠실(송파구청),87288,87293,174581,12
2023-12-08,2호선,선릉,65783,58177,123960,12
2023-12-08,2호선,강남,93740,92038,185778,12
2023-12-08,2호선,사당,51986,55118,107104,12
2023-12-08,2호선,신림,61377,58448,119825,12
2023-12-08,2호선,구로디지털단지,65450,64331,129781,12
2023-12-08,2호선,홍대입구,73889,83940,157829,12
2023-12-08,3호선,고속터미널,54334,54323,108657,12
2023-12-08,4호선,서울역,14781,25359,40140,12
2023-12-08,4호선,사당,29825,29579,59404,12
2023-12-09,8호선,잠실(송파구청),17633,20801,38434,12
2023-12-09,7호선,가산디지털단지,15511,14512,30023,12
2023-12-09,7호선,고속터미널,19832,14736,34568,12
2023-12-09,2호선,사당,48090,50411,98501,12
2023-12-09,2호선,신림,49365,46914,96279,12
2023-12-09,2호선,구로디지털단지,41365,40171,81536,12
2023-12-09,2호선,홍대입구,85884,99425,185309,12
2023-12-09,3호선,고속터미널,61085,59436,120521,12
2023-12-09,4호선,서울역,8243,20378,28621,12
2023-12-09,4호선,사당,26396,28170,54566,12
2023-12-09,2호선,강남,64623,64587,129210,12
2023-12-09,2호선,선릉,29375,25484,54859,12
2023-12-09,2호선,잠실(송파구청),88783,87105,175888,12
2023-12-09,1호선,서울역,49943,49721,99664,12
2023-12-09,신림선,신림,1461,1968,3429,12
2023-12-09,분당선,선릉,6065,9960,16025,12
2023-12-09,공항철도 1호선,홍대입구,18510,18529,37039,12
2023-12-09,공항철도 1호선,서울역,14186,13715,27901,12
2023-12-09,경의선,홍대입구,2727,3823,6550,12
2023-12-09,경의선,서울역,1883,2002,3885,12
2023-12-09,경부선,가산디지털단지,7933,9528,17461,12
2023-12-09,경부선,서울역,11728,3197,14925,12
2023-12-09,9호선,고속터미널,17598,25246,42844,12
2023-12-10,신림선,신림,1131,1633,2764,12
2023-12-10,분당선,선릉,3273,4956,8229,12
2023-12-10,공항철도 1호선,홍대입구,14725,13079,27804,12
2023-12-10,공항철도 1호선,서울역,13380,12228,25608,12
2023-12-10,경의선,홍대입구,2108,2675,4783,12
2023-12-10,경의선,서울역,1415,1326,2741,12
2023-12-10,경부선,가산디지털단지,5880,7083,12963,12
2023-12-10,경부선,서울역,10493,2609,13102,12
2023-12-10,9호선,고속터미널,13541,19727,33268,12
2023-12-10,8호선,잠실(송파구청),13610,15027,28637,12
2023-12-10,7호선,가산디지털단지,10778,10397,21175,12
2023-12-10,7호선,고속터미널,15137,10491,25628,12
2023-12-10,4호선,사당,17441,18775,36216,12
2023-12-10,4호선,서울역,5735,15400,21135,12
2023-12-10,3호선,고속터미널,48072,45279,93351,12
2023-12-10,2호선,홍대입구,64568,64407,128975,12
2023-12-10,2호선,구로디지털단지,28789,27848,56637,12
2023-12-10,2호선,신림,36465,35541,72006,12
2023-12-10,2호선,사당,30678,31122,61800,12
2023-12-10,2호선,강남,37431,35711,73142,12
2023-12-10,2호선,선릉,16089,13343,29432,12
2023-12-10,2호선,잠실(송파구청),63796,60852,124648,12
2023-12-10,1호선,서울역,37489,36279,73768,12
2023-12-11,경부선,서울역,9202,2797,11999,12
2023-12-11,경부선,가산디지털단지,18310,21405,39715,12
2023-12-11,2호선,잠실(송파구청),78378,78768,157146,12
2023-12-11,2호선,선릉,63850,56413,120263,12
2023-12-11,2호선,강남,82812,79195,162007,12
2023-12-11,2호선,사당,41190,42942,84132,12
2023-12-11,4호선,서울역,13525,21176,34701,12
2023-12-11,3호선,고속터미널,44492,41629,86121,12
2023-12-11,공항철도 1호선,홍대입구,11604,11440,23044,12
2023-12-11,공항철도 1호선,서울역,12165,10899,23064,12
2023-12-11,2호선,홍대입구,58647,60358,119005,12
2023-12-11,2호선,구로디지털단지,61165,60409,121574,12
2023-12-11,2호선,신림,54626,52583,107209,12
2023-12-11,9호선,고속터미널,13959,19030,32989,12
2023-12-11,4호선,사당,24668,23122,47790,12
2023-12-11,1호선,서울역,56687,53085,109772,12
2023-12-11,7호선,고속터미널,17391,14605,31996,12
2023-12-11,7호선,가산디지털단지,50378,50017,100395,12
2023-12-11,8호선,잠실(송파구청),17250,19419,36669,12
2023-12-11,신림선,신림,1839,2524,4363,12
2023-12-11,분당선,선릉,15262,23234,38496,12
2023-12-11,경의선,홍대입구,1587,2005,3592,12
2023-12-11,경의선,서울역,5053,6384,11437,12
2023-12-12,8호선,잠실(송파구청),17758,21001,38759,12
2023-12-12,7호선,가산디지털단지,50923,51362,102285,12
2023-12-12,7호선,고속터미널,17364,15324,32688,12
2023-12-12,4호선,사당,27815,25693,53508,12
2023-12-12,4호선,서울역,13947,21098,35045,12
2023-12-12,3호선,고속터미널,45247,42349,87596,12
2023-12-12,9호선,고속터미널,14655,18919,33574,12
2023-12-12,2호선,홍대입구,65582,69382,134964,12
2023-12-12,2호선,구로디지털단지,64122,63476,127598,12
2023-12-12,2호선,신림,58095,55683,113778,12
2023-12-12,2호선,사당,46580,48793,95373,12
2023-12-12,2호선,강남,88133,85020,173153,12
2023-12-12,2호선,선릉,66620,58702,125322,12
2023-12-12,2호선,잠실(송파구청),88317,88462,176779,12
2023-12-12,1호선,서울역,56165,53372,109537,12
2023-12-12,경부선,서울역,8210,2595,10805,12
2023-12-12,경부선,가산디지털단지,19916,22397,42313,12
2023-12-12,경의선,서울역,5254,6569,11823,12
2023-12-12,경의선,홍대입구,2128,2577,4705,12
2023-12-12,공항철도 1호선,서울역,11786,10272,22058,12
2023-12-12,공항철도 1호선,홍대입구,12921,12606,25527,12
2023-12-12,분당선,선릉,15759,24106,39865,12
2023-12-12,신림선,신림,1868,2616,4484,12
2023-12-13,1호선,서울역,57477,54853,112330,12
2023-12-13,2호선,잠실(송파구청),89669,89794,179463,12
2023-12-13,2호선,선릉,66610,59069,125679,12
2023-12-13,2호선,강남,88781,84825,173606,12
2023-12-13,2호선,사당,46268,49208,95476,12
2023-12-13,2호선,신림,59556,57517,117073,12
2023-12-13,2호선,구로디지털단지,65582,64764,130346,12
2023-12-13,2호선,홍대입구,66467,70659,137126,12
2023-12-13,3호선,고속터미널,45477,42699,88176,12
2023-12-13,4호선,서울역,14443,21798,36241,12
2023-12-13,4호선,사당,28743,26536,55279,12
2023-12-13,7호선,고속터미널,17358,15304,32662,12
2023-12-13,7호선,가산디지털단지,50369,51248,101617,12
2023-12-13,8호선,잠실(송파구청),17750,21254,39004,12
2023-12-13,9호선,고속터미널,15048,19074,34122,12
2023-12-13,경부선,서울역,8645,2576,11221,12
2023-12-13,경부선,가산디지털단지,19979,22555,42534,12
2023-12-13,경의선,서울역,5217,6805,12022,12
2023-12-13,경의선,홍대입구,2189,2578,4767,12
2023-12-13,공항철도 1호선,서울역,11993,10274,22267,12
2023-12-13,공항철도 1호선,홍대입구,13302,13390,26692,12
2023-12-13,분당선,선릉,15667,24049,39716,12
2023-12-13,신림선,신림,1955,2605,4560,12
2023-12-14,7호선,가산디지털단지,50564,50521,101085,12
2023-12-14,8호선,잠실(송파구청),18456,21351,39807,12
2023-12-14,7호선,고속터미널,17893,15458,33351,12
2023-12-14,1호선,서울역,59746,56923,116669,12
2023-12-14,2호선,잠실(송파구청),86625,86349,172974,12
2023-12-14,2호선,선릉,66281,58847,125128,12
2023-12-14,2호선,강남,90817,86618,177435,12
2023-12-14,2호선,사당,46093,49014,95107,12
2023-12-14,2호선,신림,58204,55613,113817,12
2023-12-14,2호선,구로디지털단지,64530,63530,128060,12
2023-12-14,2호선,홍대입구,68284,71395,139679,12
2023-12-14,3호선,고속터미널,48509,44557,93066,12
2023-12-14,4호선,서울역,14303,22711,37014,12
2023-12-14,4호선,사당,29325,26712,56037,12
2023-12-14,신림선,신림,1967,2630,4597,12
2023-12-14,9호선,고속터미널,14799,19885,34684,12
2023-12-14,경부선,서울역,9421,2818,12239,12
2023-12-14,경부선,가산디지털단지,19077,22046,41123,12
2023-12-14,경의선,서울역,5071,6485,11556,12
2023-12-14,경의선,홍대입구,1939,2412,4351,12
2023-12-14,공항철도 1호선,서울역,12889,11004,23893,12
2023-12-14,공항철도 1호선,홍대입구,13154,13624,26778,12
2023-12-14,분당선,선릉,15625,23923,39548,12
2023-12-15,신림선,신림,1927,2644,4571,12
2023-12-15,분당선,선릉,15081,23624,38705,12
2023-12-15,공항철도 1호선,홍대입구,14843,15763,30606,12
2023-12-15,공항철도 1호선,서울역,15591,13793,29384,12
2023-12-15,경의선,홍대입구,2229,2966,5195,12
2023-12-15,경의선,서울역,5140,6425,11565,12
2023-12-15,경부선,가산디지털단지,19158,21671,40829,12
2023-12-15,경부선,서울역,12424,4083,16507,12
2023-12-15,9호선,고속터미널,17420,24053,41473,12
2023-12-15,8호선,잠실(송파구청),19800,23613,43413,12
2023-12-15,7호선,가산디지털단지,48703,48953,97656,12
2023-12-15,7호선,고속터미널,21999,16799,38798,12
2023-12-15,4호선,사당,31244,29292,60536,12
2023-12-15,4호선,서울역,14677,25572,40249,12
2023-12-15,3호선,고속터미널,57053,55435,112488,12
2023-12-15,2호선,홍대입구,75834,86424,162258,12
2023-12-15,2호선,구로디지털단지,64868,64228,129096,12
2023-12-15,2호선,신림,60844,58129,118973,12
2023-12-15,2호선,사당,49782,54037,103819,12
2023-12-15,2호선,강남,94678,93760,188438,12
2023-12-15,2호선,선릉,64514,57355,121869,12
2023-12-15,2호선,잠실(송파구청),94028,95311,189339,12
2023-12-15,1호선,서울역,64821,62743,127564,12
2023-12-16,분당선,선릉,6391,10191,16582,12
2023-12-16,공항철도 1호선,홍대입구,18867,19305,38172,12
2023-12-16,신림선,신림,1522,1992,3514,12
2023-12-16,경의선,홍대입구,2549,3769,6318,12
2023-12-16,경의선,서울역,1771,2027,3798,12
2023-12-16,7호선,고속터미널,20993,14742,35735,12
2023-12-16,7호선,가산디지털단지,15316,13781,29097,12
2023-12-16,8호선,잠실(송파구청),21173,23901,45074,12
2023-12-16,1호선,서울역,53026,52115,105141,12
2023-12-16,9호선,고속터미널,17758,26859,44617,12
2023-12-16,2호선,잠실(송파구청),96682,93304,189986,12
2023-12-16,2호선,선릉,30479,26804,57283,12
2023-12-16,2호선,강남,68698,67838,136536,12
2023-12-16,2호선,사당,45929,49991,95920,12
2023-12-16,2호선,신림,50469,47977,98446,12
2023-12-16,2호선,구로디지털단지,40935,39888,80823,12
2023-12-16,2호선,홍대입구,94446,105616,200062,12
2023-12-16,경부선,서울역,12447,3646,16093,12
2023-12-16,경부선,가산디지털단지,7229,9202,16431,12
2023-12-16,4호선,사당,29177,28572,57749,12
2023-12-16,4호선,서울역,8725,22281,31006,12
2023-12-16,3호선,고속터미널,67322,64772,132094,12
2023-12-16,공항철도 1호선,서울역,14843,14482,29325,12
2023-12-17,7호선,고속터미널,14656,10233,24889,12
2023-12-17,7호선,가산디지털단지,10130,9500,19630,12
2023-12-17,8호선,잠실(송파구청),14778,16058,30836,12
2023-12-17,9호선,고속터미널,13044,19970,33014,12
2023-12-17,경부선,서울역,10938,2955,13893,12
2023-12-17,경부선,가산디지털단지,4858,6295,11153,12
2023-12-17,경의선,서울역,1214,1285,2499,12
2023-12-17,경의선,홍대입구,1850,2632,4482,12
2023-12-17,1호선,서울역,39284,39152,78436,12
2023-12-17,3호선,고속터미널,51672,48425,100097,12
2023-12-17,4호선,서울역,5971,17166,23137,12
2023-12-17,4호선,사당,18273,17773,36046,12
2023-12-17,신림선,신림,1113,1535,2648,12
2023-12-17,2호선,홍대입구,67898,66698,134596,12
2023-12-17,2호선,구로디지털단지,26761,25974,52735,12
2023-12-17,2호선,신림,35651,34315,69966,12
2023-12-17,2호선,사당,27602,29210,56812,12
2023-12-17,2호선,강남,36870,35221,72091,12
2023-12-17,2호선,선릉,15675,13182,28857,12
2023-12-17,2호선,잠실(송파구청),65093,61826,126919,12
2023-12-17,분당선,선릉,3168,4906,8074,12
2023-12-17,공항철도 1호선,홍대입구,15025,13223,28248,12
2023-12-17,공항철도 1호선,서울역,13745,12952,26697,12
2023-12-18,1호선,서울역,56249,53932,110181,12
2023-12-18,2호선,잠실(송파구청),83531,83196,166727,12
2023-12-18,2호선,선릉,63785,56390,120175,12
2023-12-18,2호선,강남,86775,83128,169903,12
2023-12-18,2호선,사당,40709,44056,84765,12
2023-12-18,2호선,신림,55579,53161,108740,12
2023-12-18,2호선,구로디지털단지,61135,60060,121195,12
2023-12-18,2호선,홍대입구,67282,69531,136813,12
2023-12-18,3호선,고속터미널,47250,44373,91623,12
2023-12-18,4호선,서울역,13866,21945,35811,12
2023-12-18,4호선,사당,26531,23568,50099,12
2023-12-18,7호선,고속터미널,17546,15071,32617,12
2023-12-18,7호선,가산디지털단지,49840,49858,99698,12
2023-12-18,8호선,잠실(송파구청),18219,20708,38927,12
2023-12-18,9호선,고속터미널,14448,19461,33909,12
2023-12-18,경부선,서울역,9470,3023,12493,12
2023-12-18,경부선,가산디지털단지,18261,21212,39473,12
2023-12-18,경의선,서울역,4859,6196,11055,12
2023-12-18,경의선,홍대입구,1858,2324,4182,12
2023-12-18,공항철도 1호선,서울역,12514,11652,24166,12
2023-12-18,공항철도 1호선,홍대입구,13380,12895,26275,12
2023-12-18,분당선,선릉,15392,23339,38731,12
2023-12-18,신림선,신림,1776,2531,4307,12
2023-12-19,7호선,고속터미널,18059,15623,33682,12
2023-12-19,7호선,가산디지털단지,51910,51701,103611,12
2023-12-19,8호선,잠실(송파구청),18989,21679,40668,12
2023-12-19,9호선,고속터미널,15115,20032,35147,12
2023-12-19,경부선,서울역,8924,2776,11700,12
2023-12-19,경부선,가산디지털단지,19547,22049,41596,12
2023-12-19,경의선,서울역,5114,6402,11516,12
2023-12-19,경의선,홍대입구,1965,2516,4481,12
2023-12-19,공항철도 1호선,서울역,11765,10880,22645,12
2023-12-19,공항철도 1호선,홍대입구,13370,13225,26595,12
2023-12-19,분당선,선릉,16018,24460,40478,12
2023-12-19,1호선,서울역,57028,54909,111937,12
2023-12-19,2호선,잠실(송파구청),90307,87930,178237,12
2023-12-19,2호선,선릉,68113,59669,127782,12
2023-12-19,2호선,강남,92544,88271,180815,12
2023-12-19,2호선,사당,45384,48771,94155,12
2023-12-19,2호선,신림,57833,56195,114028,12
2023-12-19,2호선,구로디지털단지,64451,63571,128022,12
2023-12-19,2호선,홍대입구,68665,71756,140421,12
2023-12-19,3호선,고속터미널,48741,45458,94199,12
2023-12-19,4호선,서울역,14292,22010,36302,12
2023-12-19,4호선,사당,28978,25890,54868,12
2023-12-19,신림선,신림,1952,2644,4596,12
2023-12-20,경의선,홍대입구,1976,2494,4470,12
2023-12-20,경의선,서울역,5031,6254,11285,12
2023-12-20,경부선,가산디지털단지,18738,22258,40996,12
2023-12-20,경부선,서울역,9322,2874,12196,12
2023-12-20,9호선,고속터미널,15434,20201,35635,12
2023-12-20,8호선,잠실(송파구청),19947,22944,42891,12
2023-12-20,7호선,가산디지털단지,52317,52534,104851,12
2023-12-20,7호선,고속터미널,17712,15569,33281,12
2023-12-20,분당선,선릉,15783,24750,40533,12
2023-12-20,공항철도 1호선,홍대입구,13798,13761,27559,12
2023-12-20,신림선,신림,2060,2792,4852,12
2023-12-20,1호선,서울역,59084,56517,115601,12
2023-12-20,2호선,잠실(송파구청),92690,92191,184881,12
2023-12-20,2호선,선릉,67201,59193,126394,12
2023-12-20,2호선,강남,92628,88821,181449,12
2023-12-20,2호선,사당,45209,48784,93993,12
2023-12-20,2호선,신림,60346,57468,117814,12
2023-12-20,2호선,구로디지털단지,65350,64765,130115,12
2023-12-20,2호선,홍대입구,70601,74689,145290,12
2023-12-20,3호선,고속터미널,49719,46068,95787,12
2023-12-20,4호선,서울역,14900,23106,38006,12
2023-12-20,4호선,사당,29533,26358,55891,12
2023-12-20,공항철도 1호선,서울역,12103,10979,23082,12
2023-12-21,1호선,서울역,58082,55934,114016,12
2023-12-21,신림선,신림,1816,2578,4394,12
2023-12-21,분당선,선릉,15417,23767,39184,12
2023-12-21,경의선,홍대입구,1789,2476,4265,12
2023-12-21,경의선,서울역,4704,6003,10707,12
2023-12-21,경부선,가산디지털단지,18129,21338,39467,12
2023-12-21,경부선,서울역,9757,3136,12893,12
2023-12-21,9호선,고속터미널,15109,20176,35285,12
2023-12-21,8호선,잠실(송파구청),19480,22670,42150,12
2023-12-21,7호선,가산디지털단지,50078,50427,100505,12
2023-12-21,7호선,고속터미널,17782,14927,32709,12
2023-12-21,4호선,사당,28252,25151,53403,12
2023-12-21,4호선,서울역,14106,22914,37020,12
2023-12-21,3호선,고속터미널,49603,46089,95692,12
2023-12-21,공항철도 1호선,홍대입구,13400,14126,27526,12
2023-12-21,공항철도 1호선,서울역,12712,11325,24037,12
2023-12-21,2호선,홍대입구,70376,74669,145045,12
2023-12-21,2호선,구로디지털단지,62155,61229,123384,12
2023-12-21,2호선,신림,57471,55036,112507,12
2023-12-21,2호선,사당,43895,47609,91504,12
2023-12-21,2호선,강남,90532,87067,177599,12
2023-12-21,2호선,선릉,65702,57676,123378,12
2023-12-21,2호선,잠실(송파구청),90468,90331,180799,12
2023-12-22,7호선,고속터미널,20560,16050,36610,12
2023-12-22,7호선,가산디지털단지,47795,47043,94838,12
2023-12-22,8호선,잠실(송파구청),20864,23934,44798,12
2023-12-22,9호선,고속터미널,17645,25459,43104,12
2023-12-22,경부선,서울역,12123,4004,16127,12
2023-12-22,경부선,가산디지털단지,17420,20291,37711,12
2023-12-22,경의선,서울역,4567,6052,10619,12
2023-12-22,경의선,홍대입구,2134,2871,5005,12
2023-12-22,공항철도 1호선,서울역,15159,14280,29439,12
2023-12-22,공항철도 1호선,홍대입구,15414,16115,31529,12
2023-12-22,분당선,선릉,14575,22519,37094,12
2023-12-22,신림선,신림,1994,2658,4652,12
2023-12-22,1호선,서울역,63764,62307,126071,12
2023-12-22,2호선,잠실(송파구청),96404,96649,193053,12
2023-12-22,2호선,선릉,62810,55452,118262,12
2023-12-22,2호선,강남,94946,92829,187775,12
2023-12-22,2호선,사당,46312,50848,97160,12
2023-12-22,2호선,신림,59947,56657,116604,12
2023-12-22,2호선,구로디지털단지,61351,59978,121329,12
2023-12-22,2호선,홍대입구,79318,88669,167987,12
2023-12-22,3호선,고속터미널,60422,60564,120986,12
2023-12-22,4호선,서울역,13858,24542,38400,12
2023-12-22,4호선,사당,29970,27283,57253,12
2023-12-23,1호선,서울역,48061,48567,96628,12
2023-12-23,2호선,잠실(송파구청),93224,91021,184245,12
2023-12-23,2호선,선릉,27109,23676,50785,12
2023-12-23,2호선,강남,60129,59957,120086,12
2023-12-23,2호선,사당,37115,40227,77342,12
2023-12-23,2호선,신림,47744,45124,92868,12
2023-12-23,2호선,구로디지털단지,37112,36364,73476,12
2023-12-23,2호선,홍대입구,87765,99611,187376,12
2023-12-23,3호선,고속터미널,62628,62326,124954,12
2023-12-23,4호선,서울역,7481,19736,27217,12
2023-12-23,4호선,사당,24231,22586,46817,12
2023-12-23,8호선,잠실(송파구청),21003,23293,44296,12
2023-12-23,7호선,가산디지털단지,14336,12929,27265,12
2023-12-23,7호선,고속터미널,18419,13315,31734,12
2023-12-23,경부선,가산디지털단지,6438,8075,14513,12
2023-12-23,경부선,서울역,10740,3629,14369,12
2023-12-23,9호선,고속터미널,16930,26589,43519,12
2023-12-23,경의선,서울역,1620,1618,3238,12
2023-12-23,경의선,홍대입구,2490,3393,5883,12
2023-12-23,공항철도 1호선,서울역,13826,13468,27294,12
2023-12-23,공항철도 1호선,홍대입구,18491,18719,37210,12
2023-12-23,분당선,선릉,5650,8641,14291,12
2023-12-23,신림선,신림,1418,1939,3357,12
2023-12-24,1호선,서울역,42576,39998,82574,12
2023-12-24,2호선,잠실(송파구청),97440,94134,191574,12
2023-12-24,2호선,선릉,15706,13387,29093,12
2023-12-24,2호선,강남,38632,38958,77590,12
2023-12-24,2호선,사당,26176,28651,54827,12
2023-12-24,2호선,신림,40768,39501,80269,12
2023-12-24,2호선,구로디지털단지,30500,29224,59724,12
2023-12-24,2호선,홍대입구,89602,102461,192063,12
2023-12-24,3호선,고속터미널,49273,46478,95751,12
2023-12-24,4호선,서울역,7226,17647,24873,12
2023-12-24,4호선,사당,18914,17158,36072,12
2023-12-24,7호선,고속터미널,12591,9074,21665,12
2023-12-24,7호선,가산디지털단지,11235,10262,21497,12
2023-12-24,8호선,잠실(송파구청),22131,24232,46363,12
2023-12-24,9호선,고속터미널,13161,19722,32883,12
2023-12-24,경부선,서울역,9447,2772,12219,12
2023-12-24,경부선,가산디지털단지,5468,6923,12391,12
2023-12-24,경의선,서울역,1430,1435,2865,12
2023-12-24,경의선,홍대입구,2728,3713,6441,12
2023-12-24,공항철도 1호선,서울역,12530,11670,24200,12
2023-12-24,공항철도 1호선,홍대입구,19430,18767,38197,12
2023-12-24,분당선,선릉,3133,4451,7584,12
2023-12-24,신림선,신림,1193,1682,2875,12
2023-12-25,신림선,신림,1143,1596,2739,12
2023-12-25,분당선,선릉,3119,4522,7641,12
2023-12-25,공항철도 1호선,홍대입구,18957,17481,36438,12
2023-12-25,공항철도 1호선,서울역,13119,12501,25620,12
2023-12-25,경의선,홍대입구,2694,3862,6556,12
2023-12-25,경의선,서울역,1492,1370,2862,12
2023-12-25,경부선,가산디지털단지,5047,6455,11502,12
2023-12-25,경부선,서울역,10625,2931,13556,12
2023-12-25,9호선,고속터미널,13845,19481,33326,12
2023-12-25,8호선,잠실(송파구청),21153,23041,44194,12
2023-12-25,7호선,가산디지털단지,10159,9800,19959,12
2023-12-25,7호선,고속터미널,14047,8442,22489,12
2023-12-25,4호선,사당,17203,15891,33094,12
2023-12-25,4호선,서울역,6609,16841,23450,12
2023-12-25,3호선,고속터미널,50151,44858,95009,12
2023-12-25,2호선,홍대입구,94263,99976,194239,12
2023-12-25,2호선,구로디지털단지,27528,27456,54984,12
2023-12-25,2호선,신림,37171,36895,74066,12
2023-12-25,2호선,사당,22929,26266,49195,12
2023-12-25,2호선,강남,37449,37061,74510,12
2023-12-25,2호선,선릉,15079,13432,28511,12
2023-12-25,2호선,잠실(송파구청),97869,94853,192722,12
2023-12-25,1호선,서울역,41901,40839,82740,12
2023-12-26,3호선,고속터미널,49026,45975,95001,12
2023-12-26,4호선,서울역,12518,21102,33620,12
2023-12-26,4호선,사당,26350,23718,50068,12
2023-12-26,7호선,고속터미널,18885,15467,34352,12
2023-12-26,7호선,가산디지털단지,46954,46811,93765,12
2023-12-26,8호선,잠실(송파구청),18102,20651,38753,12
2023-12-26,9호선,고속터미널,15192,20680,35872,12
2023-12-26,경부선,서울역,10117,3185,13302,12
2023-12-26,경부선,가산디지털단지,18049,20374,38423,12
2023-12-26,경의선,서울역,4901,6212,11113,12
2023-12-26,경의선,홍대입구,2122,2654,4776,12
2023-12-26,공항철도 1호선,서울역,13228,12187,25415,12
2023-12-26,공항철도 1호선,홍대입구,14922,14247,29169,12
2023-12-26,분당선,선릉,14808,22696,37504,12
2023-12-26,신림선,신림,1872,2669,4541,12
2023-12-26,1호선,서울역,57295,54801,112096,12
2023-12-26,2호선,잠실(송파구청),85461,84191,169652,12
2023-12-26,2호선,선릉,62909,55255,118164,12
2023-12-26,2호선,강남,87479,84086,171565,12
2023-12-26,2호선,사당,41067,44912,85979,12
2023-12-26,2호선,신림,55418,53603,109021,12
2023-12-26,2호선,구로디지털단지,60459,59981,120440,12
2023-12-26,2호선,홍대입구,74294,76655,150949,12
2023-12-27,신림선,신림,1922,2589,4511,12
2023-12-27,공항철도 1호선,서울역,12940,11831,24771,12
2023-12-27,공항철도 1호선,홍대입구,15258,14868,30126,12
2023-12-27,분당선,선릉,15027,23225,38252,12
2023-12-27,1호선,서울역,57479,55421,112900,12
2023-12-27,2호선,잠실(송파구청),87603,86695,174298,12
2023-12-27,2호선,선릉,64007,56604,120611,12
2023-12-27,2호선,강남,90411,87305,177716,12
2023-12-27,2호선,사당,44120,47726,91846,12
2023-12-27,2호선,신림,57950,55867,113817,12
2023-12-27,2호선,구로디지털단지,62871,62002,124873,12
2023-12-27,2호선,홍대입구,74274,79509,153783,12
2023-12-27,3호선,고속터미널,48322,45420,93742,12
2023-12-27,4호선,서울역,13307,21898,35205,12
2023-12-27,4호선,사당,28096,25156,53252,12
2023-12-27,7호선,고속터미널,17882,15403,33285,12
2023-12-27,7호선,가산디지털단지,48355,48817,97172,12
2023-12-27,8호선,잠실(송파구청),18120,20896,39016,12
2023-12-27,9호선,고속터미널,14831,20327,35158,12
2023-12-27,경부선,서울역,9218,3014,12232,12
2023-12-27,경부선,가산디지털단지,18677,21030,39707,12
2023-12-27,경의선,서울역,4900,6163,11063,12
2023-12-27,경의선,홍대입구,2203,2715,4918,12
2023-12-28,신림선,신림,1876,2520,4396,12
2023-12-28,분당선,선릉,14737,22693,37430,12
2023-12-28,공항철도 1호선,홍대입구,15293,15138,30431,12
2023-12-28,공항철도 1호선,서울역,12863,11729,24592,12
2023-12-28,경의선,홍대입구,2194,2730,4924,12
2023-12-28,경의선,서울역,4752,6074,10826,12
2023-12-28,경부선,가산디지털단지,17981,20096,38077,12
2023-12-28,경부선,서울역,9562,3190,12752,12
2023-12-28,9호선,고속터미널,15105,20981,36086,12
2023-12-28,8호선,잠실(송파구청),18381,21376,39757,12
2023-12-28,7호선,가산디지털단지,46791,47985,94776,12
2023-12-28,7호선,고속터미널,17553,15146,32699,12
2023-12-28,4호선,사당,27793,24958,52751,12
2023-12-28,4호선,서울역,13129,22433,35562,12
2023-12-28,3호선,고속터미널,49314,47700,97014,12
2023-12-28,2호선,홍대입구,76374,81581,157955,12
2023-12-28,2호선,구로디지털단지,62702,61770,124472,12
2023-12-28,2호선,신림,57516,54935,112451,12
2023-12-28,2호선,사당,43765,47592,91357,12
2023-12-28,2호선,강남,90811,87883,178694,12
2023-12-28,2호선,선릉,63307,55578,118885,12
2023-12-28,2호선,잠실(송파구청),89252,87845,177097,12
2023-12-28,1호선,서울역,56709,56349,113058,12
2023-12-29,신림선,신림,1931,2502,4433,12
2023-12-29,분당선,선릉,13180,20197,33377,12
2023-12-29,공항철도 1호선,홍대입구,16399,17030,33429,12
2023-12-29,공항철도 1호선,서울역,14889,13611,28500,12
2023-12-29,경의선,홍대입구,2372,3060,5432,12
2023-12-29,경의선,서울역,4581,6050,10631,12
2023-12-29,경부선,가산디지털단지,16212,18343,34555,12
2023-12-29,경부선,서울역,11091,3979,15070,12
2023-12-29,9호선,고속터미널,16463,25522,41985,12
2023-12-29,8호선,잠실(송파구청),19174,22252,41426,12
2023-12-29,7호선,가산디지털단지,41654,41494,83148,12
2023-12-29,7호선,고속터미널,19396,16515,35911,12
2023-12-29,4호선,사당,28114,25528,53642,12
2023-12-29,4호선,서울역,12234,23121,35355,12
2023-12-29,3호선,고속터미널,54389,59769,114158,12
2023-12-29,2호선,홍대입구,81933,92135,174068,12
2023-12-29,2호선,구로디지털단지,59978,58435,118413,12
2023-12-29,2호선,신림,58973,55650,114623,12
2023-12-29,2호선,사당,42601,46693,89294,12
2023-12-29,2호선,강남,87518,86817,174335,12
2023-12-29,2호선,선릉,56356,49705,106061,12
2023-12-29,2호선,잠실(송파구청),88713,88077,176790,12
2023-12-29,1호선,서울역,57905,60011,117916,12
2023-12-30,신림선,신림,1375,1752,3127,12
2023-12-30,분당선,선릉,5950,8715,14665,12
2023-12-30,공항철도 1호선,홍대입구,16349,16691,33040,12
2023-12-30,공항철도 1호선,서울역,14457,14114,28571,12
2023-12-30,경의선,홍대입구,2158,3164,5322,12
2023-12-30,경의선,서울역,1373,1626,2999,12
2023-12-30,경부선,가산디지털단지,5791,7053,12844,12
2023-12-30,경부선,서울역,10595,3820,14415,12
2023-12-30,9호선,고속터미널,14622,24584,39206,12
2023-12-30,8호선,잠실(송파구청),18142,20714,38856,12
2023-12-30,7호선,가산디지털단지,12407,11059,23466,12
2023-12-30,7호선,고속터미널,16209,12983,29192,12
2023-12-30,4호선,사당,21394,20195,41589,12
2023-12-30,4호선,서울역,7375,19546,26921,12
2023-12-30,3호선,고속터미널,55396,59859,115255,12
2023-12-30,2호선,홍대입구,77233,85287,162520,12
2023-12-30,2호선,구로디지털단지,34177,33264,67441,12
2023-12-30,2호선,신림,43309,40147,83456,12
2023-12-30,2호선,사당,31430,34393,65823,12
2023-12-30,2호선,강남,53556,52816,106372,12
2023-12-30,2호선,선릉,25672,22178,47850,12
2023-12-30,2호선,잠실(송파구청),72964,71791,144755,12
2023-12-30,1호선,서울역,45292,47428,92720,12
2023-12-31,신림선,신림,1041,1439,2480,12
2023-12-31,분당선,선릉,2930,4066,6996,12
2023-12-31,공항철도 1호선,홍대입구,13830,13812,27642,12
2023-12-31,공항철도 1호선,서울역,11717,10676,22393,12
2023-12-31,경의선,홍대입구,2034,2933,4967,12
2023-12-31,경의선,서울역,1213,1239,2452,12
2023-12-31,경부선,가산디지털단지,4933,5957,10890,12
2023-12-31,경부선,서울역,8757,2458,11215,12
2023-12-31,9호선,고속터미널,10565,15977,26542,12
2023-12-31,8호선,잠실(송파구청),15345,18308,33653,12
2023-12-31,7호선,가산디지털단지,9480,8608,18088,12
2023-12-31,7호선,고속터미널,10735,8083,18818,12
2023-12-31,4호선,사당,15706,14734,30440,12
2023-12-31,4호선,서울역,6440,14678,21118,12
2023-12-31,3호선,고속터미널,38668,39012,77680,12
2023-12-31,2호선,홍대입구,68219,84910,153129,12
2023-12-31,2호선,구로디지털단지,27060,26446,53506,12
2023-12-31,2호선,신림,35810,33626,69436,12
2023-12-31,2호선,사당,21162,24296,45458,12
2023-12-31,2호선,강남,30010,31451,61461,12
2023-12-31,2호선,선릉,14043,12004,26047,12
2023-12-31,2호선,잠실(송파구청),71069,73851,144920,12
2023-12-31,1호선,서울역,37626,38277,75903,12
